ABACK: CANST ARIEL CHUCK ABACK
ABASE: CANST REALM BOUGE ABASE
ABATE: CANST TRITE ABOIL ABATE
ABBEY: CANST DROLE KHAYA ABBEY
ABBOT: CANST PROLE ADBOT ABBOT
ABHOR: CANST DROLE MORAY AGGRO ABHOR
ABIDE: CANST DROLE ABAMP ABIDE
ABLED: CANST DROLE APAID AXLED ABLED
ABODE: CANST DROLE ADOBE ABODE
ABORT: CANST PROLE ABORT
ABOUT: CANST PROLE RUMBO ABOUT
ABOVE: CANST DROLE BEGEM ABOVE
ABUSE: CANST REALM AVISE ABUSE
ABYSS: CANST REALM FOSSA ABYSS
ACORN: CANST UNION OCEAN ACORN
ACRID: CANST ARIEL AURIC ACRID
ACTOR: CANST TITRE ACTOR
ACUTE: CANST TITRE ACUTE
ADAGE: CANST DROLE ABAMP ADAGE
ADAPT: CANST PROLE ADAPT
ADEPT: CANST PROLE EXPAT ADEPT
ADMIN: CANST ALGAE INBOX AHIND ADMIN
ADMIT: CANST PROLE AMAIN ADMIT
ADOBE: CANST DROLE ADOBE
ADOPT: CANST PROLE ADOPT
ADORE: CANST DROLE ADORE
ADORN: CANST ALGAE INBOX ADORN
ADULT: CANST PROLE ATILT ADULT
AFFIX: CANST DROLE GUIMP ZIMBI AFFIX
AFIRE: CANST DROLE GUIMP AFIRE
AFOOT: CANST PROLE RUMBO AFOOT
AFOUL: CANST DROLE AFOUL
AFTER: CANST TRITE EXPEL AFTER
AGAIN: CANST ALGAE AGUNA AGAIN
AGAPE: CANST DROLE AGAZE AGAVE AGAPE
AGATE: CANST TRITE ABOIL AMATE AGATE
AGENT: CANST LIANG AGENT
AGILE: CANST DROLE GUIMP AGILE
AGING: CANST ALGAE WHILK PIXIE AGING
AGLOW: CANST DROLE LOLOG AGLOW
AGONY: CANST ALGAE WHILK AMONG AGONY
AGORA: CANST DROLE AGORA
AGREE: CANST DROLE GUIMP AGREE
AHEAD: CANST DROLE HIDED AHEAD
AIDER: CANST DROLE NEDDY AIDER
AISLE: CANST REALS AISLE
ALARM: CANST DROLE FIRRY ALARM
ALBUM: CANST DROLE GUIMP ALBUM
ALERT: CANST PROLE ALERT
ALGAE: CANST DROLE GLAIK ALGAE
ALIBI: CANST DROLE GUIMP ALIBI
ALIEN: CANST ALGAE ALIEN
ALIGN: CANST ALGAE ALIGN
ALIKE: CANST DROLE GLAIK ALIKE
ALIVE: CANST DROLE GLAIK ALIVE
ALLAY: CANST DROLE GUIMP ALWAY ALLAY
ALLEY: CANST DROLE HEMAL GLEBA ALLEY
ALLOT: CANST PROLE LOVAT ALLOT
ALLOW: CANST DROLE LOLOG ALLOY ALLOW
ALLOY: CANST DROLE LOLOG ALLOY
ALOFT: CANST PROLE BAFFS ALOFT
ALONE: CANST ALGAE ALONE
ALONG: CANST ALGAE ALIGN ALONG
ALOOF: CANST DROLE AFOUL ALOOF
ALOUD: CANST DROLE ALOUD
ALPHA: CANST DROLE GUIMP PLAYA ALPHA
ALTAR: CANST TRITE ALTAR
ALTER: CANST TRITE EXPEL ALTER
AMASS: CANST REALM SMASH AMASS
AMAZE: CANST DROLE AGAZE AMAZE
AMBER: CANST DROLE REBAR AMBER
AMBLE: CANST DROLE GUIMP AMBLE
AMEND: CANST ALGAE ADMEN AMEND
AMISS: CANST REALM AMISS
AMITY: CANST TRITE AKITA AMITY
AMONG: CANST ALGAE WHILK AMONG
AMPLE: CANST DROLE GUIMP AMPLE
AMPLY: CANST DROLE MILPA AMPLY
AMUSE: CANST REALM AMUSE
ANGEL: CANST ALGAE ANGEL
ANGER: CANST ALGAE ANGER
ANGLE: CANST ALGAE ANGLE
ANGRY: CANST ALGAE ANGRY
ANGST: CANST ANGST
ANIME: CANST ALGAE UNMIX ANIME
ANKLE: CANST ALGAE OKEHS ANKLE
ANNEX: CANST GELID PRIES ANNEX
ANNOY: CANST GELID BONZA ANNOY
ANNUL: CANST GELID MUCOR ANNUL
ANODE: CANST ALGAE UNMIX ANODE
ANTIC: CANST ANTIC
ANVIL: CANST ALGAE AZLON ANVIL
AORTA: CANST TRITE ANYON AORTA
APART: CANST PROLE APART
APHID: CANST DROLE APAID APHID
APING: CANST ALGAE WHILK PIXIE APING
APNEA: CANST GELID PRIES APNEA
APPLE: CANST DROLE GUIMP APPLE
APPLY: CANST DROLE MILPA APPLY
APRON: CANST ALGAE INBOX AMMON APRON
APTLY: CANST TRITE MOULD APTLY
ARBOR: CANST DROLE BEZIL ARBOR
ARDOR: CANST DROLE ARDOR
ARENA: CANST ALGAE ARENA
ARGUE: CANST DROLE GUAVA ARGUE
ARISE: CANST REALM ARISE
ARMOR: CANST DROLE BEZIL ARROW ARMOR
AROMA: CANST DROLE HAMZA AROMA
AROSE: CANST REALM ARISE AROSE
ARRAY: CANST DROLE AMIGA ARRAY
ARROW: CANST DROLE BEZIL ARROW
ARSON: CANST SLANE AMOKS ARSON
ARTSY: CANST TRASS ARTSY
ASCOT: CANST SCART ASCOT
ASHEN: CANST SLANE ASPEN ASHEN
ASIDE: CANST REALS ASKED ASIDE
ASKEW: CANST REALS ASKED ASKEW
ASSAY: CANST REALS SUSHI ASSAY
ASSET: CANST HEPAR ASSET
ATOLL: CANST TRITE MOULD ATOLL
ATONE: CANST TIARA ATONE
ATTIC: CANST TITRE ATTIC
AUDIO: CANST DROLE BIVIA AUDIO
AUDIT: CANST PROLE AMAIN AUDIT
AUGUR: CANST DROLE MURRI FUBAR AUGUR
AUNTY: CANST KELTY AUNTY
AVAIL: CANST DROLE GUIMP FLAIL AVAIL
AVERT: CANST PROLE FEART AVERT
AVIAN: CANST ALGAE DIMPS AVIAN
AVOID: CANST DROLE AVOID
AWAIT: CANST PROLE AMAIN AWAIT
AWAKE: CANST DROLE AGAZE AWAVE AWAKE
AWARD: CANST DROLE ULAMA AWARD
AWARE: CANST DROLE GUIMP WHARF AWARE
AWASH: CANST REALM WHUPS AWASH
AWFUL: CANST DROLE GUIMP AWFUL
AWOKE: CANST DROLE BEGEM AWOKE
AXIAL: CANST DROLE GUIMP ALIBI AXIAL
AXIOM: CANST DROLE GIMPY AXIOM
AXION: CANST ALGAE INBOX AXION
AZURE: CANST DROLE GUIMP AZURE
BACON: CANST MUCOR BACON
BADGE: CANST REDLY GOWFS BADGE
BADLY: CANST REDLY MADLY BADLY
BAGEL: CANST REDLY AGAVE BAGEL
BAGGY: CANST REDLY PYGMY BAFFS BAGGY
BAKER: CANST REDLY PORGE WAKFS RUMBO BAKER
BALER: CANST REDLY WHEEP GALVO BALER
BALMY: CANST REDLY POMBE BALMY
BANAL: CANST GYBED BANAK BANAL
BANJO: CANST GYBED BANAK BANJO
BARGE: CANST REDLY PORGE BARGE
BARON: CANST RIVEN MARON BARON
BASAL: CANST MERLS BIPOD BASAL
BASIC: CANST SMEIK BASIC
BASIL: CANST MERLS BIPOD BASIL
BASIN: CANST REINS BASIN
BASIS: CANST MERLS GOPIK SWADS BASIS
BASTE: CANST TERTS WHUMP BASTE
BATCH: CANST HOTLY GRUMP WATCH BATCH
BATHE: CANST TILER BUMPH BATHE
BATON: CANST TELOI BATON
BATTY: CANST TILER WOMBY BATTY
BAWDY: CANST REDLY PUGIL DAFFY BAWDY
BAYOU: CANST REDLY YAKOW BAYOU
BEACH: CANST ARIEL PHYLA BEACH
BEADY: CANST DROLE HIDED BEADY
BEARD: CANST DROLE NEDDY BEARD
BEAST: CANST BLORE BEAST
BEECH: CANST LOCIE MERED KEECH BEECH
BEEFY: CANST DROLE WIMPY BEZEL BEEFY
BEFIT: CANST REOIL BETED BEFIT
BEGAN: CANST ALGAE VEGAN BEGAN
BEGAT: CANST PROLE HEADY BEGAT
BEGET: CANST REOIL PUDGE BEGET
BEGIN: CANST REOIL UMBLE BEGIN
BEGUN: CANST REOIL DWEEB BEGUN
BEING: CANST REOIL FUDGE BEING
BELCH: CANST LOCIE BEWET BELCH
BELIE: CANST DROLE BEGEM BELIE
BELLE: CANST DROLE BIGHT BELLE
BELLY: CANST DROLE WELKE BEFOG BELLY
BELOW: CANST DROLE VUGHY BOWEL BELOW
BENCH: CANST HOMIE DAWKS BENCH
BERET: CANST REOIL BERET
BERRY: CANST DROLE REFER BUMPH BERRY
BERTH: CANST TORTE DERTH BERTH
BESET: CANST POILU WERSH BESET
BETEL: CANST TORTE DIMLY BETEL
BEVEL: CANST DROLE BEGEM BEZEL BEVEL
BEZEL: CANST DROLE BEGEM BEZEL
BIBLE: CANST DROLE BIGHT BIBLE
BICEP: CANST LOCIE DIARY BICEP
BIDDY: CANST DROLE GIMPY SKEWS BIDDY
BIGOT: CANST REOIL GIVED JIGOT BIGOT
BILGE: CANST DROLE BEGEM BULGE BILGE
BILLY: CANST DROLE BILGY BILLY
BINGE: CANST DOGIE THUMB BINGE
BINGO: CANST DOGIE BEZIL BINGO
BIOME: CANST DROLE VEHME BIOME
BIRCH: CANST LOCIE BULKY BIRCH
BIRTH: CANST TORTE FUBBY BIRTH
BISON: CANST REINS VISON BISON
BITTY: CANST TORTE BIPOD BITTY
BLACK: CANST ARIEL PUBCO BLACK
BLADE: CANST DROLE BLADE
BLAME: CANST DROLE GLAIK BLAME
BLAND: CANST ALGAE BIDON BLAND
BLANK: CANST ALGAE BIDON BLANK
BLARE: CANST DROLE GEBUR BLARE
BLAST: CANST BLORE BLAST
BLAZE: CANST DROLE GLAIK BLAME BLAZE
BLEAK: CANST DROLE HEMAL BLEAK
BLEAT: CANST PROLE BLEAT
BLEED: CANST DROLE FILUM BLEED
BLEEP: CANST DROLE BEGEM BLEEP
BLEND: CANST REOIL ELVEN BLEND
BLESS: CANST PROLE LEISH BLESS
BLIMP: CANST DROLE GIMPY BLIMP
BLIND: CANST REOIL PUDGY BLIND
BLINK: CANST REOIL PUDGY BLINK
BLISS: CANST PROLE FUSKS BLISS
BLITZ: CANST TORTE FILMY GLITZ BLITZ
BLOAT: CANST PROLE BAFFS BLOAT
BLOCK: CANST LOCIE BLOCK
BLOKE: CANST DROLE BOYGS BLOKE
BLOND: CANST REOIL FLUNK PLONG BLOND
BLOOD: CANST DROLE BLOOD
BLOOM: CANST DROLE BLOOP BLOOM
BLOWN: CANST REOIL FLUNK BLOWN
BLUER: CANST DROLE LIVER BUPPY BLUER
BLUFF: CANST DROLE GIMPY BLUFF
BLUNT: CANST PLIER BLUNT
BLURB: CANST DROLE LURRY BLURB
BLURT: CANST REOIL BLURT
BLUSH: CANST PROLE FUSKS BLUSH
BOARD: CANST DROLE HOARD BOARD
BOAST: CANST BLORE BOAST
BOBBY: CANST DROLE BUMPY BOGGY BOBBY
BONEY: CANST DOGIE RHOMB BONEY
BONGO: CANST DOGIE GAMBO BONGO
BONUS: CANST GEOID KEMPY BONUS
BOOBY: CANST DROLE BUMPH KRABS BOOBY
BOOST: CANST OURIE GULLY BOOST
BOOTH: CANST TORTE BOOFY BOOTH
BOOTY: CANST TORTE BOOFY BOOTY
BOOZE: CANST DROLE VEHME PIOYE BOOZE
BOOZY: CANST DROLE BUMPH KRABS GAZON BOOZY
BORAX: CANST DROLE MORAY BORAK BORAX
BORNE: CANST REOIL FREMD BORNE
BOSOM: CANST POLER DUMKY BAZOO BOSOM
BOSSY: CANST PROLE MISDO BOSSY
BOTCH: CANST THEIR HOKUM BOUGE BOTCH
BOUGH: CANST DROLE BUMPY BOUGH
BOULE: CANST DROLE FUBBY BOULE
BOUND: CANST REOIL DOWNY BUMPH BOUND
BOWEL: CANST DROLE VUGHY BOWEL
BOXER: CANST DROLE PORER MAWKY FIRTH BOXER
BRACE: CANST ARIEL BRACE
BRAID: CANST DROLE FRAUD BRAID
BRAIN: CANST ALGAE DRINK BRAIN
BRAKE: CANST DROLE GUAVA ZAMBO BRAKE
BRAND: CANST ALGAE DRINK BRAND
BRASH: CANST REALM BAFFS BRASH
BRASS: CANST REALM BAFFS BRASS
BRAVE: CANST DROLE GUAVA BRAVE
BRAVO: CANST DROLE BEZIL BRAVO
BRAWL: CANST DROLE AKING BRAWL
BRAWN: CANST ALGAE DRINK BRAWN
BREAD: CANST DROLE BREAK BREAD
BREAK: CANST DROLE FUBAR BREAK
BREED: CANST DROLE GEEPS FREED BREED
BRIAR: CANST DROLE AMIGA FRIAR BRIAR
BRIBE: CANST DROLE GUIMP BRIBE
BRICK: CANST LOCIE BULKY BRICK
BRIDE: CANST DROLE PUGIL BRIDE
BRIEF: CANST DROLE GIBER BRIEF
BRINE: CANST REOIL UNGET BRINE
BRING: CANST REOIL DEBUG BRING
BRINK: CANST REOIL DEBUG BRINY BRINK
BRINY: CANST REOIL DEBUG BRINY
BRISK: CANST PROLE KIRBY BRISK
BROAD: CANST DROLE BROAD
BROIL: CANST DROLE PUGIL BROIL
BROKE: CANST DROLE SPORK WROKE BROKE
BROOD: CANST DROLE BROOD
BROOK: CANST DROLE GUIMP FRORY BROOK
BROOM: CANST DROLE GUIMP BROOM
BROTH: CANST TORTE BOFFO BROTH
BROWN: CANST REOIL DWANG BROWN
BRUNT: CANST PLIER BRUNT
BRUSH: CANST PROLE KIRBY BRUSH
BRUTE: CANST TORTE BRUTE
BUDDY: CANST DROLE GIMPY WOLFS BUDDY
BUDGE: CANST DROLE MUJIK BAFFS BUDGE
BUGGY: CANST DROLE PIGMY VUGHY BUGGY
BUGLE: CANST DROLE BIGHT BUGLE
BUILD: CANST DROLE GUILD BUILD
BUILT: CANST REOIL BUGLE BUILT
BULGE: CANST DROLE BEGEM BULGE
BULKY: CANST DROLE GIMPY BULKY
BULLY: CANST DROLE BILGY BULLY
BUNCH: CANST HOMIE PARLY BUNCH
BUNNY: CANST DOGIE PRINK BAFFS BUNNY
BURLY: CANST DROLE RHUMB BURLY
BURNT: CANST PLIER BRUNT BURNT
BURST: CANST OURIE DHOWS BURST
BUSED: CANST POLER DISKS RUMBO BUSED
BUSHY: CANST POLER SHIMS HEWGH BUSHY
BUTCH: CANST THEIR HOKUM BUTCH
BUTTE: CANST TORTE BITTE BUTTE
BUXOM: CANST DROLE BUMPY BUXOM
BUYER: CANST DROLE REFER BUMPH BUYER
BYLAW: CANST DROLE GUIMP ALWAY BYLAW
CABAL: CANST RILED CAULK CABAL
CABBY: CANST RILED CABOC CABBY
CABIN: CANST BORAX CABIN
CABLE: CANST RILED CABLE
CACAO: CANST RILED CABOC CACAO
CACHE: CANST RILED CACHE
CACTI: CANST HIRES CACTI
CADDY: CANST RILED CAUDA CADDY
CADET: CANST LUGER CADET
CAGEY: CANST RILED GOTHY CAGEY
CAIRN: CANST BORAX CAIRN
CAMEL: CANST RILED CAVEL CAMEL
CAMEO: CANST RILED GOTHY CAMEO
CANAL: CANST YODEL CANAL
CANDY: CANST YODEL CANDY
CANNY: CANST YODEL CANNY
CANOE: CANST YODEL CANOE
CANON: CANST YODEL CANON
CAPER: CANST RILED PERVO CAPER
CAPUT: CANST LUGER CAPUT
CARAT: CANST LUGER CARAT
CARGO: CANST RILED POMBE CARGO
CAROL: CANST RILED CAROL
CARRY: CANST RILED POMBE CARVY CARRY
CARVE: CANST RILED CABRE CARVE
CASTE: CANST CASTE
CATCH: CANST HIRES CATCH
CATER: CANST HIRES CATER
CATTY: CANST HIRES CATTY
CAULK: CANST RILED CAULK
CAUSE: CANST MERED CAUSE
CAVIL: CANST RILED CAVIL
CEASE: CANST CHELP CEASE
CEDAR: CANST PEARL CEDAR
CELLO: CANST ROULE CELLO
CHAFE: CANST PEARL FISCS CHAFE
CHAFF: CANST PEARL COCKY CHAFF
CHAIN: CANST KRAAL CHANG CHAIN
CHAIR: CANST PEARL CRAIC CHAIR
CHALK: CANST PEARL MITCH CHALK
CHAMP: CANST PEARL CHAMP
CHANT: CANST CHANT
CHAOS: CANST PHARM VIOLD CHAOS
CHARD: CANST PEARL DUMKY CHARD
CHARM: CANST PEARL DUMKY CHARM
CHART: CANST PRAHU CHART
CHASE: CANST CHELP CHASE
CHASM: CANST CHELP CHASM
CHEAP: CANST PEARL CHEAP
CHEAT: CANST PRAHU CHEAT
CHECK: CANST ROULE YIKED CHECK
CHEEK: CANST ROULE YIKED CHEEK
CHEER: CANST ROULE KEYED CHEER
CHESS: CANST ROULE CHESS
CHEST: CANST RUMBO CHEST
CHICK: CANST ROULE NYMPH CHICK
CHIDE: CANST ROULE DEISM CHIDE
CHIEF: CANST ROULE YIKED CHIEF
CHILD: CANST ROULE CELLI CHILD
CHILI: CANST ROULE CELLI CHILI
CHILL: CANST ROULE CELLI CHILL
CHIME: CANST ROULE DEISM CHIME
CHINA: CANST KRAAL CHINA
CHIRP: CANST ROULE CRIMP CHIRP
CHOCK: CANST ROULE SMOKO CHOCK
CHOIR: CANST ROULE BRICK CHOIR
CHOKE: CANST ROULE CHOKE
CHORD: CANST ROULE BRICK CHORD
CHORE: CANST ROULE HAMZA CHORE
CHOSE: CANST ROULE CHOSE
CHUCK: CANST ROULE EPICS CHUCK
CHUMP: CANST ROULE EPICS CHUMP
CHUNK: CANST REOIL CHYND CHUNK
CHURN: CANST REOIL CURNY CHURN
CHUTE: CANST OUTER CHUTE
CIDER: CANST ROULE KEYED CIDER
CIGAR: CANST PEARL GOYIM CIGAR
CINCH: CANST VIDEO CINCH
CIRCA: CANST PEARL GOYIM CIRCA
CIVIC: CANST ROULE NYMPH CIVIC
CIVIL: CANST ROULE FILMS CIVIL
CLACK: CANST PEARL MITCH CLACK
CLAIM: CANST PEARL MITCH CLAIM
CLAMP: CANST PEARL CLAMP
CLANG: CANST KRAAL CLANG
CLANK: CANST KRAAL CLANK
CLASH: CANST CHELP CLASH
CLASP: CANST CHELP CLASP
CLASS: CANST CHELP CLASS
CLEAN: CANST KRAAL CLEAN
CLEAR: CANST PEARL CLEAR
CLEAT: CANST PRAHU CLEAT
CLEFT: CANST LOURE CLEPT CLEFT
CLERK: CANST ROULE CREEL CLERK
CLICK: CANST ROULE FILMS CLICK
CLIFF: CANST ROULE FILMS CLIFF
CLIMB: CANST ROULE FILMS CLIMB
CLING: CANST REOIL CLINK CLING
CLINK: CANST REOIL CLINK
CLOAK: CANST PEARL CLOAK
CLOCK: CANST ROULE CLOMP CLOFF CLOCK
CLONE: CANST REOIL CLONE
CLOSE: CANST ROULE CLOSE
CLOTH: CANST OUTER CLOTH
CLOUD: CANST ROULE CLOUD
CLOUT: CANST LOURE CLOUT
CLOVE: CANST ROULE ZINKY CLOVE
CLOWN: CANST REOIL CLOWN
CLUCK: CANST ROULE CLUMP CLUCK
CLUED: CANST ROULE CLUED
CLUMP: CANST ROULE CLUMP
CLUNG: CANST REOIL CLUNK CLUNG
COACH: CANST PEARL COCKY COACH
COAST: CANST CLAST COAST
COBRA: CANST PEARL COBRA
COCOA: CANST PEARL BOOAI COCOA
COLON: CANST REOIL COLON
COLOR: CANST ROULE COLOR
COMET: CANST LOURE COMET
COMFY: CANST ROULE BOOMY COMFY
COMIC: CANST ROULE BOOMY COMIC
COMMA: CANST PEARL BOOAI COMMA
CONCH: CANST VIDEO CONKY CONCH
CONDO: CANST VIDEO CONDO
CONIC: CANST VIDEO CONIC
COPSE: CANST ROULE COPSE
CORAL: CANST PEARL CORAL
CORER: CANST ROULE PARDY CORER
CORNY: CANST REOIL RUMBO CORNY
COUCH: CANST ROULE COUGH COUCH
COUGH: CANST ROULE COUGH
COULD: CANST ROULE COULD
COUNT: CANST COUNT
COUPE: CANST ROULE COUPE
COURT: CANST LOURE COURT
COVEN: CANST REOIL VOZHD COVEN
COVER: CANST ROULE PARDY EMOVE COVER
COVET: CANST LOURE COMET COVET
COVEY: CANST ROULE EPOXY COZEY COVEY
COWER: CANST ROULE PARDY EMOVE COWER
COYLY: CANST ROULE HOLLO COYLY
CRACK: CANST PEARL CRAIC CRACK
CRAFT: CANST PRAHU CRAFT
CRAMP: CANST PEARL CRAMP
CRANE: CANST KRAAL CRANE
CRANK: CANST KRAAL CRANK
CRASH: CANST CHELP CRASH
CRASS: CANST CHELP CRASS
CRATE: CANST LOUIE CRATE
CRAVE: CANST PEARL MIKVA CRAVE
CRAWL: CANST PEARL CRAWL
CRAZE: CANST PEARL MIKVA CRAZE
CRAZY: CANST PEARL CRAIC CRAZY
CREAK: CANST PEARL CREAK
CREAM: CANST PEARL CREAK CREAM
CREDO: CANST ROULE CREDO
CREED: CANST ROULE KEYED CREED
CREEK: CANST ROULE KEYED CREEK
CREEP: CANST ROULE KEYED CHEER CREEP
CREME: CANST ROULE WHEEP CREME
CREPE: CANST ROULE WHEEP CREPE
CREPT: CANST LOURE CREPT
CRESS: CANST ROULE CRESS
CREST: CANST RUMBO CREST
CRICK: CANST ROULE CRIMP CRICK
CRIED: CANST ROULE KEYED CRIED
CRIER: CANST ROULE KEYED CRIER
CRIME: CANST ROULE WHEEP CRIME
CRIMP: CANST ROULE CRIMP
CRISP: CANST ROULE CRISP
CROAK: CANST PEARL GOYIM CROAK
CROCK: CANST ROULE BRICK CROCK
CRONE: CANST REOIL CRONE
CRONY: CANST REOIL ANYON CRONY
CROOK: CANST ROULE BRICK CROOK
CROSS: CANST ROULE CROSS
CROUP: CANST ROULE CURIO CROUP
CROWD: CANST ROULE BRICK CROWD
CROWN: CANST REOIL ANYON CROWN
CRUDE: CANST ROULE CRUVE CRUDE
CRUEL: CANST ROULE CRUEL
CRUMB: CANST ROULE HUMPY CRUMB
CRUMP: CANST ROULE HUMPY CRUMP
CRUSH: CANST ROULE CRUSY CRUSH
CRUST: CANST RUMBO CRUST
CRYPT: CANST LOURE CRYPT
CUBIC: CANST ROULE CUPID CUBIC
CUMIN: CANST REOIL CUMIN
CURIO: CANST ROULE CURIO
CURLY: CANST ROULE CURLY
CURRY: CANST ROULE DIARY CURRY
CURSE: CANST ROULE CURSE
CURVE: CANST ROULE CURIE CURVE
CURVY: CANST ROULE DIARY CURVY
CUTIE: CANST OUTER CUTIE
CYBER: CANST ROULE KEYED CYBER
CYCLE: CANST ROULE CHYLE CYCLE
CYNIC: CANST VIDEO CYNIC
DADDY: CANST REDLY DWEEB DADDY
DAILY: CANST REDLY DAILY
DAIRY: CANST REDLY DIMPS DAIRY
DAISY: CANST RILEY DAISY
DALLY: CANST REDLY DAILY DALLY
DANCE: CANST HIDER DANCE
DANDY: CANST GYBED DRANK DANDY
DATUM: CANST TILER WOMBY DATUM
DAUNT: CANST THRID DAYNT DAUNT
DEALT: CANST PROLE DEALT
DEATH: CANST TRITE MOLDY DEATH
DEBAR: CANST DROLE KIRBY DEBAR
DEBIT: CANST REOIL BETED DEBIT
DEBUG: CANST DROLE BEIGY DEBUG
DEBUT: CANST REOIL PUDGE DEBUT
DECAL: CANST ARIEL FECAL DECAL
DECAY: CANST ARIEL PHYLA DECAY
DECOR: CANST LOCIE DECOR
DECOY: CANST LOCIE DECOR DECOY
DECRY: CANST LOCIE RUTHS DECRY
DEFER: CANST DROLE MURID DEFER
DEIGN: CANST REOIL FUDGE DEIGN
DEITY: CANST TORTE MILKY DEITY
DELAY: CANST DROLE DELAY
DELTA: CANST TRITE MOLDY DELTA
DELVE: CANST DROLE DELVE
DEMON: CANST REOIL DEMON
DEMUR: CANST DROLE MURID DEMUR
DENIM: CANST DOGIE DENIM
DENSE: CANST SEEDY DENSE
DEPOT: CANST REOIL GALVO DEPOT
DEPTH: CANST TORTE MILKY DEPTH
DERBY: CANST DROLE MURID DERBY
DETER: CANST TORTE HILUM DETER
DETOX: CANST TORTE LEDUM DETOX
DEUCE: CANST LOCIE PEECE DEUCE
DEVIL: CANST DROLE DEBEL DEVIL
DIARY: CANST DROLE DIARY
DICEY: CANST LOCIE DIARY DICEY
DIGIT: CANST REOIL DIXIT DIGIT
DILLY: CANST DROLE DILLY
DIMLY: CANST DROLE DILLY DIMLY
DINER: CANST DOGIE DINED DINER
DINGO: CANST DOGIE DINGO
DINGY: CANST DOGIE DINGY
DIODE: CANST DROLE DIODE
DIRGE: CANST DROLE DIRGE
DIRTY: CANST TORTE FUBBY DIRTY
DISCO: CANST KIORE PELFS DISCO
DITCH: CANST THEIR BIFID DITCH
DITTO: CANST TORTE PUTTO DITTO
DITTY: CANST TORTE BIPOD DITTY
DIVER: CANST DROLE MURID DIKER DIVER
DIZZY: CANST DROLE DUPED DIVVY DIZZY
DODGE: CANST DROLE BEWIG DODGE
DODGY: CANST DROLE BUDDY DODGY
DOGMA: CANST DROLE DOGMA
DOING: CANST REOIL GOMBO HOING DOING
DOLLY: CANST DROLE WILCO DOLLY
DONOR: CANST DOGIE DONOR
DONUT: CANST BOUGE DONUT
DOPEY: CANST DROLE KEMPY DOPEY
DOUBT: CANST REOIL RAGED DOUBT
DOUGH: CANST DROLE BUDDY DOUGH
DOWDY: CANST DROLE BUDDY DOWDY
DOWEL: CANST DROLE DOLED DOWEL
DOWNY: CANST REOIL DOWNY
DOWRY: CANST DROLE DORMY DOWRY
DOZEN: CANST REOIL VOWED DOYEN DOZEN
DRAFT: CANST PROLE FIKED DRAFT
DRAIN: CANST ALGAE DRINK DRAIN
DRAKE: CANST DROLE PANKO DRAKE
DRAMA: CANST DROLE DRAMA
DRANK: CANST ALGAE DRINK DRANK
DRAPE: CANST DROLE PANKO DRAPE
DRAWL: CANST DROLE DRAWL
DRAWN: CANST ALGAE DRINK DRAWN
DREAD: CANST DROLE MYLAR DREAD
DREAM: CANST DROLE MYLAR DREAM
DRESS: CANST PROLE DRESS
DRIED: CANST DROLE BIELD DRIED
DRIER: CANST DROLE BIELD DRIER
DRIFT: CANST REOIL FUDGE DRIFT
DRILL: CANST DROLE DRILL
DRINK: CANST REOIL DEBUG DRINK
DRIVE: CANST DROLE BUIST DRIVE
DROIT: CANST REOIL DROIT
DROLL: CANST DROLE DROLL
DRONE: CANST REOIL PUDGE DRONE
DROOL: CANST DROLE DROIL DROOL
DROOP: CANST DROLE PUGIL DROOP
DROSS: CANST PROLE HAGGS DROSS
DROVE: CANST DROLE MUSKS DROVE
DROWN: CANST REOIL DWANG DROWN
DRUID: CANST DROLE DRUXY DRUID
DRUNK: CANST REOIL GRUND DRUNK
DRYER: CANST DROLE BIELD DRYER
DRYLY: CANST DROLE DRILL DRYLY
DUCHY: CANST LOCIE DUMKY DUCHY
DULLY: CANST DROLE DILLY DULLY
DUMMY: CANST DROLE DUPED DUMKY DUMMY
DUMPY: CANST DROLE DUPED DUMPY
DUNCE: CANST HOMIE DEEPS DUNCE
DUSKY: CANST POLER SHIMS BUSKY DUSKY
DUSTY: CANST TORTE SLIMS FUDGE DUSTY
DUTCH: CANST THEIR HOKUM BUTCH DUTCH
DUVET: CANST REOIL UNMEW DUVET
DWARF: CANST DROLE DIARY DWARF
DWELL: CANST DROLE DEELY DWELL
DWELT: CANST REOIL GLEET DWELT
DYING: CANST REOIL HINNY VYING DYING
EAGER: CANST REDLY PORGE GEMEL EAGER
EAGLE: CANST REDLY GOMPA EAGLE
EARLY: CANST REDLY EARLY
EARTH: CANST TILER EARTH
EASEL: CANST MERLS EVADE EASEL
EATEN: CANST TELOI PATEN EATEN
EATER: CANST TILER EPHOD EATER
EBONY: CANST REOIL OHING EBONY
ECLAT: CANST FRAPE ECLAT
EDICT: CANST HIDER EDICT
EDIFY: CANST DROLE WIMPY EDIFY
EERIE: CANST DROLE MIEVE EERIE
EGRET: CANST REOIL GEMEL EGRET
EIGHT: CANST REOIL BIDET EIGHT
EJECT: CANST HIDER ELECT EJECT
EKING: CANST REOIL EWKED EKING
ELATE: CANST TRITE ABOIL ELATE
ELBOW: CANST DROLE VUGHY BOWEL ELBOW
ELDER: CANST DROLE RULED ELDER
ELECT: CANST HIDER ELECT
ELEGY: CANST DROLE BEGEM ELEGY
ELFIN: CANST REOIL ELDIN ELFIN
ELIDE: CANST DROLE ELUDE ELIDE
ELITE: CANST TORTE FILUM ELITE
ELOPE: CANST DROLE BOYGS ELOPE
ELUDE: CANST DROLE ELUDE
EMAIL: CANST DROLE HEMAL EMAIL
EMBED: CANST DROLE WIMPY EMBED
EMBER: CANST DROLE REFER BUMPY EMBER
EMCEE: CANST LOCIE PECKE EMCEE
EMPTY: CANST TORTE MILKY EMPTY
ENACT: CANST ENACT
ENDOW: CANST REOIL VOWED ENDOW
ENEMA: CANST ALGAE REAMY ENEMA
ENEMY: CANST REOIL ENDEW ENEMY
ENJOY: CANST REOIL VOWED PHEON ENJOY
ENNUI: CANST DOGIE BERYL VINEW ENNUI
ENSUE: CANST REINS SOKEN ENSUE
ENTER: CANST TITRE NOTER ENTER
ENTRY: CANST TITRE ENTRY
ENVOY: CANST REOIL VOWED ENVOY
EPOCH: CANST LOCIE OCKER EPOCH
EPOXY: CANST DROLE ENZYM EPOXY
EQUAL: CANST DROLE HEMAL ILEAL EQUAL
EQUIP: CANST DROLE WIMPY EQUIP
ERASE: CANST REALM EPICS ERASE
ERECT: CANST HIDER RECUT ERECT
ERODE: CANST DROLE ERODE
ERROR: CANST DROLE EMBOG ERROR
ERUPT: CANST REOIL GEMEL ERUPT
ESSAY: CANST REALS ASKED PSOAE ESSAY
ESTER: CANST TORTE RITES ESTER
ETHER: CANST TORTE HILUM ETHER
ETHIC: CANST THEIR ETHIC
ETHOS: CANST TORTE ETHOS
ETUDE: CANST TORTE HAILY ETWEE ETUDE
EVADE: CANST DROLE ABAMP EVADE
EVENT: CANST PLIER EVENT
EVERY: CANST DROLE REFER EVERY
EVICT: CANST HIDER EVICT
EVOKE: CANST DROLE VEHME EVOKE
EXACT: CANST FRAPE EXACT
EXALT: CANST PROLE DEALT EXALT
EXCEL: CANST LOCIE ULCER EXCEL
EXERT: CANST REOIL GEMEL EXERT
EXILE: CANST DROLE BIGHT EXILE
EXIST: CANST OURIE DEFOG EXIST
EXPEL: CANST DROLE BEGEM FLEEK EXPEL
EXTOL: CANST TORTE LEDUM EXTOL
EXTRA: CANST TRITE EXPEL EXTRA
EXULT: CANST REOIL GLEET EXULT
EYING: CANST REOIL EWKED HOMEY EYING
FABLE: CANST REDLY GOMPA FABLE
FACET: CANST FILLE FACET
FAINT: CANST THRID PAINT FAINT
FAIRY: CANST REDLY BUMPH VAIRY FAIRY
FAITH: CANST TILER HIKOI FAITH
FALSE: CANST RILEY SHAFT FALSE
FANCY: CANST HIDER NANCY FANCY
FANNY: CANST GYBED WHILK NAIFS FANNY
FARCE: CANST MERCH FARCE
FATAL: CANST TILER HOPAK FATAL
FATTY: CANST TILER WOMBY FATTY
FAULT: CANST GEBUR VOZHD FAULT
FAUNA: CANST RIVEN NOBLY MAUND FAUNA
FAVOR: CANST REDLY MARIA FAVOR
FEAST: CANST BLORE FIRTH FEAST
FECAL: CANST ARIEL FECAL
FEIGN: CANST REOIL FUDGE FEIGN
FELLA: CANST DROLE KEMPY FELLA
FELON: CANST REOIL POMBE FELON
FEMME: CANST DROLE GUIMP FEMME
FEMUR: CANST DROLE REFER FEMUR
FENCE: CANST HOMIE DEEPS FENCE
FERAL: CANST DROLE RELAY FERAL
FERRY: CANST DROLE REFER FERRY
FETAL: CANST TRITE FEMAL FETAL
FETCH: CANST THEIR KEVEL FETCH
FETID: CANST TORTE DIMLY FETID
FETUS: CANST TORTE SKIEY RUMBO FETUS
FEVER: CANST DROLE REFER JIVEY FEVER
FEWER: CANST DROLE REFER JIVEY FEWER
FIBER: CANST DROLE REFER BIVIA FIBER
FIBRE: CANST DROLE MIEVE JIRRE FIBRE
FICUS: CANST KIORE DISCS FICUS
FIELD: CANST DROLE BIFFY FIELD
FIEND: CANST REOIL EWKED PIEND FIEND
FIERY: CANST DROLE REFER FIERY
FIFTH: CANST TORTE FILMY FIFTH
FIFTY: CANST TORTE FILMY FIFTY
FIGHT: CANST REOIL TWIRP EMBED FORKS FIGHT
FILER: CANST DROLE LIVER CAMPY FILER
FILET: CANST REOIL FILET
FILLY: CANST DROLE BILGY FIRTH FILLY
FILMY: CANST DROLE GIMPY FILMY
FILTH: CANST TORTE FILMY FILTH
FINAL: CANST GELID BRAVA FINAL
FINCH: CANST HOMIE WOLFS FINCH
FINER: CANST DOGIE BERYL FILMS FINER
FIRST: CANST OURIE FIRST
FISHY: CANST POLER SHIMS FISHY
FIXER: CANST DROLE REFER BIVIA FIXER
FIZZY: CANST DROLE PIGMY BIFFY FIZZY
FJORD: CANST DROLE JIHAD FJORD
FLACK: CANST ARIEL PUBCO FLACK
FLAIL: CANST DROLE GUIMP FLAIL
FLAIR: CANST DROLE FIRRY FLAIR
FLAKE: CANST DROLE GLAIK FLAKE
FLAKY: CANST DROLE GUIMP ALWAY FLAXY FLAKY
FLAME: CANST DROLE GLAIK BLAME FLAME
FLANK: CANST ALGAE BIDON PLANK FLANK
FLARE: CANST DROLE GEBUR FLARE
FLASH: CANST REALM SKYFS FLASH
FLASK: CANST REALM SKYFS FLASK
FLECK: CANST LOCIE BEWET FLECK
FLEET: CANST REOIL GLEET FLEET
FLESH: CANST PROLE LEISH FLESH
FLICK: CANST LOCIE FLIMP FLICK
FLIER: CANST DROLE LIVER FLIER
FLING: CANST REOIL PUDGY FLING
FLINT: CANST PLIER FLINT
FLIRT: CANST REOIL FLIRT
FLOAT: CANST PROLE BAFFS FLOAT
FLOCK: CANST LOCIE BLOCK FLOCK
FLOOD: CANST DROLE BLOOD FLOOD
FLOOR: CANST DROLE FLOUR FLOOR
FLORA: CANST DROLE FLORA
FLOSS: CANST PROLE FLOSS
FLOUR: CANST DROLE FLOUR
FLOUT: CANST REOIL FLOUT
FLOWN: CANST REOIL FLUNK FLOWN
FLUFF: CANST DROLE GIMPY BLUFF FLUFF
FLUID: CANST DROLE PUBIC FLUID
FLUKE: CANST DROLE BEGEM ULZIE FLUKE
FLUME: CANST DROLE BEGEM FLUME
FLUNG: CANST REOIL BEFOG FLUNG
FLUNK: CANST REOIL BEFOG FLUNK
FLUSH: CANST PROLE FUSKS FLUSH
FLUTE: CANST TORTE FILUM FLUTE
FLYER: CANST DROLE LIVER BUPPY FLYER
FOAMY: CANST DROLE GIMPY FOAMY
FOCAL: CANST ARIEL LOVER FOCAL
FOCUS: CANST KIORE MOULD FOCUS
FOGGY: CANST DROLE BUMPY FOGGY
FOIST: CANST OURIE HAMZA JOIST FOIST
FOLIO: CANST DROLE BILGY FOLIO
FOLLY: CANST DROLE WHUMP LIGER FOLLY
FORAY: CANST DROLE MORAY FORAY
FORCE: CANST LOCIE DOUCE FORCE
FORGE: CANST DROLE GUIMP FORGE
FORGO: CANST DROLE GURRY FORGO
FORTE: CANST TORTE FORTE
FORTH: CANST TORTE FORBY FORTH
FORTY: CANST TORTE FORBY FORTY
FORUM: CANST DROLE GURRY JORUM FORUM
FOUND: CANST REOIL DOWNY BUMPH FOUND
FOYER: CANST DROLE PORER MAWKY FOYER
FRAIL: CANST DROLE AKING BRAIL FRAIL
FRAME: CANST DROLE GUAVA ZAMBO FRAME
FRANK: CANST ALGAE DRINK BAFFS FRANK
FRAUD: CANST DROLE FRAUD
FREAK: CANST DROLE FUBAR FREAK
FREED: CANST DROLE GEEPS FREED
FREER: CANST DROLE GIBER PEWEE FREER
FRESH: CANST PROLE DRESS FRESH
FRIAR: CANST DROLE AMIGA FRIAR
FRIED: CANST DROLE GEEPS FRIED
FRILL: CANST DROLE GOPIK BRILL FRILL
FRISK: CANST PROLE KIRBY FRISK
FRITZ: CANST TORTE BROGH FRITZ
FROCK: CANST LOCIE BROCH FROCK
FROND: CANST REOIL DWANG FROND
FRONT: CANST PLIER BRUNT FRONT
FROST: CANST OURIE PROST FROST
FROTH: CANST TORTE BOFFO FROTH
FROWN: CANST REOIL DWANG BROWN FROWN
FROZE: CANST DROLE SPORK BOUGE FROZE
FRUIT: CANST REOIL FRUIT
FUDGE: CANST DROLE MUJIK BAFFS FUDGE
FUGUE: CANST DROLE GUIMP FUGUE
FULLY: CANST DROLE BILGY STAPH FULLY
FUNGI: CANST DOGIE UMBLE FUNGI
FUNKY: CANST DOGIE PRINK JIHAD FUNKY
FUNNY: CANST DOGIE PRINK BAFFS FUNNY
FUROR: CANST DROLE GURRY JUROR FUROR
FURRY: CANST DROLE MURRY BROGH FURRY
FUSSY: CANST PROLE SHIMS WAGYU FUSSY
FUZZY: CANST DROLE PIGMY FLYBY FUFFY FUZZY
GAFFE: CANST REDLY GUMMI GAFFE
GAILY: CANST REDLY GILPY GAILY
GAMER: CANST REDLY PORGE GEMEL GAMER
GAMMA: CANST REDLY HIMBO MAMMA GAMMA
GAMUT: CANST GEBUR GAMUT
GASSY: CANST RILEY SMUGS GASSY
GAUDY: CANST REDLY PUGIL GAUDY
GAUGE: CANST REDLY GUMMI AZYGY GAUGE
GAUNT: CANST THRID JIVEY NAUNT GAUNT
GAUZE: CANST REDLY GUMMI AZYGY GAUZE
GAVEL: CANST REDLY AGAVE GAVEL
GAWKY: CANST REDLY PYGMY BUIST GAWKY
GAYER: CANST REDLY GRYPE GAYER
GAYLY: CANST REDLY GILPY GAYLY
GAZER: CANST REDLY PORGE GEMEL GAZER
GECKO: CANST LOCIE DECOR GECKO
GEEKY: CANST DROLE WIMPY BEZEL GEEKY
GEESE: CANST PROLE GISMS GUYSE GEESE
GENIE: CANST DOGIE GENIE
GENRE: CANST DOGIE WHUMP GENRE
GHOST: CANST OURIE GULLY GHOST
GHOUL: CANST DROLE BLOOP GHOUL
GIANT: CANST LIANG GIANT
GIDDY: CANST DROLE GIMPY GIDDY
GIPSY: CANST PROLE GIPSY
GIRLY: CANST DROLE RHUMB GIRLY
GIRTH: CANST TORTE FUBBY MIRTH GIRTH
GIVEN: CANST REOIL EWKED MIXEN GIVEN
GIVER: CANST DROLE REFER BUMPH WRANG GIVER
GLADE: CANST DROLE BLADE GLADE
GLAND: CANST ALGAE GLAND
GLARE: CANST DROLE GEBUR GLARE
GLASS: CANST REALM SKYFS GLASS
GLAZE: CANST DROLE GLAIK GLAZE
GLEAM: CANST DROLE HEMAL GLEAM
GLEAN: CANST ALGAE GLEAN
GLIDE: CANST DROLE ELUDE GLIDE
GLINT: CANST PLIER FLINT GLINT
GLOAT: CANST PROLE BAFFS GLOAT
GLOBE: CANST DROLE BOYGS GLOBE
GLOOM: CANST DROLE BLOOP GLOOM
GLORY: CANST DROLE FLOUR GLORY
GLOSS: CANST PROLE FLOSS GLOSS
GLOVE: CANST DROLE BOYGS GLOVE
GLYPH: CANST DROLE GIMPY GLYPH
GNASH: CANST GNASH
GNOME: CANST REOIL OHING GNOME
GODLY: CANST DROLE MOULD GODLY
GOING: CANST REOIL GOMBO GOING
GOLEM: CANST DROLE VUGHY GOLEM
GOLLY: CANST DROLE WHUMP LIGER GOLLY
GONAD: CANST GELID GONAD
GONER: CANST DOGIE GONER
GOODY: CANST DROLE WOMBY FIRTH GOODY
GOOEY: CANST DROLE ENZYM GOOEY
GOOFY: CANST DROLE BUMPH GOWFS GOOFY
GOOSE: CANST PROLE WOMBS GOOSE
GORGE: CANST DROLE GUIMP GORGE
GOUGE: CANST DROLE PIGMY GALVO GOUGE
GOURD: CANST DROLE BURRY GOURD
GRACE: CANST ARIEL BRACE GRACE
GRADE: CANST DROLE GRADE
GRAFT: CANST PROLE FIKED GRAFT
GRAIL: CANST DROLE AKING GRAIL
GRAIN: CANST ALGAE WRONG GRAIN
GRAND: CANST ALGAE WRONG GRAND
GRANT: CANST LIANG GRANT
GRAPE: CANST DROLE GUAVA CAMPY GRAPE
GRAPH: CANST DROLE AMIGA GRAPY GRAPH
GRASP: CANST REALM BAFFS GRASP
GRASS: CANST REALM BAFFS GRASS
GRATE: CANST TRITE AWFUL BOUGE GRATE
GRAVE: CANST DROLE GUAVA GRAVE
GRAVY: CANST DROLE AMIGA GRAPY GRAVY
GRAZE: CANST DROLE GUAVA CAMPY GRAZE
GREAT: CANST PROLE GLEAM GREAT
GREED: CANST DROLE GEEPS GREED
GREEN: CANST REOIL UPEND GREEN
GREET: CANST REOIL GEMEL GREET
GRIEF: CANST DROLE GIBER GRIEF
GRILL: CANST DROLE GOPIK GRILL
GRIME: CANST DROLE GUIMP GRIME
GRIMY: CANST DROLE GRIMY
GRIND: CANST REOIL DEBUG GRIND
GRIPE: CANST DROLE GUIMP GRIPE
GROAN: CANST ALGAE GOBAN GROAN
GROIN: CANST REOIL PROIN GROIN
GROOM: CANST DROLE GUIMP GROOM
GROPE: CANST DROLE SPORK PROVE GROPE
GROSS: CANST PROLE HAGGS GROSS
GROUP: CANST DROLE GUIMP GROUP
GROUT: CANST REOIL TWERP GROUT
GROVE: CANST DROLE SPORK BOUGE GROVE
GROWL: CANST DROLE PUGIL GROWL
GROWN: CANST REOIL DWANG GROWN
GRUEL: CANST DROLE GRUEL
GRUFF: CANST DROLE GRIMY GRUFF
GRUNT: CANST PLIER BRUNT GRUNT
GUARD: CANST DROLE ULAMA GUARD
GUAVA: CANST DROLE GUIMP GUAVA
GUESS: CANST PROLE SEISM GUESS
GUEST: CANST OURIE GUEST
GUIDE: CANST DROLE MUJIK GUIDE
GUILD: CANST DROLE GUILD
GUILE: CANST DROLE BIGHT GUILE
GUILT: CANST REOIL BUGLE GUILT
GUISE: CANST PROLE GISMS GUISE
GULCH: CANST LOCIE MULCH GULCH
GULLY: CANST DROLE BILGY GULLY
GUMBO: CANST DROLE BUMPY JUMBO GUMBO
GUMMY: CANST DROLE PIGMY GUMMY
GUPPY: CANST DROLE PIGMY GUPPY
GUSTO: CANST TORTE LISPS GUSTO
GUSTY: CANST TORTE SLIMS FUDGE GUSTY
GYPSY: CANST PROLE GIPSY GYPSY
HABIT: CANST GEBUR HABIT
HAIRY: CANST REDLY BUMPH HARRY HAIRY
HALVE: CANST REDLY AGAVE VALVE HALVE
HANDY: CANST GYBED DRANK HANDY
HAPPY: CANST REDLY PYGMY ZAPPY HAPPY
HARDY: CANST REDLY DIMPS TAVAH HARDY
HAREM: CANST REDLY PORGE UMBER HAREM
HARPY: CANST REDLY BUMPH HARPY
HARRY: CANST REDLY BUMPH HARRY
HARSH: CANST RILEY MARSH HARSH
HASTE: CANST TERTS WHUMP HASTE
HASTY: CANST TERTS SOPHY HASTY
HATCH: CANST HOTLY HATCH
HATER: CANST TILER EPHOD HATER
HAUNT: CANST THRID HAUNT
HAUTE: CANST TILER BUMPH HAUTE
HAVEN: CANST RIVEN HEMPS HAVEN
HAVOC: CANST MERCH BIPOD HAVOC
HAZEL: CANST REDLY AGAVE LABEL HAZEL
HEADY: CANST DROLE HIDED HEADY
HEARD: CANST DROLE NEDDY BEARD HEARD
HEART: CANST PROLE FEART HEART
HEATH: CANST TRITE MOLDY HEATH
HEAVE: CANST DROLE AGAZE HEAME HEAVE
HEAVY: CANST DROLE KHAYA HEAVY
HEDGE: CANST DROLE MUJIK HEDGE
HEFTY: CANST TORTE MILKY HEFTY
HEIST: CANST OURIE DEFOG HEIST
HELIX: CANST DROLE BEGEM HELIX
HELLO: CANST DROLE JELLO HELLO
HENCE: CANST HOMIE HENCE
HERON: CANST REOIL HERON
HILLY: CANST DROLE BILGY FIRTH HILLY
HINGE: CANST DOGIE THUMB HINGE
HIPPO: CANST DROLE BUMPY GOTHY HIPPO
HIPPY: CANST DROLE PIGMY HAMZA HIPPY
HITCH: CANST THEIR BIFID GUIMP WITCH HITCH
HOARD: CANST DROLE HOARD
HOBBY: CANST DROLE BUMPY GOTHY HOBBY
HOIST: CANST OURIE HAMZA HOIST
HOLLY: CANST DROLE WHUMP HOLLO HOLLY
HOMER: CANST DROLE PORER MAWKY TAVAH HOMER
HONEY: CANST DOGIE RHOMB HONEY
HONOR: CANST DOGIE BULKY HONOR
HORDE: CANST DROLE HORDE
HORNY: CANST REOIL SPUMY HORNY
HORSE: CANST PROLE WHUMP HORSE
HOTEL: CANST TORTE DUMPY HOTEL
HOTLY: CANST TORTE HIMBO HOTLY
HOUND: CANST REOIL DOWNY BUMPH HOUND
HOUSE: CANST PROLE BUSHY HOUSE
HOVEL: CANST DROLE VUGHY HOVEL
HOVER: CANST DROLE PORER MAWKY FIRTH HOVER
HOWDY: CANST DROLE MIDDY HOWDY
HUMAN: CANST ALGAE RUMBO HUMAN
HUMID: CANST DROLE GIMPY HUMID
HUMOR: CANST DROLE GURRY RUMBO HUMOR
HUMPH: CANST DROLE PIGMY HUMPH
HUMUS: CANST POLER SHIMS HUMUS
HUNCH: CANST HOMIE HUNCH
HUNKY: CANST DOGIE PRINK JIHAD HUNKY
HURRY: CANST DROLE MURRY BROGH HURRY
HUSKY: CANST POLER SHIMS HEWGH HUSKY
HUSSY: CANST PROLE SHIMS HUSSY
HUTCH: CANST THEIR HOKUM HUTCH
HYDRO: CANST DROLE BURRY HYDRO
HYENA: CANST ALGAE REAMY HYENA
HYMEN: CANST REOIL ENDEW NUMEN HYMEN
HYPER: CANST DROLE REFER BUMPH HYPER
ICILY: CANST LOCIE FLIMP ICILY
ICING: CANST NICER ICING
IDEAL: CANST DROLE APAID IDEAL
IDIOM: CANST DROLE MIDDY ODIUM IDIOM
IDIOT: CANST REOIL GIVED IDIOT
IDLER: CANST DROLE RULED IDLER
IDYLL: CANST DROLE GUILD IDYLL
IGLOO: CANST DROLE BILGY IGLOO
ILIAC: CANST ARIEL PLICA ILIAC
IMAGE: CANST DROLE AGAZE PHAGE IMAGE
IMBUE: CANST DROLE GUIMP IMBUE
IMPEL: CANST DROLE BEGEM MULEY IMPEL
IMPLY: CANST DROLE BILGY IMPLY
INANE: CANST ALGAE MIRKS INANE
INBOX: CANST REOIL GOMBO BIDON INBOX
INCUR: CANST NICER INCUR
INDEX: CANST REOIL EWKED INDEX
INEPT: CANST PLIER INEPT
INERT: CANST PLIER INERT
INFER: CANST REOIL UNGET INFER
INGOT: CANST PLIER QUOIF INGOT
INLAY: CANST ALGAE YUPON INLAY
INLET: CANST PLIER INLET
INNER: CANST DOGIE BERYL FILMS INNER
INPUT: CANST PLIER INPUT
INTER: CANST TITRE INTER
INTRO: CANST TITRE INTRO
IONIC: CANST HOMIE IONIC
IRATE: CANST TRITE IRATE
IRONY: CANST REOIL IRONY
ISLET: CANST POILU ISLET
ISSUE: CANST POLER SEEDS ISSUE
ITCHY: CANST THEIR BIFID ITCHY
IVORY: CANST DROLE PIGMY IVORY
JAUNT: CANST THRID JIVEY JAUNT
JAZZY: CANST REDLY PYGMY FABBY JAZZY
JELLY: CANST DROLE WELKE BEFOG JELLY
JERKY: CANST DROLE REFER KAPHS JERKY
JETTY: CANST TORTE PUBIC JETTY
JEWEL: CANST DROLE BEGEM KEVEL JEWEL
JIFFY: CANST DROLE PIGMY BIFFY JIFFY
JOINT: CANST PLIER NOINT JOINT
JOIST: CANST OURIE HAMZA JOIST
JOKER: CANST DROLE PORER MAWKY KOKER JOKER
JOLLY: CANST DROLE WHUMP LIGER FOLLY JOLLY
JOUST: CANST OURIE MOUST JOUST
JUDGE: CANST DROLE MUJIK JUDGE
JUICE: CANST LOCIE SPARD JUICE
JUICY: CANST LOCIE BULKY JUICY
JUMBO: CANST DROLE BUMPY JUMBO
JUMPY: CANST DROLE PIGMY JIHAD JUMPY
JUNTA: CANST KELTY PINTA JUNTA
JUNTO: CANST ROUTE PUNTO JUNTO
JUROR: CANST DROLE GURRY JUROR
KAPPA: CANST REDLY HIMBO KAWAU KAPPA
KARMA: CANST REDLY MARIA PARMA KARMA
KAYAK: CANST REDLY YAKOW KAYAK
KEBAB: CANST DROLE KHAYA KEBAB
KHAKI: CANST DROLE GUIMP ZIMBI KHAKI
KINKY: CANST DOGIE KELPY KINKY
KIOSK: CANST PROLE WOOSH KIOSK
KITTY: CANST TORTE BIPOD WITTY KITTY
KNACK: CANST UNION ANCLE KNACK
KNAVE: CANST ALGAE MIRKS KNAVE
KNEAD: CANST ALGAE MERED KNEAD
KNEED: CANST REOIL ENDEW KNEED
KNEEL: CANST REOIL KNELL KNEEL
KNELT: CANST PLIER KNELT
KNIFE: CANST REOIL EWKED KNIVE KNIFE
KNOCK: CANST NICER KNOCK
KNOLL: CANST REOIL KNOLL
KNOWN: CANST REOIL MOONY KNOWN
KOALA: CANST DROLE MILKY KOALA
KRILL: CANST DROLE GOPIK KRILL
LABEL: CANST REDLY AGAVE LABEL
LABOR: CANST REDLY LIVOR LABOR
LADEN: CANST RIVEN WONKY LADEN
LADLE: CANST REDLY LADLE
LAGER: CANST REDLY WHEEP GALVO LAGER
LANCE: CANST HIDER PARLY LANCE
LANKY: CANST GYBED WHILK LANKY
LAPEL: CANST REDLY AGAVE LABEL LAPEL
LAPSE: CANST RILEY LAPSE
LARGE: CANST REDLY WHEEP LARGE
LARVA: CANST REDLY LIVOR LARVA
LASSO: CANST RILEY LASSU LASSO
LATCH: CANST HOTLY LATCH
LATER: CANST TILER LATER
LATHE: CANST TILER FIRTH LATHE
LATTE: CANST TILER FIRTH LATTE
LAUGH: CANST REDLY KALAM LAIGH LAUGH
LAYER: CANST REDLY LAYER
LEACH: CANST ARIEL PLACE LEACH
LEAFY: CANST DROLE HEMAL FOLKY LEAFY
LEAKY: CANST DROLE HEMAL FOLKY LEAKY
LEANT: CANST LIANG LEANT
LEAPT: CANST PROLE LEAPT
LEARN: CANST ALGAE LEARN
LEASE: CANST REALM LEASH LEASE
LEASH: CANST REALM LEASH
LEAST: CANST BLORE LEAST
LEAVE: CANST DROLE GLAIK LEAVE
LEDGE: CANST DROLE ELUDE LEDGE
LEECH: CANST LOCIE LEECH
LEERY: CANST DROLE LIVER LEERY
LEFTY: CANST TORTE MILKY LEFTY
LEGAL: CANST DROLE HEMAL LEGAL
LEGGY: CANST DROLE BEGEM LEGGY
LEMON: CANST REOIL POMBE LEMON
LEMUR: CANST DROLE LIVER LEMUR
LEPER: CANST DROLE LIVER DERIG LEPER
LEVEL: CANST DROLE BEGEM KEVEL LEVEL
LEVER: CANST DROLE LIVER LEVER
LIBEL: CANST DROLE BEGEM LIBEL
LIEGE: CANST DROLE BEGEM LIEGE
LIGHT: CANST REOIL BUGLE LIGHT
LIKEN: CANST REOIL KNIVE LIKEN
LILAC: CANST ARIEL LILAC
LIMBO: CANST DROLE BILGY LIMBO
LIMIT: CANST REOIL LIMIT
LINEN: CANST DOGIE BERYL LINEN
LINER: CANST DOGIE BERYL LINER
LINGO: CANST DOGIE BEZIL LINGO
LIPID: CANST DROLE PUBIC LIPID
LITHE: CANST TORTE HAILY LITHE
LIVER: CANST DROLE LIVER
LIVID: CANST DROLE PUBIC LIVID
LLAMA: CANST DROLE GUIMP FLAMM LLAMA
LOAMY: CANST DROLE LOLOG LOUMA LOAMY
LOATH: CANST TRITE LOATH
LOBBY: CANST DROLE BILGY LOBBY
LOCAL: CANST ARIEL LOVER LOCAL
LOCUS: CANST KIORE MOULD LOCUS
LODGE: CANST DROLE OLDIE LODGE
LOFTY: CANST TORTE BOOFY LOFTY
LOGIC: CANST LOCIE LORIC LOGIC
LOGIN: CANST REOIL LOGIN
LOOPY: CANST DROLE BLOOP LOOPY
LOOSE: CANST PROLE LOOSE
LORRY: CANST DROLE LURGI LORRY
LOSER: CANST POLER LOSER
LOUSE: CANST PROLE LOWSE LOUSE
LOUSY: CANST PROLE LOUSY
LOVER: CANST DROLE LOWER LOVER
LOWER: CANST DROLE LOWER
LOWLY: CANST DROLE WHUMP LOWLY
LOYAL: CANST DROLE LOLOG LOYAL
LUCID: CANST LOCIE LUCID
LUCKY: CANST LOCIE LUCKY
LUMEN: CANST REOIL ELVEN LUMEN
LUMPY: CANST DROLE GIMPY LUMPY
LUNAR: CANST GELID MUCOR LUNAR
LUNCH: CANST HOMIE PARLY LUNCH
LUNGE: CANST DOGIE WHUMP GUNGE LUNGE
LUPUS: CANST POLER SLIPS LUPUS
LURCH: CANST LOCIE LURCH
LURID: CANST DROLE LURID
LUSTY: CANST TORTE SLIMS LUSTY
LYING: CANST REOIL PUDGY LYING
LYMPH: CANST DROLE GIMPY LYMPH
LYNCH: CANST HOMIE PARLY LYNCH
LYRIC: CANST LOCIE LYRIC
MACAW: CANST MERCH FILLE MACAW
MACHO: CANST MERCH MACHI MACHO
MACRO: CANST MERCH MACRO
MADAM: CANST REDLY MUJIK MADAM
MADLY: CANST REDLY MADLY
MAFIA: CANST REDLY HIMBO MAFIA
MAGIC: CANST MERCH FILLE MAGIC
MAGMA: CANST REDLY HIMBO KAAMA MAGMA
MAIZE: CANST REDLY GUMMI MAVIE MAIZE
MAJOR: CANST REDLY MARIA MAJOR
MAKER: CANST REDLY PORGE WAKFS RUMBO MAKER
MAMBO: CANST REDLY HIMBO GAZON JAMBO MAMBO
MAMMA: CANST REDLY HIMBO MAMMA
MAMMY: CANST REDLY PYGMY JIHAD MAMMY
MANGA: CANST GYBED MIKRA MANGA
MANGE: CANST GYBED RANGE MANGE
MANGO: CANST GYBED MIKRA MANGO
MANGY: CANST GYBED RANGY MANGY
MANIA: CANST GYBED OPIUM MANIA
MANIC: CANST HIDER PANIC MANIC
MANLY: CANST GYBED WHILK MANLY
MANOR: CANST GYBED OPIUM MANOR
MAPLE: CANST REDLY GOMPA MAPLE
MARCH: CANST MERCH MARCH
MARRY: CANST REDLY BUMPH MARVY MARRY
MARSH: CANST RILEY MARSH
MASON: CANST REINS SLOOM MASON
MASSE: CANST RILEY SUMPH MASSE
MATCH: CANST HOTLY GRUMP MATCH
MATEY: CANST TILER BUMPH MATEY
MAUVE: CANST REDLY GUMMI MAUVE
MAXIM: CANST REDLY HIMBO MAFIA MAXIM
MAYBE: CANST REDLY MAYBE
MAYOR: CANST REDLY MYLAR MAYOR
MEALY: CANST DROLE KEMPY MEALY
MEANT: CANST LIANG ROBED MEANT
MEATY: CANST TRITE MOLDY MEATY
MECCA: CANST ARIEL PHYLA MECCA
MEDAL: CANST DROLE APAID MEDAL
MEDIA: CANST DROLE HIDED MEDIA
MEDIC: CANST LOCIE HEMIC MEDIC
MELEE: CANST DROLE BEGEM MELEE
MELON: CANST REOIL POMBE MELON
MERCY: CANST LOCIE MERED MERCY
MERGE: CANST DROLE MIEVE MERGE
MERIT: CANST REOIL MERIT
MERRY: CANST DROLE REFER BUMPH MERRY
METAL: CANST TRITE FEMAL METAL
METER: CANST TORTE HILUM METER
METRO: CANST TORTE RETOX METRO
MICRO: CANST LOCIE MICRO
MIDGE: CANST DROLE MUJIK MIDGE
MIDST: CANST OURIE DHOWS MIDST
MIGHT: CANST REOIL TWIRP EMBED MIGHT
MILKY: CANST DROLE GIMPY FILMY MILKY
MIMIC: CANST LOCIE DUMKY MIMIC
MINCE: CANST HOMIE MINCE
MINER: CANST DOGIE BERYL FILMS MINER
MINIM: CANST DOGIE LININ MINIM
MINOR: CANST DOGIE PINON MINOR
MINTY: CANST ROUTE MYLAR MINTY
MINUS: CANST GEOID SKULK MINUS
MIRTH: CANST TORTE FUBBY MIRTH
MISER: CANST POLER SKIVY RUMBO MISER
MISSY: CANST PROLE SHIMS MISSY
MOCHA: CANST ARIEL CHUCK MOCHA
MODAL: CANST DROLE PODAL MODAL
MODEL: CANST DROLE LYMPH MODEL
MODEM: CANST DROLE OOMPH VOZHD MODEM
MOGUL: CANST DROLE BILGY MOGUL
MOIST: CANST OURIE HAMZA MOIST
MOLAR: CANST DROLE MORPH MOLAR
MOLDY: CANST DROLE GOLDY MOLDY
MONEY: CANST DOGIE RHOMB MONEY
MONTH: CANST ROUTE CAMPY MONTH
MOODY: CANST DROLE WOMBY MOODY
MOOSE: CANST PROLE WOMBS MOOSE
MORAL: CANST DROLE MORPH MORAL
MORON: CANST REOIL SPUMY MORON
MORPH: CANST DROLE GURRY MORPH
MOSSY: CANST PROLE MISDO MOSSY
MOTEL: CANST TORTE DUMPY MOTEL
MOTIF: CANST TORTE HIMBO MOTIF
MOTOR: CANST TORTE ROTOR MOTOR
MOTTO: CANST TORTE OOMPH MOTTO
MOULT: CANST REOIL UMBLE MOULT
MOUND: CANST REOIL DOWNY BUMPH MOUND
MOUNT: CANST PLIER MOSKS MOUNT
MOURN: CANST REOIL SPUMY MOURN
MOUSE: CANST PROLE BUSHY SCODY MOUSE
MOUTH: CANST TORTE BOOFY MOUTH
MOVER: CANST DROLE PORER MAWKY MOVER
MOVIE: CANST DROLE PIGMY BEMIX MOVIE
MOWER: CANST DROLE PORER MAWKY MOWER
MUCKY: CANST LOCIE DUMKY MUCKY
MUCUS: CANST KIORE PLUMS MUCUS
MUDDY: CANST DROLE GIMPY MUDDY
MULCH: CANST LOCIE MULCH
MUMMY: CANST DROLE PIGMY MUMMY
MUNCH: CANST HOMIE MUNCH
MURAL: CANST DROLE FIRRY HAMZA MURAL
MURKY: CANST DROLE MURRY MURKY
MUSHY: CANST POLER SHIMS MUSHY
MUSIC: CANST KIORE MUILS MUSIC
MUSKY: CANST POLER SHIMS MUSKY
MUSTY: CANST TORTE SLIMS MUSTY
MYRRH: CANST DROLE MURRY MYRRH
NADIR: CANST RIVEN DURRS NADIR
NAIVE: CANST RIVEN NAIVE
NANNY: CANST GYBED WHILK NAIFS NANNY
NASAL: CANST REINS SLOOM NASAL
NASTY: CANST TAINS NASTY
NATAL: CANST TELOI NATAL
NAVAL: CANST RIVEN NAVVY NAVAL
NAVEL: CANST RIVEN NAVEW NAVEL
NEEDY: CANST REOIL DWEEB NEEDY
NEIGH: CANST REOIL FUDGE NEIGH
NERDY: CANST REOIL EVADE NERDY
NERVE: CANST REOIL EVADE NERVE
NEVER: CANST REOIL EVADE NEVER
NEWER: CANST REOIL EVADE NEWER
NEWLY: CANST REOIL PEWEE NEWLY
NICER: CANST NICER
NICHE: CANST NICER NICHE
NIECE: CANST NICER NIECE
NIGHT: CANST PLIER QUOIF NIGHT
NINJA: CANST GELID NYMPH NINJA
NINNY: CANST DOGIE KELPY NYMPH NINNY
NINTH: CANST ROUTE MYLAR NINTH
NOBLE: CANST REOIL WOULD NOBLE
NOBLY: CANST REOIL GUNNY NOBLY
NOISE: CANST KIORE NOISE
NOISY: CANST KIORE NOISY
NOMAD: CANST ALGAE RUMBO WOMAN NOMAD
NOOSE: CANST KIORE NOOSE
NORTH: CANST TITRE NORTH
NOSEY: CANST REINS SOKEN NOSEY
NOTCH: CANST TRONC NOTCH
NOVEL: CANST REOIL NOVEL
NUDGE: CANST REOIL ENDEW NUDGE
NURSE: CANST KIORE NURSE
NUTTY: CANST TITRE NUTTY
NYLON: CANST REOIL GUNNY NYLON
NYMPH: CANST REOIL DUMKY NYMPH
OAKEN: CANST RIVEN WONKY OAKEN
OBESE: CANST PROLE BUSHY OBESE
OCCUR: CANST LOCIE RUMBO OCCUR
OCEAN: CANST UNION OCEAN
OCTAL: CANST TITRE OCTAL
OCTET: CANST HIDER OCTET
ODDER: CANST DROLE ROBED ODDER
ODDLY: CANST DROLE MOULD ODDLY
OFFAL: CANST DROLE LOLOG ALAMO OFFAL
OFFER: CANST DROLE PORER OMBER OFFER
OFTEN: CANST TITRE JOMON OFTEN
OLDEN: CANST REOIL WOULD OLDEN
OLDER: CANST DROLE OLDER
OLIVE: CANST DROLE VOGIE OLIVE
OMBRE: CANST DROLE GUIMP OMBRE
OMEGA: CANST DROLE HOVEA OMEGA
ONION: CANST REOIL GOMBO ONION
ONSET: CANST UTERI ONSET
OPERA: CANST DROLE OPERA
OPINE: CANST REOIL OVINE OPINE
OPIUM: CANST DROLE BUMPY OPIUM
OPTIC: CANST THEIR LOTIC OPTIC
ORBIT: CANST REOIL ORBIT
ORDER: CANST DROLE ORBED ORDER
ORGAN: CANST ALGAE BIDON HOGAN ORGAN
OTHER: CANST TORTE RETOX OTHER
OTTER: CANST TORTE OTTER
OUGHT: CANST REOIL RAGED OUGHT
OUNCE: CANST HOMIE OUNCE
OUTDO: CANST TORTE OUTGO OUTDO
OUTER: CANST TORTE RETOX TURPS OUTER
OUTGO: CANST TORTE OUTGO
OVARY: CANST DROLE MORAY OVARY
OVATE: CANST TRITE ABOIL OVATE
OVERT: CANST REOIL ERGOT OVERT
OVINE: CANST REOIL OVINE
OVOID: CANST DROLE WOMBY OVOID
OWING: CANST REOIL GOMBO STAPH OWING
OWNER: CANST DOGIE XENON OWNER
OXIDE: CANST DROLE POMBE OXIDE
OZONE: CANST REOIL OHING OZONE
PADDY: CANST REDLY DWEEB PADDY
PAGAN: CANST RIVEN GOLDY PAGAN
PAINT: CANST THRID PAINT
PALER: CANST REDLY WHEEP PALER
PALSY: CANST RILEY PALSY
PANEL: CANST GYBED MYLAR PANEL
PANIC: CANST HIDER PANIC
PANSY: CANST HAMZA PANSY
PAPAL: CANST REDLY KALAM VOZHD PAPAL
PAPER: CANST REDLY PORGE AVOWS PAPER
PARER: CANST REDLY PORGE LURRY PARER
PARKA: CANST REDLY MARIA PARKA
PARRY: CANST REDLY BUMPH PARRY
PARSE: CANST RILEY CAMPY PARSE
PARTY: CANST TILER PORGY PARTY
PASTA: CANST TERTS SOPHY PASTA
PASTE: CANST TERTS WHUMP PASTE
PASTY: CANST TERTS SOPHY PASTY
PATCH: CANST HOTLY GRUMP PATCH
PATIO: CANST TILER HIKOI PATIO
PATSY: CANST HOSEY PATSY
PATTY: CANST TILER WOMBY FATTY PATTY
PAUSE: CANST RILEY SUMPH PAUSE
PAYEE: CANST REDLY MAYBE PAYEE
PAYER: CANST REDLY GRYPE PAYER
PEACE: CANST ARIEL PHYLA PEACE
PEACH: CANST ARIEL PHYLA PEACH
PEARL: CANST DROLE RELAY PEARL
PECAN: CANST UNION DECAN PECAN
PEDAL: CANST DROLE APAID PEDAL
PENAL: CANST GELID PRIES PENAL
PENCE: CANST HOMIE DEEPS PENCE
PENNE: CANST DOGIE RUMBO PENNE
PENNY: CANST DOGIE SHREW BAFFS JENNY PENNY
PERCH: CANST LOCIE MERED PERCH
PERIL: CANST DROLE LIVER MERIL PERIL
PERKY: CANST DROLE REFER KAPHS PERKY
PESKY: CANST POLER OKEHS PESKY
PESTO: CANST TORTE MESTO PESTO
PETAL: CANST TRITE FEMAL PETAL
PETTY: CANST TORTE PUBIC PETTY
PHASE: CANST REALM BOUGE PHASE
PHONE: CANST REOIL OHING PHONE
PHONY: CANST REOIL MOONY PHONY
PHOTO: CANST TORTE PLUTO PHOTO
PIANO: CANST ALGAE DRINK PIANI PIANO
PICKY: CANST LOCIE KEMPY PICKY
PIECE: CANST LOCIE SPARD PIECE
PIETY: CANST TORTE MILKY PIETY
PIGGY: CANST DROLE PIGMY PIGGY
PILOT: CANST REOIL DOILT PILOT
PINCH: CANST HOMIE WOLFS PINCH
PINEY: CANST DOGIE BERYL WINEY PINEY
PINKY: CANST DOGIE KELPY PINKY
PINTO: CANST ROUTE PINTO
PIPER: CANST DROLE REFER BUMPH PAWKS PIPER
PIQUE: CANST DROLE GUIMP PIQUE
PITCH: CANST THEIR BIFID GUIMP PITCH
PITHY: CANST TORTE HIPLY PITHY
PIVOT: CANST REOIL GIVED PIVOT
PIXEL: CANST DROLE BEGEM PUZEL PIXEL
PIXIE: CANST DROLE GUIMP PIXIE
PIZZA: CANST DROLE GUIMP KIPPA PIZZA
PLACE: CANST ARIEL PLACE
PLAID: CANST DROLE UGALI PLAID
PLAIN: CANST ALGAE BIDON PLAIN
PLAIT: CANST PROLE PLATT PLAIT
PLANE: CANST ALGAE FLANE PLANE
PLANK: CANST ALGAE BIDON PLANK
PLANT: CANST LIANG ALANT PLANT
PLATE: CANST TRITE ABOIL ELATE PLATE
PLAZA: CANST DROLE GUIMP PLAYA PLAZA
PLEAD: CANST DROLE APAID PLEAD
PLEAT: CANST PROLE PLEAT
PLIED: CANST DROLE FILUM PLIED
PLIER: CANST DROLE LIVER FLIER PLIER
PLUCK: CANST LOCIE MULCH PLUCK
PLUMB: CANST DROLE GIMPY PLUMB
PLUME: CANST DROLE BEGEM FLUME PLUME
PLUMP: CANST DROLE GIMPY PLUMB PLUMP
PLUNK: CANST REOIL BEFOG PLUNK
PLUSH: CANST PROLE PLUSH
POESY: CANST PROLE POESY
POINT: CANST PLIER POINT
POISE: CANST PROLE JIVEY POISE
POKER: CANST DROLE PORER POWER POKER
POLAR: CANST DROLE MORPH POLAR
POLKA: CANST DROLE LOLOG JIVEY POLKA
POLYP: CANST DROLE BILGY XYLOL POLYP
POOCH: CANST LOCIE GRUMP POOCH
POPPY: CANST DROLE BUMPY POPPY
PORCH: CANST LOCIE GRUMP PORCH
POSER: CANST POLER POSER
POSIT: CANST POILU POSIT
POSSE: CANST PROLE JIVEY POSSE
POUCH: CANST LOCIE GRUMP POUCH
POUND: CANST REOIL DOWNY BUMPH POUND
POUTY: CANST TORTE BOOFY POUTY
POWER: CANST DROLE PORER POWER
PRANK: CANST ALGAE DRINK BAFFS PRANK
PRAWN: CANST ALGAE DRINK BRAWN PRAWN
PREEN: CANST REOIL UPEND PREEN
PRESS: CANST PROLE PRESS
PRICE: CANST LOCIE SPARD PRICE
PRICK: CANST LOCIE BULKY WRICK PRICK
PRIDE: CANST DROLE PUGIL PRIDE
PRIED: CANST DROLE GEEPS URPED PRIED
PRIME: CANST DROLE GUIMP PRIME
PRIMO: CANST DROLE PRIOR PRIMO
PRINT: CANST PLIER PRINT
PRIOR: CANST DROLE PRIOR
PRISM: CANST PROLE PRISM
PRIVY: CANST DROLE GRIMY PRIVY
PRIZE: CANST DROLE GUIMP PRIZE
PROBE: CANST DROLE SPORK PROVE PROBE
PRONE: CANST REOIL PUDGE PRONE
PRONG: CANST REOIL DWANG PRONG
PROOF: CANST DROLE GUIMP PROOF
PROSE: CANST PROLE PROSE
PROUD: CANST DROLE BROOD PROUD
PROVE: CANST DROLE SPORK PROVE
PROWL: CANST DROLE PUGIL PROWL
PROXY: CANST DROLE GUIMP PROOF PROXY
PRUDE: CANST DROLE PUGIL PRUDE
PRUNE: CANST REOIL UPEND PRUNE
PSALM: CANST REALS HUMPY PSALM
PUBIC: CANST LOCIE DUMKY PUBIC
PUDGY: CANST DROLE GIMPY PUDGY
PUFFY: CANST DROLE PIGMY PUPPY PUFFY
PULPY: CANST DROLE GIMPY PULPY
PULSE: CANST PROLE PULSE
PUNCH: CANST HOMIE PARLY PUNCH
PUPAL: CANST DROLE GUIMP PUPAL
PUPIL: CANST DROLE GIMPY PULIK PUPIL
PUPPY: CANST DROLE PIGMY PUPPY
PUREE: CANST DROLE MIEVE GERBE PUREE
PURER: CANST DROLE REFER WIRER PURER
PURGE: CANST DROLE MIEVE PORKY PURGE
PURSE: CANST PROLE PERSE PURSE
PUSHY: CANST POLER KIPPS PUSHY
PUTTY: CANST TORTE BIPOD PUTTY
PYGMY: CANST DROLE PIGMY PYGMY
QUACK: CANST ARIEL CHUCK QUACK
QUAIL: CANST DROLE GUIMP QUAIL
QUAKE: CANST DROLE AGAZE HEAME QUAKE
QUALM: CANST DROLE MILPA QUALM
QUARK: CANST DROLE MURRI QUARK
QUART: CANST PROLE TURFY QUART
QUASH: CANST REALM WHUPS QUASH
QUASI: CANST REALM WHUPS QUASI
QUEEN: CANST REOIL ENDEW QUEEN
QUEER: CANST DROLE REFER BUMPY QUEER
QUELL: CANST DROLE WELKE QUELL
QUERY: CANST DROLE REFER EXURB QUERY
QUEST: CANST OURIE GUEST QUEST
QUEUE: CANST DROLE GUIMP FUZEE QUEUE
QUICK: CANST LOCIE BULKY QUICK
QUIET: CANST REOIL BIDET QUIET
QUILL: CANST DROLE BILGY WHILK QUILL
QUILT: CANST REOIL BUGLE QUILT
QUIRK: CANST DROLE MURRY QUIRK
QUITE: CANST TORTE FILUM QUITE
QUOTA: CANST TRITE LOATH QUOTA
QUOTE: CANST TORTE AWFUL QUOTE
QUOTH: CANST TORTE PLUTO QUOTH
RABBI: CANST REDLY FUGIO RABBI
RABID: CANST REDLY RABID
RACER: CANST MERCH FLURR RACER
RADAR: CANST REDLY PIXIE RADAR
RADII: CANST REDLY PIXIE RADII
RADIO: CANST REDLY PIXIE RADIO
RAINY: CANST RIVEN RAINY
RAISE: CANST RILEY RAISE
RAJAH: CANST REDLY FUGIO RAJAH
RALLY: CANST REDLY RALLY
RALPH: CANST REDLY RAMAL RALPH
RAMEN: CANST RIVEN RAMEN
RANCH: CANST HIDER RANCH
RANDY: CANST GYBED DRANK RANDY
RANGE: CANST GYBED RANGE
RAPID: CANST REDLY RABID RAPID
RARER: CANST REDLY MERGE RARER
RASPY: CANST MERLS PIOYE RASPY
RATIO: CANST TILER AARTI RATIO
RATTY: CANST TILER PORGY RATTY
RAVEN: CANST RIVEN RAVEN
RAYON: CANST RIVEN RADON RAYON
RAZOR: CANST REDLY FUGIO RAZOR
REACH: CANST ARIEL REACH
REACT: CANST FRAPE REACT
READY: CANST DROLE NEDDY READY
REALM: CANST DROLE REPLA REALM
REARM: CANST DROLE REBAR REARM
REBAR: CANST DROLE REBAR
REBEL: CANST DROLE LIVER BURFI REBEL
REBUS: CANST POLER BEEDI CHUCK REBUS
REBUT: CANST REOIL EMOVE REBUT
RECAP: CANST ARIEL REACH RECAP
RECUR: CANST LOCIE RUTHS RECUR
RECUT: CANST HIDER RECUT
REEDY: CANST DROLE REDID REEDY
REFER: CANST DROLE REFER
REFIT: CANST REOIL RUMBO REFIT
REGAL: CANST DROLE RELAY REGAL
REHAB: CANST DROLE REBAR REHAB
REIGN: CANST REOIL REIGN
RELAX: CANST DROLE RELAY RELAX
RELAY: CANST DROLE RELAY
RELIC: CANST LOCIE RELIC
REMIT: CANST REOIL RUMBO REMIT
RENAL: CANST GELID PRIES RENAL
RENEW: CANST DOGIE SHREW RENEW
REPAY: CANST DROLE REBAR REMAP REPAY
REPEL: CANST DROLE LIVER BURFI REPEL
REPLY: CANST DROLE REFLY REPLY
RERUN: CANST REOIL REMEN RERUN
RESET: CANST POILU WERSH RESET
RESIN: CANST REINS RESIN
RETCH: CANST THEIR RETCH
RETRO: CANST TORTE RETOX RETRO
RETRY: CANST TORTE HILUM DETER RETRY
REUSE: CANST PROLE THUMB REUSE
REVEL: CANST DROLE LIVER REVEL
REVUE: CANST DROLE MIEVE VERGE REVUE
RHINO: CANST REOIL RHINO
RHYME: CANST DROLE MIEVE RYMME RHYME
RIDER: CANST DROLE REDID RIDER
RIDGE: CANST DROLE RIDGE
RIFLE: CANST DROLE FIRMS RIFLE
RIGHT: CANST REOIL RIGHT
RIGID: CANST DROLE MURID RIGID
RIGOR: CANST DROLE GURRY RIGOR
RINSE: CANST SEEDY RINSE
RIPEN: CANST REOIL RIVEN RIPEN
RIPER: CANST DROLE REFER CAMPY RIPER
RISEN: CANST REINS RISEN
RISER: CANST POLER SKIVY RUMBO RISER
RISKY: CANST POLER BIRDS RISKY
RIVAL: CANST DROLE FIRRY HILAR RIVAL
RIVER: CANST DROLE REFER CAMPY RIVER
RIVET: CANST REOIL RIVET
ROACH: CANST ARIEL FURCA ROACH
ROAST: CANST BLORE ROAST
ROBIN: CANST REOIL ROBIN
ROBOT: CANST REOIL ROBOT
ROCKY: CANST LOCIE PORKY ROCKY
RODEO: CANST DROLE ROBED RODEO
ROGER: CANST DROLE PORER GAWKY ROGER
ROGUE: CANST DROLE GUIMP ROGUE
ROOMY: CANST DROLE PIGMY ROOMY
ROOST: CANST OURIE PROST ROOST
ROTOR: CANST TORTE ROTOR
ROUGE: CANST DROLE GUIMP ROGUE ROUGE
ROUGH: CANST DROLE GURRY ROUGH
ROUND: CANST REOIL ROUND
ROUSE: CANST PROLE WHUMP ROUSE
ROUTE: CANST TORTE ROUTE
ROVER: CANST DROLE PORER GAWKY ROVER
ROWDY: CANST DROLE BURRY ROWDY
ROWER: CANST DROLE PORER GAWKY ROWER
ROYAL: CANST DROLE MORPH VOLAR ROYAL
RUDDY: CANST DROLE MURID RUDDY
RUDER: CANST DROLE REDID RUDER
RUGBY: CANST DROLE MURRY RUGGY RUGBY
RULER: CANST DROLE LIVER BUPPY RULER
RUMBA: CANST DROLE MURRI JUMAR RUMBA
RUMOR: CANST DROLE GURRY RUMOR
RUPEE: CANST DROLE MIEVE GERBE RUPEE
RURAL: CANST DROLE FIRRY RURAL
RUSTY: CANST TORTE FRIBS RUSTY
SADLY: CANST MERLS SADLY
SAFER: CANST MERLS BESES GAWKY SAVER SAFER
SAINT: CANST SAUNT SAINT
SALAD: CANST MERLS BIPOD SALAD
SALLY: CANST MERLS SADLY SALLY
SALON: CANST REINS SLOOM SALON
SALSA: CANST RILEY STAPH SALSA
SALTY: CANST TERTS SOPHY SALTY
SALVE: CANST MERLS EVADE SALVE
SALVO: CANST MERLS BIPOD SALVO
SANDY: CANST DREKS SANDY
SANER: CANST DREKS SANER
SAPPY: CANST MERLS SIDHA GALVO SAPPY
SASSY: CANST RILEY SMUGS SASSY
SATIN: CANST TAINS SATIN
SATYR: CANST TERTS SATYR
SAUCE: CANST SMEIK SAUCE
SAUCY: CANST SMEIK SAUCY
SAUNA: CANST REINS SAUNA
SAUTE: CANST TERTS WHUMP SAUTE
SAVOR: CANST MERLS PIOYE SAVOR
SAVOY: CANST MERLS SIDHA GALVO SAVOY
SAVVY: CANST MERLS SIDHA GALVO SAVVY
SCALD: CANST ECRUS PHYLA SCALL SCALD
SCALE: CANST ECRUS SCAPE SCALE
SCALP: CANST ECRUS PHYLA SCALP
SCALY: CANST ECRUS PHYLA SCALY
SCAMP: CANST ECRUS PHYLA SCAMP
SCANT: CANST SCANT
SCARE: CANST ECRUS SCARE
SCARF: CANST ECRUS CAMPY SCARF
SCARY: CANST ECRUS CAMPY SCARY
SCENE: CANST ENOKI SCEND SCENE
SCENT: CANST SCENT
SCION: CANST ENOKI SCION
SCOFF: CANST KIORE GULPS SCODY SCOFF
SCOLD: CANST KIORE GULPS SCOLD
SCONE: CANST ENOKI SCONE
SCOOP: CANST KIORE GULPS SCOOP
SCOPE: CANST KIORE SCOPE
SCORE: CANST KIORE SCORE
SCORN: CANST ENOKI SCORN
SCOUR: CANST KIORE SCOUR
SCOUT: CANST SOUCT SCOUT
SCOWL: CANST KIORE GULPS SCOLD SCOWL
SCRAM: CANST ECRUS GIMPY SCRAM
SCRAP: CANST ECRUS GIMPY SCRAP
SCREE: CANST KIORE SCREE
SCREW: CANST KIORE MERCS SCREW
SCRUB: CANST KIORE SCRUB
SCRUM: CANST KIORE SCRUB SCRUM
SCUBA: CANST ECRUS SCUBA
SEDAN: CANST SLANE KNEED SEDAN
SEEDY: CANST POLER SEEDS SEEDY
SEGUE: CANST POLER SEEDS SEIZE SEGUE
SEIZE: CANST POLER SEEDS SEIZE
SEMEN: CANST REINS VAMPY SEMEN
SENSE: CANST SEEDY SENSE
SEPIA: CANST REALS VESPA SEPIA
SERIF: CANST POLER BEEDI SHIRK SERIF
SERUM: CANST POLER BEEDI SKYFS SERUM
SERVE: CANST POLER BEEDI GALVO SERVE
SETUP: CANST TORTE SKIEY DIMPS SETUP
SEVEN: CANST REINS VAMPY SEVEN
SEVER: CANST POLER SKIVY SEVER
SEWER: CANST POLER SKIVY WEXED SEWER
SHACK: CANST ECRUS WHILK SHACK
SHADE: CANST REALS WHUMP EVADE SHADE
SHADY: CANST REALS WHYDA SHADY
SHAFT: CANST HEPAR FILLE SHAFT
SHAKE: CANST REALS WHUMP EVADE SHAKE
SHAKY: CANST REALS WHYDA SHAKY
SHALE: CANST REALS STAPH SHALE
SHALL: CANST REALS HUMPY SHALL
SHALT: CANST HEPAR FILLE SHALT
SHAME: CANST REALS WHUMP SHAME
SHANK: CANST SLANE KAPHS SHANK
SHAPE: CANST REALS WHUMP SHAPE
SHARD: CANST REALS HOPED SHARD
SHARE: CANST REALS HOWES SHARE
SHARK: CANST REALS HOPED SHARK
SHARP: CANST REALS HOPED SHARP
SHAVE: CANST REALS WHUMP EVADE SHAVE
SHAWL: CANST REALS TWIRP SHAWL
SHEAR: CANST REALS PUKEY HAMZA SHEAR
SHEEN: CANST REINS SOKEN SHEEN
SHEEP: CANST POLER SUIDS SHEEP
SHEER: CANST POLER SKIVY WEXED SHEER
SHEET: CANST POILU WERSH SHEET
SHEIK: CANST POLER SEEDS SMEIK SHEIK
SHELF: CANST POLER WEIDS FEHME SHELF
SHELL: CANST POLER WEIDS FEHME SHELL
SHIED: CANST POLER DISKS SHIED
SHIFT: CANST POILU SHIRT SHIFT
SHINE: CANST REINS STAPH SHINE
SHINY: CANST REINS GULPY SHINY
SHIRE: CANST POLER BEEDI SHIRE
SHIRK: CANST POLER BIRDS SHIRK
SHIRT: CANST POILU SHIRT
SHOAL: CANST REALS PILAU SKOAL SHOAL
SHOCK: CANST KIORE SHOCK
SHONE: CANST REINS SHONE
SHOOK: CANST POLER MUIDS SHOOK
SHOOT: CANST POILU SHROW SHOOT
SHORE: CANST POLER HERDS SHORE
SHORN: CANST REINS SHORN
SHORT: CANST POILU SHROW SHORT
SHOUT: CANST POILU STAPH SHOUT
SHOVE: CANST POLER DEMOS SHOVE
SHOWN: CANST REINS HOLON SHOWN
SHOWY: CANST POLER MUIDS SHOOK SHOWY
SHREW: CANST POLER DERIG SUJEE SHREW
SHRUB: CANST POLER BIRDS SHRUB
SHRUG: CANST POLER BIRDS SURFY SHRUG
SHUCK: CANST KIORE SYLPH SHUCK
SHUNT: CANST UTERI SHUNT
SHUSH: CANST PROLE SHIMS SHUSH
SHYLY: CANST POLER BUIKS SLYLY SHYLY
SIEGE: CANST POLER SEEDS SIEGE
SIEVE: CANST POLER SEEDS SIEGE SIEVE
SIGHT: CANST POILU BESIT SIGHT
SIGMA: CANST REALS SUSHI SIGMA
SILKY: CANST POLER BIGLY SILKY
SILLY: CANST POLER BIGLY SILLY
SINCE: CANST PRIES SINCE
SINEW: CANST GEOID SWERF SINEW
SINGE: CANST GEOID SINGE
SIREN: CANST REINS SIREN
SISSY: CANST PROLE SHIMS SISSY
SIXTH: CANST TORTE SLIMS SIXTH
SIXTY: CANST TORTE SLIMS SIXTH SIXTY
SKATE: CANST TEARS KLETT SKATE
SKIER: CANST POLER SKIVY SKIER
SKIFF: CANST POLER SHIMS SKIFF
SKILL: CANST POLER BUIKS SKILL
SKIMP: CANST POLER SIGHS SKIMP
SKIRT: CANST POILU SHIRT SKIRT
SKULK: CANST POLER BUIKS SKULK
SKULL: CANST POLER BUIKS SKULK SKULL
SKUNK: CANST REINS PLOUK SKUNK
SLACK: CANST ECRUS WHILK SLACK
SLAIN: CANST SLANE SLAIN
SLANG: CANST SLANE SLANG
SLANT: CANST SLANT
SLASH: CANST REALM SKYFS SLASH
SLATE: CANST TEARS KLETT SLATE
SLAVE: CANST REALS EVADE SLAVE
SLEEK: CANST POLER SUIDS SHEEL SLEEK
SLEEP: CANST POLER SLEEP
SLEET: CANST POILU SLEET
SLEPT: CANST POILU SLEPT
SLICE: CANST KIORE SLICE
SLICK: CANST KIORE SPICK SLICK
SLIDE: CANST POLER WEIDS SLIDE
SLIME: CANST POLER WEIDS SLIVE SLIME
SLIMY: CANST POLER BUIKS SWILL SLIMY
SLING: CANST REINS GULPY SLING
SLINK: CANST REINS GULPY SLINK
SLOOP: CANST POLER SPROG SLOOP
SLOPE: CANST POLER ELOPS SLOPE
SLOSH: CANST PROLE FLOSS SLOSH
SLOTH: CANST TORTE LISPS SLOTH
SLUMP: CANST POLER SLIPS SLUMP
SLUNG: CANST REINS PLOUK SLUNG
SLUNK: CANST REINS PLOUK SLUNK
SLURP: CANST POLER SLURP
SLUSH: CANST PROLE FUSKS SLUSH
SLYLY: CANST POLER BUIKS SLYLY
SMACK: CANST ECRUS WHILK SMACK
SMALL: CANST REALS HUMPY SMALM SMALL
SMART: CANST HEPAR WHILK SMART
SMASH: CANST REALM SMASH
SMEAR: CANST REALS PUKEY HAMZA SMEAR
SMELL: CANST POLER WEIDS FEHME SMELL
SMELT: CANST POILU SMELT
SMILE: CANST POLER WEIDS SLIVE SMILE
SMIRK: CANST POLER BIRDS SHIRK SMIRK
SMITE: CANST TORTE GUIMP SMITE
SMITH: CANST TORTE SLIMS SMITH
SMOCK: CANST KIORE SHOCK SMOCK
SMOKE: CANST POLER DEMOS SMOKE
SMOKY: CANST POLER MUIDS SMOKO SMOKY
SMOTE: CANST TORTE SMOTE
SNACK: CANST SCAND SNACK
SNAIL: CANST SLANE SNARL SNAIL
SNAKE: CANST SLANE SNARE SNAKE
SNAKY: CANST SLANE WHIRS SNAFU SNAKY
SNARE: CANST SLANE SNARE
SNARL: CANST SLANE SNARL
SNEAK: CANST SLANE KNEED SNEAK
SNEER: CANST REINS NOSER SNEER
SNIDE: CANST REINS SNIDE
SNIFF: CANST REINS SNIFF
SNIPE: CANST REINS SNIDE SNIPE
SNOOP: CANST REINS HOLON PAYED SNOOP
SNORE: CANST REINS NOSER SNORE
SNORT: CANST UTERI SNORT
SNOUT: CANST UTERI SHUNT SNOUT
SNOWY: CANST REINS HOLON SNOWK SNOWY
SNUCK: CANST ENOKI SNUCK
SNUFF: CANST REINS HOLON SNUFF
SOAPY: CANST REALS WHYDA SOAPY
SOBER: CANST POLER SHREW SOGER SOBER
SOGGY: CANST POLER DUMKY SOGGY
SOLAR: CANST REALS SURAL SOLAR
SOLID: CANST POLER KHUDS SOLID
SOLVE: CANST POLER SOLDE SOLVE
SONAR: CANST MEOUS SONAR
SONIC: CANST PRIES SONIC
SOOTH: CANST TORTE SULPH SOWTH SOOTH
SOOTY: CANST TORTE SULPH SOFTS SOOTY
SORRY: CANST POLER BURDS SORRY
SOUND: CANST REINS PLOUK SOUND
SOUTH: CANST TORTE SULPH SOUTH
SOWER: CANST POLER SHREW SOWER
SPACE: CANST ECRUS SPACE
SPADE: CANST REALS WHUMP SPAKE SPADE
SPANK: CANST SLANE KAPHS SPANK
SPARE: CANST REALS HOWES SPARE
SPARK: CANST REALS HOPED SPARK
SPASM: CANST REALM SPASM
SPAWN: CANST SLANE WHIRS SPAWN
SPEAK: CANST REALS ASKED SPEAK
SPEAR: CANST REALS PUKEY SPEAR
SPECK: CANST KIORE BUMPH PECKS SPECK
SPEED: CANST POLER SUIDS SPEED
SPELL: CANST POLER SPEIL SPELL
SPELT: CANST POILU SPELT
SPEND: CANST REINS SHONE SPEND
SPENT: CANST UTERI SHENT SPENT
SPERM: CANST POLER SPIRE SPERM
SPICE: CANST KIORE SLICE SPICE
SPICY: CANST KIORE MUILS SPICY
SPIED: CANST POLER SUIDS SPIED
SPIEL: CANST POLER SLEEP SPIEL
SPIKE: CANST POLER SKEWS SPIKE
SPIKY: CANST POLER SIGHS SKIMP SPIKY
SPILL: CANST POLER SLIPS SPILL
SPILT: CANST POILU SPILT
SPINE: CANST REINS STAPH SPINE
SPINY: CANST REINS GULPY SPINY
SPIRE: CANST POLER SPIRE
SPITE: CANST TORTE GUIMP SPITE
SPLAT: CANST HEPAR SPLAT
SPLIT: CANST POILU SPLIT
SPOIL: CANST POLER SPROG SPOIL
SPOKE: CANST POLER SPODE SPOKE
SPOOF: CANST POLER SPOOM SPOOK SPOOF
SPOOK: CANST POLER SPOOM SPOOK
SPOOL: CANST POLER SPROG SPOOL
SPOON: CANST REINS HOLON SWOON SPOON
SPORE: CANST POLER SPORE
SPORT: CANST POILU WOOPY SPORT
SPOUT: CANST POILU SPOUT
SPRAY: CANST REALS SORRY SPRAY
SPREE: CANST POLER DIANE SPREE
SPRIG: CANST POLER GIRRS SPRIG
SPUNK: CANST REINS PLOUK SPUNK
SPURN: CANST REINS SHORN SPURN
SPURT: CANST POILU SPURT
SQUAD: CANST REALS SUSHI REBID SQUAD
SQUAT: CANST HEPAR STOAT SQUAT
SQUIB: CANST POLER SHIMS REBID SQUIB
STACK: CANST SCATS STACK
STAFF: CANST TEARS HIPLY STAFF
STAGE: CANST TEARS KLETT RAGED STAGE
STAID: CANST TEARS HIPLY STAIG STAID
STAIN: CANST SEGNI STAIN
STAIR: CANST TEARS STAIR
STAKE: CANST TEARS KLETT STAKE
STALE: CANST TEARS KLETT STALE
STALK: CANST TEARS HIPLY STALK
STALL: CANST TEARS HIPLY STALK STALL
STAMP: CANST TEARS HIPLY STAMP
STAND: CANST SEGNI STAND
STANK: CANST SEGNI STAND STANK
STARE: CANST TEARS STARE
STARK: CANST TEARS STARK
START: CANST HEPAR WHILK SMART START
STASH: CANST TRASS STASH
STATE: CANST TEARS KLETT STATE
STAVE: CANST TEARS KLETT RAGED STAVE
STEAD: CANST TEARS MOULD STEAD
STEAK: CANST TEARS MOULD STEAK
STEAL: CANST TEARS MOULD STEAL
STEAM: CANST TEARS MOULD STEAM
STEED: CANST TORTE SKIEY ALMUD STEED
STEEL: CANST TORTE SKIEY ALMUD STEEL
STEEP: CANST TORTE SKIEY ALMUD STEEP
STEER: CANST TORTE RITES STEER
STEIN: CANST REINS STEIN
STERN: CANST REINS STERN
STICK: CANST KIORE STICK
STIFF: CANST TORTE MUILS STIVY STIFF
STILL: CANST TORTE MUILS STILB STILL
STILT: CANST POILU STILT
STING: CANST REINS STINK STING
STINK: CANST REINS STINK
STINT: CANST UTERI STINT
STOCK: CANST KIORE STOCK
STOIC: CANST KIORE STOIC
STOKE: CANST TORTE PULIK STOKE
STOLE: CANST TORTE PULIK STOLE
STOMP: CANST TORTE WOOPY STOUP STOMP
STONE: CANST REINS STONE
STONY: CANST REINS DYKON STONY
STOOD: CANST TORTE WOOPY LODEN STOOD
STOOL: CANST TORTE WOOPY LODEN STOOL
STOOP: CANST TORTE WOOPY STOOP
STORE: CANST TORTE STORE
STORK: CANST TORTE DUMKY STORK
STORM: CANST TORTE DUMKY STORM
STORY: CANST TORTE DUMKY STORY
STOUT: CANST POILU STAPH STOUT
STOVE: CANST TORTE PULIK STOVE
STRAP: CANST TEARS GOPIK STRAP
STRAW: CANST TEARS GOPIK SCODY STRAW
STRAY: CANST TEARS GOPIK SCODY STRAY
STRIP: CANST TORTE PUGIL STRIP
STRUT: CANST POILU STRUT
STUCK: CANST KIORE STUCK
STUDY: CANST TORTE MUILS STUFF STUDY
STUFF: CANST TORTE MUILS STUFF
STUMP: CANST TORTE MUILS SHTUM STUMP
STUNG: CANST REINS DYKON STUNG
STUNK: CANST REINS DYKON STUNK
STUNT: CANST UTERI STUNT
STYLE: CANST TORTE IMPLY STYLE
SUAVE: CANST REALS WHUMP USAGE SUAVE
SUGAR: CANST REALS SORRY SIMAR SUGAR
SUING: CANST REINS GULPY SUING
SUITE: CANST TORTE GUIMP SUITE
SULKY: CANST POLER BIGLY SULKY
SULLY: CANST POLER BIGLY SULLY
SUMAC: CANST ECRUS MUSCA SUMAC
SUNNY: CANST GEOID SYLPH SUNNY
SUPER: CANST POLER BUIST SUPER
SURER: CANST POLER SKIVY WEXED SURER
SURGE: CANST POLER BEEDI ERUVS SURGE
SURLY: CANST POLER BUIKS SURLY
SUSHI: CANST POLER SHIMS SUSHI
SWAMI: CANST REALS WHYDA SWAMI
SWAMP: CANST REALS WHYDA SWAMI SWAMP
SWARM: CANST REALS HOPED SMARM SWARM
SWASH: CANST REALM WHUPS AWASH SWASH
SWATH: CANST TEARS HIPLY SWATH
SWEAR: CANST REALS PUKEY HAMZA SWEAR
SWEAT: CANST HEPAR SWEAT
SWEEP: CANST POLER SUIDS SHEEP SWEEP
SWEET: CANST POILU WERSH SWEET
SWELL: CANST POLER WEIDS SWELL
SWEPT: CANST POILU SWEPT
SWIFT: CANST POILU SHIRT SWIFT
SWILL: CANST POLER BUIKS SWILL
SWINE: CANST REINS STAPH SWINE
SWING: CANST REINS GULPY SWING
SWIRL: CANST POLER BUIKS SWIRL
SWISH: CANST PROLE SHIMS SWISH
SWOON: CANST REINS HOLON SWOON
SWOOP: CANST POLER SPOOM SWOOP
SWORD: CANST POLER DROOG SWORD
SWORE: CANST POLER HERDS SMORE SWORE
SWORN: CANST REINS SHORN SWORN
SWUNG: CANST REINS PLOUK SWUNG
SYNOD: CANST GEOID SYNOD
SYRUP: CANST POLER GIRRS SYRUP
TABBY: CANST TILER GOTHY BUMFS TABBY
TABLE: CANST TILER TABLE
TABOO: CANST TILER GOTHY TABOO
TACIT: CANST FILLE TACIT
TACKY: CANST HOTLY TACKY
TAFFY: CANST TILER GOTHY BUMFS TAFFY
TAINT: CANST THRID TAINT
TAKEN: CANST TELOI TAPEN TAKEN
TAKER: CANST TILER ABAMP TWIXT TAKER
TALLY: CANST TILER PASKA TALLY
TALON: CANST TELOI TALON
TAMER: CANST TILER ABAMP TAMER
TANGO: CANST MOTTY TANGO
TANGY: CANST MOTTY TANGY
TAPER: CANST TILER ABAMP TAPER
TAPIR: CANST TILER TAPIR
TARDY: CANST TILER ADYTA TARDY
TAROT: CANST GEBUR TAROT
TASTE: CANST TERTS TASTE
TASTY: CANST TERTS TASTY
TATTY: CANST TILER GOTHY TATTY
TAUNT: CANST THRID TAUNT
TAWNY: CANST TELOI TAWNY
TEACH: CANST TITRE TEACH
TEARY: CANST TRITE TERRA TEARY
TEASE: CANST TRASS TEASE
TEDDY: CANST TORTE WEDEL TEDDY
TEETH: CANST TORTE TEETH
TEMPO: CANST TORTE TELOI TEMPO
TENET: CANST BOUGE DENET TENET
TENOR: CANST ROUTE TENOR
TENSE: CANST TENSE
TENTH: CANST ROUTE THIGH TENTH
TEPEE: CANST TORTE ILEUM TEPEE
TEPID: CANST TORTE WEDEL TEIID TEPID
TERRA: CANST TRITE TERRA
TERSE: CANST KIORE TERSE
TESTY: CANST TORTE TESTY
THANK: CANST TIARA SKEWS THANK
THEFT: CANST REOIL UNMEW THEFT
THEIR: CANST TORTE WRIER THEIR
THEME: CANST TORTE ILEUM THEME
THERE: CANST TORTE KRUBI THERE
THESE: CANST KIORE TEMSE THESE
THETA: CANST TRITE THETA
THICK: CANST THEIR THICK
THIEF: CANST TORTE WEDEL TYPEY THIEF
THIGH: CANST TORTE HIPLY THIGH
THING: CANST TITRE GOTHY THING
THINK: CANST TITRE GOTHY THINK
THIRD: CANST TORTE THIRL THIRD
THONG: CANST TITRE THONG
THORN: CANST TITRE THORN
THOSE: CANST KIORE THOSE
THREE: CANST TORTE THREE
THREW: CANST TORTE WIRED THREW
THROB: CANST TORTE THROB
THROW: CANST TORTE THROB THROW
THRUM: CANST TORTE THRID THRUM
THUMB: CANST TORTE HIPLY THUMB
THUMP: CANST TORTE HIPLY THUMP
THYME: CANST TORTE ILEUM THYME
TIARA: CANST TRITE TIARA
TIBIA: CANST TRITE HELIO TIBIA
TIDAL: CANST TRITE HELIO TIDAL
TIGER: CANST TORTE WRIER GULLY TIGER
TIGHT: CANST REOIL TWIRP TIGHT
TILDE: CANST TORTE ILEUM TILDE
TIMER: CANST TORTE WRIER GULLY TIMER
TIMID: CANST TORTE HIPLY TIMID
TIPSY: CANST KIORE DITSY TIPSY
TITAN: CANST TIARA TITAN
TITHE: CANST TORTE TITHE
TITLE: CANST TORTE TITHE TITLE
TOAST: CANST BLORE TOAST
TODAY: CANST TRITE GOLDY TODAY
TODDY: CANST TORTE DUMPY TODDY
TOKEN: CANST TITRE TEEND TOKEN
TONAL: CANST KELTY TONAL
TONGA: CANST KELTY TONGA
TONIC: CANST TONIC
TOOTH: CANST TORTE TOOTH
TOPAZ: CANST TRITE GOLDY TOPAZ
TOPIC: CANST THEIR TOPIC
TORCH: CANST THEIR TORCH
TORSO: CANST KIORE TORSO
TORUS: CANST TORTE LURRY TORUS
TOTAL: CANST TRITE TOTAL
TOTEM: CANST TORTE TOTEM
TOUCH: CANST THEIR TOUCH
TOUGH: CANST TORTE DUMPY TOUGH
TOWEL: CANST TORTE KELPY TOWEL
TOWER: CANST TORTE WOOPY TOWER
TOXIC: CANST THEIR TOPIC TOXIC
TOXIN: CANST TITRE GOTHY TOXIN
TRACE: CANST TITRE TRACE
TRACK: CANST TITRE TRACK
TRACT: CANST FRAPE TRACT
TRADE: CANST TRITE PAYED TRADE
TRAIL: CANST TRITE TRAIL
TRAIN: CANST TIARA TRAIN
TRAIT: CANST PROLE FIKED TRAIT
TRAMP: CANST TRITE DUMKY TRAMP
TRASH: CANST TRASS TRASH
TRAWL: CANST TRITE DUMKY TRAWL
TREAD: CANST TRITE TREFA TREAD
TREAT: CANST PROLE GLEAM TREAT
TREND: CANST TITRE TREND
TRIAD: CANST TRITE TRIAL TRIAD
TRIAL: CANST TRITE TRIAL
TRIBE: CANST TORTE KRUBI TRIBE
TRICE: CANST THEIR TRICE
TRICK: CANST THEIR TRICK
TRIED: CANST TORTE WRIER TRIED
TRIPE: CANST TORTE KRUBI TRIDE TRIPE
TRITE: CANST TORTE TRITE
TROLL: CANST TORTE POLIO TROLL
TROOP: CANST TORTE POLIO TROOP
TROPE: CANST TORTE VODKA TROPE
TROUT: CANST REOIL TWERP TROUT
TROVE: CANST TORTE VODKA TROVE
TRUCE: CANST THEIR TERCE TRUCE
TRUCK: CANST THEIR TRUCK
TRUER: CANST TORTE WRIER TRUER
TRULY: CANST TORTE THIRL TRULY
TRUMP: CANST TORTE THIRL TRUMP
TRUNK: CANST TITRE TRUNK
TRUSS: CANST KIORE TRUSS
TRUST: CANST OURIE THUMB TRUST
TRUTH: CANST TORTE TRUTH
TRYST: CANST OURIE TRYST
TUBAL: CANST TRITE GOLDY TUBAL
TUBER: CANST TORTE WRIER TYLER TUBER
TULIP: CANST TORTE HIPLY TULIP
TULLE: CANST TORTE ILEUM TULLE
TUMOR: CANST TORTE POLIO TUMOR
TUNIC: CANST TONIC TUNIC
TURBO: CANST TORTE THROB TURBO
TUTOR: CANST TORTE TUTOR
TWANG: CANST TIARA SKEWS TWANG
TWEAK: CANST TRITE ALMUD TWEAK
TWEED: CANST TORTE WEDEL TWEED
TWEET: CANST REOIL UNMEW TWEET
TWICE: CANST THEIR TICED TWICE
TWINE: CANST TITRE THINE TWINE
TWIRL: CANST TORTE THIRL TWIRL
TWIST: CANST OURIE DHOWS TWIST
TWIXT: CANST REOIL TWIRP TWIXT
TYING: CANST TITRE GOTHY TYING
UDDER: CANST DROLE REDID UDDER
ULCER: CANST LOCIE ULCER
ULTRA: CANST TRITE ALTAR ULTRA
UMBRA: CANST DROLE MURRI UMBRA
UNCLE: CANST NICER UNCLE
UNCUT: CANST INCUT UNCUT
UNDER: CANST REOIL UPEND UNDER
UNDID: CANST REOIL DUPED UNDID
UNDUE: CANST REOIL ENDEW UNDUE
UNFED: CANST REOIL ENDEW KRABS UNFED
UNFIT: CANST PLIER QUOIF UNFIT
UNIFY: CANST REOIL HINNY UNIFY
UNION: CANST REOIL GOMBO UNION
UNITE: CANST TITRE UNITE
UNITY: CANST TITRE UNITY
UNLIT: CANST PLIER UNLIT
UNMET: CANST PLIER GAWKY UNMET
UNSET: CANST UTERI UNSET
UNTIE: CANST TITRE UNTIE
UNTIL: CANST TITRE UNTIL
UNWED: CANST REOIL ENDEW UNWED
UNZIP: CANST REOIL DUPED UNZIP
UPPER: CANST DROLE REFER BUMPH UPPER
UPSET: CANST POILU SPURT UPSET
URBAN: CANST ALGAE RUMBO UNBAR URBAN
URINE: CANST REOIL UNGET URINE
USAGE: CANST REALS WHUMP USAGE
USHER: CANST POLER SKIVY MUSER USHER
USING: CANST REINS GULPY USING
USUAL: CANST REALS PILAU USUAL
USURP: CANST POLER GIRRS USURP
UTILE: CANST TORTE HAILY UTILE
UTTER: CANST TORTE UTTER
VAGUE: CANST REDLY GUMMI VAGUE
VALET: CANST GEBUR TAPET VALET
VALID: CANST REDLY HALID VALID
VALOR: CANST REDLY LIVOR VALOR
VALUE: CANST REDLY AGAVE VALUE
VALVE: CANST REDLY AGAVE VALVE
VAPID: CANST REDLY VIGIA VAPID
VAPOR: CANST REDLY MARIA FAVOR VAPOR
VAULT: CANST GEBUR VOZHD VAULT
VAUNT: CANST THRID JIVEY VAUNT
VEGAN: CANST ALGAE VEGAN
VENOM: CANST DOGIE XENON VENOM
VENUE: CANST DOGIE RUMBO VENUE
VERGE: CANST DROLE MIEVE VERGE
VERSE: CANST PROLE THUMB VERSE
VERSO: CANST PROLE VERSO
VERVE: CANST DROLE MIEVE PANKO VERVE
VICAR: CANST ARIEL MICRA VICAR
VIDEO: CANST DROLE OOMPH VIDEO
VIGIL: CANST DROLE GIMPY VIGIL
VIGOR: CANST DROLE GURRY VIGOR
VILLA: CANST DROLE MILPA ZILLA VILLA
VINYL: CANST DOGIE KELPY VINYL
VIOLA: CANST DROLE AIOLI VIOLA
VIPER: CANST DROLE REFER BUMPH PAWKS VIPER
VIRAL: CANST DROLE FIRRY VIRAL
VIRUS: CANST POLER BIRDS MURKY VIRUS
VISIT: CANST POILU BESIT VISIT
VISOR: CANST POLER SMOOR VISOR
VISTA: CANST TEARS SOUPS VISTA
VITAL: CANST TRITE VITAL
VIVID: CANST DROLE GIMPY BIFID VIVID
VIXEN: CANST REOIL EWKED MIXEN VIXEN
VOCAL: CANST ARIEL LOVER VOCAL
VODKA: CANST DROLE BIVIA VODKA
VOGUE: CANST DROLE PIGMY BOGUE VOGUE
VOICE: CANST LOCIE VOICE
VOILA: CANST DROLE MILKY VOILA
VOMIT: CANST REOIL OUBIT VOMIT
VOTER: CANST TORTE VOTER
VOUCH: CANST LOCIE GRUMP VOUCH
VOWEL: CANST DROLE VUGHY VOXEL VOWEL
VYING: CANST REOIL HINNY VYING
WACKY: CANST MERCH JIVEY WACKY
WAFER: CANST REDLY PORGE WAKFS WAFER
WAGER: CANST REDLY PORGE GEMEL JAGER WAGER
WAGON: CANST RIVEN GOLDY WAGON
WAIST: CANST SMEIK WAIST
WAIVE: CANST REDLY GUMMI WHILK WAIVE
WALTZ: CANST TILER WALTY WALTZ
WARTY: CANST TILER PORGY WARTY
WASTE: CANST TERTS WHUMP WASTE
WATCH: CANST HOTLY GRUMP WATCH
WATER: CANST TILER EPHOD REGMA WATER
WAVER: CANST REDLY PORGE WAKFS WAXER WAVER
WAXEN: CANST RIVEN WONKY WAXEN
WEARY: CANST DROLE REBAR HOMEY WEARY
WEAVE: CANST DROLE AGAZE HEAME WEAVE
WEDGE: CANST DROLE MUJIK HEDGE WEDGE
WEEDY: CANST DROLE WIMPY WEDGY WEEDY
WEIGH: CANST DROLE WIMPY WEIGH
WEIRD: CANST DROLE REDID WEIRD
WELCH: CANST LOCIE BEWET WELCH
WELSH: CANST PROLE LEISH WELSH
WENCH: CANST HOMIE DAWKS WENCH
WHACK: CANST ARIEL CHUCK WHACK
WHALE: CANST DROLE GUIMP ABELE WHALE
WHARF: CANST DROLE MURRI WHARF
WHEAT: CANST PROLE HEADY WHEAT
WHEEL: CANST DROLE BEGEM FLEEK WHEEL
WHELP: CANST DROLE WELKE WHELP
WHERE: CANST DROLE MIEVE WHERE
WHICH: CANST LOCIE BULKY WHICH
WHIFF: CANST DROLE PIGMY BUFFI WHIFF
WHILE: CANST DROLE BIGHT WHILE
WHINE: CANST REOIL EWKED WHINE
WHINY: CANST REOIL HINNY WHINY
WHIRL: CANST DROLE LURRY WHIRL
WHISK: CANST PROLE SHIMS WHISH WHISK
WHITE: CANST TORTE FILUM WHITE
WHOLE: CANST DROLE WHOLE
WHOOP: CANST DROLE BUMPH WHOOP
WHOSE: CANST PROLE WOMBS WHOSE
WIDEN: CANST REOIL EWKED WIDEN
WIDER: CANST DROLE REDID BEWET WIDER
WIDOW: CANST DROLE MIDDY WIDOW
WIDTH: CANST TORTE FILMY WIDTH
WIELD: CANST DROLE BIFFY WIELD
WIGHT: CANST REOIL TWIRP WIGHT
WILLY: CANST DROLE BILGY FIRTH WILLY
WIMPY: CANST DROLE PIGMY JIMPY WIMPY
WINCE: CANST HOMIE YINCE WINCE
WINCH: CANST HOMIE WOLFS WINCH
WINDY: CANST DOGIE LURRY WINDY
WISER: CANST POLER SKIVY RUMBO WISER
WISPY: CANST POLER SIGHS WISPY
WITCH: CANST THEIR BIFID GUIMP WITCH
WITTY: CANST TORTE BIPOD WITTY
WOKEN: CANST REOIL VOWED MUSKS WOKEN
WOMAN: CANST ALGAE RUMBO WOMAN
WOMEN: CANST REOIL VOWED MUSKS WOMEN
WOODY: CANST DROLE WOMBY WOODY
WOOER: CANST DROLE WOOER
WOOLY: CANST DROLE GOMBO HOOLY WOOLY
WOOZY: CANST DROLE BUMPH GOWFS WOOZY
WORDY: CANST DROLE BURRY WORDY
WORLD: CANST DROLE WORLD
WORRY: CANST DROLE GURRY WORRY
WORSE: CANST PROLE WHUMP WORSE
WORST: CANST OURIE WORST
WORTH: CANST TORTE FORBY WORTH
WOULD: CANST DROLE MOULD WOULD
WOUND: CANST REOIL DOWNY WOUND
WOVEN: CANST REOIL VOWED WOVEN
WRACK: CANST ARIEL DHOWS WRACK
WRATH: CANST TRITE WRATH
WREAK: CANST DROLE FUBAR WREAK
WRECK: CANST LOCIE MERED WRECK
WREST: CANST OURIE TEPID WREST
WRING: CANST REOIL DEBUG WRING
WRIST: CANST OURIE GOWFS WRIST
WRITE: CANST TORTE BRUTE WRITE
WRONG: CANST REOIL DWANG WRONG
WROTE: CANST TORTE WROTE
WRUNG: CANST REOIL GRUND WRUNG
WRYLY: CANST DROLE GOPIK WRYLY
YACHT: CANST FILLE YACHT
YEARN: CANST ALGAE REAMY YEARN
YEAST: CANST BLORE FIRTH YEAST
YIELD: CANST DROLE BIFFY YIELD
YOUNG: CANST REOIL DOWNY YOUNG
YOUTH: CANST TORTE BOOFY YOUTH
ZEBRA: CANST DROLE REBAR ZEBRA
ZESTY: CANST TORTE LISPS YARFA ZESTY
ZONAL: CANST GELID MUCOR ZONAL
Success: 2315
Fail: 0
Avg guess: 3.956
