ABACK: CLAST BROKE ABACK
ABASE: CLAST RHEUM PESOS ABASE
ABATE: CLAST TRONE ALGUM ABATE
ABBEY: CLAST MARAE HOUND APEEK ABBEY
ABBOT: CLAST GRONE ABBOT
ABHOR: CLAST MARAE ADORN ARBOR ABHOR
ABIDE: CLAST MARAE BOING ABIDE
ABLED: CLAST MARAE WILGA AXLED ABLED
ABODE: CLAST MARAE BOING ABODE
ABORT: CLAST GRONE PRAMS ABORT
ABOUT: CLAST GRONE DUMMY ABOUT
ABOVE: CLAST MARAE BOING ABODE ABOVE
ABUSE: CLAST MAIRE ABUSE
ABYSS: CLAST MAIRE ABYSS
ACORN: CLAST NICER RANCH ACORN
ACRID: CLAST NICER RABIC ACRID
ACTOR: CLAST AROHA ACTOR
ACUTE: CLAST AROHA ACTIN ACUTE
ADAGE: CLAST DRONE EVADE ADAGE
ADAPT: CLAST PRUNE ADAPT
ADEPT: CLAST GRONE HEXED ADEPT
ADMIN: CLAST MARAE DOING ADMIN
ADMIT: CLAST GRONE UMIAK ADMIT
ADOBE: CLAST MARAE BOING ABODE ADOBE
ADOPT: CLAST GRONE DUMMY ADOPT
ADORE: CLAST MARAE GOURD ADORE
ADORN: CLAST MARAE ADORN
ADULT: CLAST VAGUE ADULT
AFFIX: CLAST MARAE POIND BIVIA AFFIX
AFIRE: CLAST MARAE GOURD AFIRE
AFOOT: CLAST GRONE DUMMY AFOOT
AFOUL: CLAST MARAE VIOLA AFOUL
AFTER: CLAST TORTE PAGED AFTER
AGAIN: CLAST DRONE AMAIN AGAIN
AGAPE: CLAST DRONE WEIGH VESPA AGAPE
AGATE: CLAST TRONE ALGUM AGATE
AGENT: CLAST GRONE AGENT
AGILE: CLAST MARAE BOING AGILE
AGING: CLAST MARAE POIND WHAUP KEXES AGING
AGLOW: CLAST MARAE VIOLA AGLOW
AGONY: CLAST MARAE POIND AGONY
AGORA: CLAST MARAE AROHA AGORA
AGREE: CLAST MARAE AERIE AGREE
AHEAD: CLAST MARAE APEAK AHEAD
AIDER: CLAST MARAE PINED AIDER
AISLE: CLAST SALLE AISLE
ALARM: CLAST FERNY GLAIR ALARM
ALBUM: CLAST AGONE DIMLY ALBUM
ALERT: CLAST PROFS ALERT
ALGAE: CLAST AGONE ALGAE
ALIBI: CLAST AGONE DIMLY ALIBI
ALIEN: CLAST AGONE ALIEN
ALIGN: CLAST AGONE ALIGN
ALIKE: CLAST AGONE BULKY ALIKE
ALIVE: CLAST AGONE BULKY ALIVE
ALLAY: CLAST AGONE DIMLY ALWAY ALLAY
ALLEY: CLAST AGONE ARLED ALLEY
ALLOT: CLAST PROFS ALLOT
ALLOW: CLAST AGONE WELLY ALLOW
ALLOY: CLAST AGONE WELLY ALLOY
ALOFT: CLAST PROFS ALOFT
ALONE: CLAST AGONE ALONE
ALONG: CLAST AGONE ALONG
ALOOF: CLAST AGONE FURTH ALOOF
ALOUD: CLAST AGONE FURTH ALOUD
ALPHA: CLAST AGONE DIMLY ALPHA
ALTAR: CLAST ALTER ALTAR
ALTER: CLAST ALTER
AMASS: CLAST RHEUM OMASA AMASS
AMAZE: CLAST DRONE WEIGH AMAZE
AMBER: CLAST MARAE BREID AMBER
AMBLE: CLAST MARAE POUPE AMBLE
AMEND: CLAST MARAE EMEND AMEND
AMISS: CLAST MAIRE APISM AMISS
AMITY: CLAST TORTE BANYA AMITY
AMONG: CLAST MARAE DOING AMONG
AMPLE: CLAST MARAE POUPE AMPLE
AMPLY: CLAST MARAE MUMPS AMPLY
AMUSE: CLAST MAIRE AMUSE
ANGEL: CLAST MARAE WILGA ANGEL
ANGER: CLAST MARAE PINED ANKER ANGER
ANGLE: CLAST MARAE BOING ANGLE
ANGRY: CLAST MARAE ADORN ANGRY
ANGST: CLAST WAIDE ANGST
ANIME: CLAST MARAE AMINE ANIME
ANKLE: CLAST MARAE BOING ANELE ANKLE
ANNEX: CLAST MARAE HOUND ANNEX
ANNOY: CLAST MARAE POIND ANYON ANNOY
ANNUL: CLAST MARAE VIOLA AWFUL ANNUL
ANODE: CLAST MARAE BOING ANODE
ANTIC: CLAST AROHA ACTIN ANTIC
ANVIL: CLAST MARAE VIOLA ANVIL
AORTA: CLAST TORTE AORTA
APART: CLAST PRUNE APART
APHID: CLAST MARAE POIND APHID
APING: CLAST MARAE POIND APING
APNEA: CLAST MARAE APNEA
APPLE: CLAST MARAE BOING ADDLE APPLE
APPLY: CLAST MARAE VIOLA AHULL APPLY
APRON: CLAST MARAE BOURN APRON
APTLY: CLAST TALEA DROLL APTLY
ARBOR: CLAST MARAE ADORN ARBOR
ARDOR: CLAST MARAE ADORN ARDOR
ARENA: CLAST MARAE AREPA ARENA
ARGUE: CLAST MARAE GOURD ARGUE
ARISE: CLAST MAIRE ARISE
ARMOR: CLAST MARAE AMOUR ARMOR
AROMA: CLAST MARAE AROMA
AROSE: CLAST MAIRE AROSE
ARRAY: CLAST MARAE ARRAY
ARROW: CLAST MARAE BOURN ARROW
ARSON: CLAST NARES SONAR ARSON
ARTSY: CLAST NOTER ARTSY
ASCOT: CLAST SCEAT ASCOT
ASHEN: CLAST NARES ASPEN ASHEN
ASIDE: CLAST NARES SEPIA ASIDE
ASKEW: CLAST NARES ASKED ASKEW
ASSAY: CLAST NARES SUSHI ASSAY
ASSET: CLAST URSAE ASSET
ATOLL: CLAST TALEA DROLL ATOLL
ATONE: CLAST TORTE ATOKE ATONE
ATTIC: CLAST AROHA ACTIN ATTIC
AUDIO: CLAST MARAE POIND ADDIO AUDIO
AUDIT: CLAST GRONE UMIAK AUDIT
AUGUR: CLAST MARAE ADORN AUGUR
AUNTY: CLAST TORTE BANYA AUNTY
AVAIL: CLAST LIVRE AVAIL
AVERT: CLAST GRONE VESPA AVERT
AVIAN: CLAST MARAE VIAND AVIAN
AVOID: CLAST MARAE POIND AXOID AVOID
AWAIT: CLAST PRUNE KIAAT AWAIT
AWAKE: CLAST DRONE WEIGH AWAVE AWAKE
AWARD: CLAST DRONE INCUS AWARD
AWARE: CLAST DRONE WHUMP AWARE
AWASH: CLAST RHEUM SHEWN AWASH
AWFUL: CLAST MARAE VIOLA AWFUL
AWOKE: CLAST MARAE BOING ADOZE AWOKE
AXIAL: CLAST MARAE FLING AXIAL
AXIOM: CLAST MARAE DOING AXIOM
AXION: CLAST MARAE POIND ANNEX AXION
AZURE: CLAST MARAE GOURD AZURE
BACON: CLAST NICER BACON
BADGE: CLAST MARAE FUNGI GOBAN BADGE
BADLY: CLAST MARAE DILLY BADLY
BAGEL: CLAST MARAE LOWND VUGHY BAGEL
BAGGY: CLAST MARAE DINGY FLUBS BAGGY
BAKER: CLAST MARAE PODGY WAKFS BAJAN BAKER
BALER: CLAST MARAE WYLED PHONS BALER
BALMY: CLAST MARAE PALMY BALMY
BANAL: CLAST MARAE GHYLL FUNKY BANAL
BANJO: CLAST MARAE DINGY PANKO BANJO
BARGE: CLAST MARAE GYBED BARGE
BARON: CLAST MARAE BIPOD BARON
BASAL: CLAST SALLE BRINK BASAL
BASIC: CLAST MARES SAUCY BASIC
BASIL: CLAST SALLE BRINK BASIL
BASIN: CLAST NARES GOBAN BASIN
BASIS: CLAST NARES GUIMP SKEDS BASIS
BASTE: CLAST TERTS WHAUP BASTE
BATCH: CLAST AROHA MINGY HOWBE BATCH
BATHE: CLAST TORTE EVOHE BATHE
BATON: CLAST TORTE MANES BATON
BATTY: CLAST TORTE NUBIA BATTY
BAWDY: CLAST MARAE DINGY UPBOW BAWDY
BAYOU: CLAST MARAE DINGY YAPOK BAYOU
BEACH: CLAST BROKE BEACH
BEADY: CLAST DRONE BAAED BEADY
BEARD: CLAST DRONE HOODY BEARD
BEAST: CLAST BROGH BEAST
BEECH: CLAST HONER MIRKY BEECH
BEEFY: CLAST RONDE WIMPY FUZEE BEEFY
BEFIT: CLAST PROIN GIBED BEFIT
BEGAN: CLAST MARAE BENDY BEGAN
BEGAT: CLAST GRONE BEGAT
BEGET: CLAST PROIN MEWED BEGET
BEGIN: CLAST RONDE HEMIN PEKIN BEGIN
BEGUN: CLAST RONDE HEMIN EEVEN BEGUN
BEING: CLAST RONDE HEMIN BEING
BELCH: CLAST LOCIE WEMBS BELCH
BELIE: CLAST OILED KEYER BELIE
BELLE: CLAST OILED FUNKY BELLE
BELLY: CLAST OILED FUNKY BEWIG BELLY
BELOW: CLAST OILED POWNY BELOW
BENCH: CLAST HONER BAWKS BENCH
BERET: CLAST PROIN REVET BERET
BERRY: CLAST RONDE FERER BUMPH BERRY
BERTH: CLAST TORTE DUNCH BERTH
BESET: CLAST ROUEN SHEWN BESET
BETEL: CLAST TOILE FEYED BETEL
BEVEL: CLAST OILED BEVER BEVEL
BEZEL: CLAST OILED BEVER BEZEL
BIBLE: CLAST OILED VERGE BIBLE
BICEP: CLAST HONER VEXED BICEP
BIDDY: CLAST RONDE DWAUM KAGUS BIDDY
BIGOT: CLAST PROIN GIBES BIGOT
BILGE: CLAST OILED GRUFE BILGE
BILLY: CLAST OILED FUGLY SHEWN BILLY
BINGE: CLAST RONDE BEWIG BINGE
BINGO: CLAST RONDE PINGO BINGO
BIOME: CLAST RONDE CHIMP BIOME
BIRCH: CLAST HONER BIRCH
BIRTH: CLAST TORTE GUMMY FIRTH BIRTH
BISON: CLAST DONER KNOWS VISON BISON
BITTY: CLAST TORTE BINGY BITTY
BLACK: CLAST BLYPE BLACK
BLADE: CLAST FERNY MUDGE BLADE
BLAME: CLAST FERNY MUDGE BLAME
BLAND: CLAST FERNY AGOOD BLAND
BLANK: CLAST FERNY AGOOD PLANK BLANK
BLARE: CLAST FERNY GLARE BLARE
BLAST: CLAST BLAST
BLAZE: CLAST FERNY MUDGE BLAZE
BLEAK: CLAST AGONE MBIRA BLEAK
BLEAT: CLAST PROFS BLEAT
BLEED: CLAST BOUGE BLEND BLEED
BLEEP: CLAST BOUGE BLEND BLEEP
BLEND: CLAST BOUGE BLEND
BLESS: CLAST SEIFS BLESS
BLIMP: CLAST BOUGE KANDY BLIMP
BLIND: CLAST BOUGE KANDY BLIND
BLINK: CLAST BOUGE KANDY BLINK
BLISS: CLAST SEIFS BLISS
BLITZ: CLAST BOEUF BLITZ
BLOAT: CLAST PROFS GLOAT BLOAT
BLOCK: CLAST BEFIT BLOCK
BLOKE: CLAST BOUGE BLOKE
BLOND: CLAST BOUGE KANDY BLOND
BLOOD: CLAST BOUGE KANDY BLOOD
BLOOM: CLAST BOUGE KANDY BLOOM
BLOWN: CLAST BOUGE KANDY BLOWN
BLUER: CLAST BOUGE DUMMY BLUER
BLUFF: CLAST BOUGE NIFTY BLUFF
BLUNT: CLAST FREON BLUNT
BLURB: CLAST BOUGE NIFTY BLURB
BLURT: CLAST FREON BLURT
BLUSH: CLAST SEIFS BLUSH
BOARD: CLAST DRONE HOARD BOARD
BOAST: CLAST BROGH BOAST
BOBBY: CLAST RONDE BUMPY FLOGS BOBBY
BONEY: CLAST RONDE NYMPH BONEY
BONGO: CLAST RONDE BOOGY BONGO
BONUS: CLAST DONER GIMPY KHAZI BONUS
BOOBY: CLAST RONDE BUMPY FLOGS OZEKI BOOBY
BOOST: CLAST OURIE DONGS BOOST
BOOTH: CLAST TORTE BUNJY BOOTH
BOOTY: CLAST TORTE BUNJY BOOTY
BOOZE: CLAST RONDE GIMPY ZOWEE BOOZE
BOOZY: CLAST RONDE BUMPY FLOGS OZEKI BOOZY
BORAX: CLAST MARAE BODHI BORAX
BORNE: CLAST RONDE BORNE
BOSOM: CLAST DONER BUMPH BOOMS BOSOM
BOSSY: CLAST IRONE BUSHY BOSSY
BOTCH: CLAST KIORE BRUNG BOTCH
BOUGH: CLAST RONDE BUMPY BOUGH
BOULE: CLAST OILED BOURN BOULE
BOUND: CLAST RONDE WHUMP BOUND
BOWEL: CLAST OILED NERVY BOWEL
BOXER: CLAST RONDE WHUMP KIRBY BOXER
BRACE: CLAST BROKE BRACE
BRAID: CLAST DRONE FRAUD BRAID
BRAIN: CLAST DRONE BRAWN BRAIN
BRAKE: CLAST DRONE GAMBA OZEKI BRAKE
BRAND: CLAST DRONE GRAND BRAND
BRASH: CLAST RHEUM BRASH
BRASS: CLAST RHEUM FLOGS BRASS
BRAVE: CLAST DRONE GAMBA OZEKI BRAVE
BRAVO: CLAST DRONE BRAVO
BRAWL: CLAST LIVRE DEBAG BRAWL
BRAWN: CLAST DRONE BRAWN
BREAD: CLAST MARAE DEBUR BREAD
BREAK: CLAST MARAE DEBUR BREAK
BREED: CLAST RONDE DRIER GRUFE PREED BREED
BRIAR: CLAST MARAE BROND BRIAR
BRIBE: CLAST RONDE BEIGE BRIBE
BRICK: CLAST HONER WIMPY BRICK
BRIDE: CLAST RONDE BEWIG BRIDE
BRIEF: CLAST RONDE FERER DEBAG BRIEF
BRINE: CLAST RONDE BEING BRINE
BRING: CLAST RONDE IBRIK BRING
BRINK: CLAST RONDE IBRIK BRINK
BRINY: CLAST RONDE IBRIK BRING BRINY
BRISK: CLAST IRONE KEMBS BRISK
BROAD: CLAST MARAE BROND BROAD
BROIL: CLAST OILED ROOPY BROIL
BROKE: CLAST RONDE PROBE BROME BROKE
BROOD: CLAST RONDE DROOK BROOD
BROOK: CLAST RONDE GROOM PROOF BROOK
BROOM: CLAST RONDE GROOM BROOM
BROTH: CLAST TORTE WOOFY BROTH
BROWN: CLAST RONDE GIPON BROWN
BRUNT: CLAST PROIN DEBYE BRUNT
BRUSH: CLAST IRONE BRUSH
BRUTE: CLAST TORTE WRITE BRUTE
BUDDY: CLAST RONDE DWAUM FLUBS BUDDY
BUDGE: CLAST RONDE BEDIM BUDGE
BUGGY: CLAST RONDE PIGMY VUGHY BUGGY
BUGLE: CLAST OILED MURLY FUGLE BUGLE
BUILD: CLAST OILED BUILD
BUILT: CLAST GEOID BUILT
BULGE: CLAST OILED FUNKY BULGE
BULKY: CLAST OILED GULPH BULLY BULKY
BULLY: CLAST OILED GULPH BULLY
BUNCH: CLAST HONER FRUMP DUNCH BUNCH
BUNNY: CLAST RONDE PIING FLUBS BUNNY
BURLY: CLAST OILED BURGH BURLY
BURNT: CLAST PROIN BURNT
BURST: CLAST OURIE HOWDY BURST
BUSED: CLAST DONER WISPS FAMED BUSED
BUSHY: CLAST DONER SIMPS HUSKY BUSHY
BUTCH: CLAST KIORE IMBED BUTCH
BUTTE: CLAST TORTE BITTE BUTTE
BUXOM: CLAST RONDE BUMPH BUXOM
BUYER: CLAST RONDE FERER BUMPH BUYER
BYLAW: CLAST MARAE YUPON ZYGAL BYLAW
CABAL: CLAST PALEA CABAL
CABBY: CLAST PORED ABUNA CABBY
CABIN: CLAST PORED ABUNA CABIN
CABLE: CLAST PALEA CARLE CABLE
CACAO: CLAST PORED HEJAB CACAO
CACHE: CLAST PORED CACHE
CACTI: CLAST NOTER CACTI
CADDY: CLAST PORED CADGY CADDY
CADET: CLAST PERDU CADET
CAGEY: CLAST PORED CAKEY CAGEY
CAIRN: CLAST PORED MINGY CAIRN
CAMEL: CLAST PALEA CAVEL CAMEL
CAMEO: CLAST PORED CAMEO
CANAL: CLAST PALEA CABAL CANAL
CANDY: CLAST PORED CADGY CANDY
CANNY: CLAST PORED ABUNA CANNY
CANOE: CLAST PORED CANOE
CANON: CLAST PORED HEJAB CANON
CAPER: CLAST PORED CAPER
CAPUT: CLAST PERDU CAPUT
CARAT: CLAST PERDU CARAT
CARGO: CLAST PORED BARON CARGO
CAROL: CLAST PALEA PERDU CAROL
CARRY: CLAST PORED BAVIN CARRY
CARVE: CLAST PORED CERIA CARVE
CASTE: CLAST BASEN CASTE
CATCH: CLAST NOTER CATCH
CATER: CLAST NOTER CATER
CATTY: CLAST NOTER CATCH CATTY
CAULK: CLAST PALEA PERDU CAULK
CAUSE: CLAST EMURE CAUSE
CAVIL: CLAST PALEA PERDU CAVIL
CEASE: CLAST CHASE CEASE
CEDAR: CLAST PORED CADRE CEDAR
CELLO: CLAST HELLO CELLO
CHAFE: CLAST KRONE VESPA CHACE CHAFE
CHAFF: CLAST KRONE MELTY CHAFF
CHAIN: CLAST KRONE CHAIN
CHAIR: CLAST KRONE MORRA CHAIR
CHALK: CLAST COALA CHALK
CHAMP: CLAST KRONE MELTY CHAMP
CHANT: CLAST ORPIN CHANT
CHAOS: CLAST PRIMY DOWDS CHAOS
CHARD: CLAST KRONE MORRA CHARD
CHARM: CLAST KRONE MORRA CHARM
CHART: CLAST ORPIN CHART
CHASE: CLAST CHASE
CHASM: CLAST CHASE CHASM
CHEAP: CLAST PORED CHEAP
CHEAT: CLAST PERDU CHEAT
CHECK: CLAST IRONE SMEEK CHECK
CHEEK: CLAST IRONE SMEEK CHEEK
CHEER: CLAST IRONE CURDY CHEER
CHESS: CLAST ROULE CHESS
CHEST: CLAST EMURE CHEST
CHICK: CLAST IRONE NYMPH CHICK
CHIDE: CLAST IRONE DEVON CHIDE
CHIEF: CLAST IRONE CIMEX CHIEF
CHILD: CLAST HELLO CHILI CHILD
CHILI: CLAST HELLO CHILI
CHILL: CLAST HELLO CHILL
CHIME: CLAST IRONE DEVON CHIME
CHINA: CLAST PORED ABUNA CHINA
CHIRP: CLAST IRONE UMIAK CHIRP
CHOCK: CLAST IRONE MOOKS CHOCK
CHOIR: CLAST IRONE CHOIR
CHOKE: CLAST IRONE HOLED CHOKE
CHORD: CLAST IRONE CHORD
CHORE: CLAST IRONE CHORE
CHOSE: CLAST ROULE CHOSE
CHUCK: CLAST IRONE PUKED CHUCK
CHUMP: CLAST IRONE PUKED CHUMP
CHUNK: CLAST IRONE CHYND CHUNK
CHURN: CLAST IRONE CHURN
CHUTE: CLAST ROUEN CHUTE
CIDER: CLAST IRONE CERIC CIDER
CIGAR: CLAST PORED MINGY CIGAR
CINCH: CLAST IRONE CYNIC CINCH
CIRCA: CLAST PORED BAVIN CIRCA
CIVIC: CLAST IRONE NYMPH CUBIC CIVIC
CIVIL: CLAST HELLO CIVIL
CLACK: CLAST VENOM CLACH CLACK
CLAIM: CLAST VENOM CLAIM
CLAMP: CLAST VENOM CLAMP
CLANG: CLAST VENOM CLANG
CLANK: CLAST VENOM CLANG CLANK
CLASH: CLAST SECHS CLASH
CLASP: CLAST SECHS CLASP
CLASS: CLAST SECHS CLASS
CLEAN: CLAST MANES CLEAN
CLEAR: CLAST MANES CLEAR
CLEAT: CLAST CLEAT
CLEFT: CLAST PELON CLEFT
CLERK: CLAST KOINE RISES CLERK
CLICK: CLAST KOINE CLICK
CLIFF: CLAST KOINE CLIMB CLIFF
CLIMB: CLAST KOINE CLIMB
CLING: CLAST KOINE CLING
CLINK: CLAST KOINE CLINK
CLOAK: CLAST MANES CLOAK
CLOCK: CLAST KOINE CLOCK
CLONE: CLAST KOINE CLONE
CLOSE: CLAST CLOSE
CLOTH: CLAST CLOTH
CLOUD: CLAST KOINE FRUMP CLOUD
CLOUT: CLAST PELON CLOUT
CLOVE: CLAST KOINE DITZY CLOVE
CLOWN: CLAST KOINE CLOWN
CLUCK: CLAST KOINE CLUCK
CLUED: CLAST KOINE CLUEY CLUED
CLUMP: CLAST KOINE CLUMP
CLUNG: CLAST KOINE CLUNG
COACH: CLAST KRONE CHACO COACH
COAST: CLAST COAST
COBRA: CLAST PORED COBRA
COCOA: CLAST PORED NIZAM COCOA
COLON: CLAST HELLO MINGY COLON
COLOR: CLAST HELLO MINGY COLOR
COMET: CLAST LOURE COMET
COMFY: CLAST IRONE BOOMY COMFY
COMIC: CLAST IRONE COMIC
COMMA: CLAST PORED NIZAM COMMA
CONCH: CLAST IRONE HEDGY CONCH
CONDO: CLAST IRONE HEDGY CONDO
CONIC: CLAST IRONE COVIN CONIC
COPSE: CLAST ROULE COPSE
CORAL: CLAST PALEA AWMRY CORAL
CORER: CLAST IRONE DORMY CORER
CORNY: CLAST IRONE DUMMY CORNY
COUCH: CLAST IRONE BOOMY COUGH COUCH
COUGH: CLAST IRONE BOOMY COUGH
COULD: CLAST HELLO COOLY COULD
COUNT: CLAST LOURE COUNT
COUPE: CLAST IRONE UNGOD COUPE
COURT: CLAST LOURE COURT
COVEN: CLAST IRONE HYPED COZEN COVEN
COVER: CLAST IRONE DORMY VESPA COVER
COVET: CLAST LOURE COMET COVET
COVEY: CLAST IRONE PYXED COVEY
COWER: CLAST IRONE DORMY VESPA COWER
COYLY: CLAST HELLO COOLY COYLY
CRACK: CLAST KRONE CRACK
CRAFT: CLAST ORPIN CRAFT
CRAMP: CLAST KRONE GYMPS CRAMP
CRANE: CLAST KRONE CRANE
CRANK: CLAST KRONE CRANK
CRASH: CLAST CHASE CRASH
CRASS: CLAST CHASE CRASS
CRATE: CLAST COATE CRATE
CRAVE: CLAST KRONE SPERM CRAZE CRAVE
CRAWL: CLAST COALA CRAWL
CRAZE: CLAST KRONE SPERM CRAZE
CRAZY: CLAST KRONE GYMPS CRAZY
CREAK: CLAST PORED CREAK
CREAM: CLAST PORED CREAK CREAM
CREDO: CLAST IRONE CREDO
CREED: CLAST IRONE DIPPY CREED
CREEK: CLAST IRONE DIPPY CREEK
CREEP: CLAST IRONE DIPPY CREEP
CREME: CLAST IRONE DWAUM CREME
CREPE: CLAST IRONE DWAUM CREPE
CREPT: CLAST LOURE CREPT
CRESS: CLAST ROULE CRESS
CREST: CLAST EMURE CREST
CRICK: CLAST IRONE CRICK
CRIED: CLAST IRONE CRIED
CRIER: CLAST IRONE CRIED CRIER
CRIME: CLAST IRONE CRIPE CRIME
CRIMP: CLAST IRONE CRICK CRIMP
CRISP: CLAST ROULE CRISP
CROAK: CLAST PORED CROAK
CROCK: CLAST IRONE KUDOS CROCK
CRONE: CLAST IRONE CRONE
CRONY: CLAST IRONE CRONK CRONY
CROOK: CLAST IRONE KUDOS CROOK
CROSS: CLAST ROULE CROSS
CROUP: CLAST IRONE KUDOS CROUP
CROWD: CLAST IRONE KUDOS CROWD
CROWN: CLAST IRONE CROON CROWN
CRUDE: CLAST IRONE DWAUM CRUDE
CRUEL: CLAST HELLO CUPEL CRUEL
CRUMB: CLAST IRONE SPICY CRUMB
CRUMP: CLAST IRONE SPICY CRUMP
CRUSH: CLAST ROULE CRUSY CRUSH
CRUST: CLAST EMURE CRUST
CRYPT: CLAST LOURE CRYPT
CUBIC: CLAST IRONE NYMPH CUBIC
CUMIN: CLAST IRONE CYNIC CUMIN
CURIO: CLAST IRONE CORGI CURIO
CURLY: CLAST HELLO CURLY
CURRY: CLAST IRONE SHERD CURRY
CURSE: CLAST ROULE CURSE
CURVE: CLAST IRONE CHERE CURVE
CURVY: CLAST IRONE SHERD CURVY
CUTIE: CLAST ROUEN CUTIE
CYBER: CLAST IRONE CURDY CYBER
CYCLE: CLAST HELLO CYCLE
CYNIC: CLAST IRONE CYNIC
DADDY: CLAST MARAE DINGY FURTH DADDY
DAILY: CLAST MARAE DILLY DAILY
DAIRY: CLAST MARAE POIND DAIRY
DAISY: CLAST MAIRE BAISA DAISY
DALLY: CLAST MARAE DILLY DALLY
DANCE: CLAST NICER PHONS DANCE
DANDY: CLAST MARAE DINGY DANNY DANDY
DATUM: CLAST TORTE PANIM DATUM
DAUNT: CLAST GRONE THIRD DAUNT
DEALT: CLAST FENDY DEALT
DEATH: CLAST TRONE HIMBO DEATH
DEBAR: CLAST MARAE DEBUR DEBAR
DEBIT: CLAST PROIN GIBED DEBIT
DEBUG: CLAST RONDE BEIGY DEBUG
DEBUT: CLAST PROIN MEWED DEBUT
DECAL: CLAST RACED DECAL
DECAY: CLAST NICER FAMED DECAY
DECOR: CLAST HONER DECOR
DECOY: CLAST HONER DECOY
DECRY: CLAST HONER PRIDE DECRY
DEFER: CLAST RONDE DRIER DUPER DEFER
DEIGN: CLAST RONDE EIKED DEIGN
DEITY: CLAST TORTE HEIGH DEITY
DELAY: CLAST MARAE DELPH DELAY
DELTA: CLAST TALEA PELTA DELTA
DELVE: CLAST OILED RHEME DELVE
DEMON: CLAST RONDE DEVON DEMON
DEMUR: CLAST RONDE DRIER DEBUR DEMUR
DENIM: CLAST RONDE WIMPY DENIM
DENSE: CLAST IRONE SMEKE DENSE
DEPOT: CLAST PROIN DEPOT
DEPTH: CLAST TORTE HEIGH DEPTH
DERBY: CLAST RONDE DRIER DERBY
DETER: CLAST TORTE MINED DETER
DETOX: CLAST TORTE BETON DETOX
DEUCE: CLAST HONER DEICE DEUCE
DEVIL: CLAST OILED EDILE DEVIL
DIARY: CLAST DRONE DIARY
DICEY: CLAST HONER VEXED DICEY
DIGIT: CLAST PROIN GIBED DIGIT
DILLY: CLAST OILED DILLI DILLY
DIMLY: CLAST OILED LINDY DIMLY
DINER: CLAST RONDE URNED DINER
DINGO: CLAST RONDE DUNNO DINGO
DINGY: CLAST RONDE DINGY
DIODE: CLAST RONDE EPODE DIODE
DIRGE: CLAST RONDE GREVE DIRGE
DIRTY: CLAST TORTE GUMMY DIRTY
DISCO: CLAST KIORE FAMED DISCO
DITCH: CLAST KIORE HOWDY DITCH
DITTO: CLAST TORTE DITTO
DITTY: CLAST TORTE BINGY DOWDS DITTY
DIVER: CLAST RONDE DRIER MAWKS DIVER
DIZZY: CLAST RONDE PIGMY DIZZY
DODGE: CLAST RONDE BEWIG DUMMY DODGE
DODGY: CLAST RONDE BIDDY DODGY
DOGMA: CLAST MARAE DOING DOGMA
DOING: CLAST RONDE WHUMP IODIN DOING
DOLLY: CLAST OILED MOLDY DOLLY
DONOR: CLAST RONDE DONOR
DONUT: CLAST PROIN MOUNT DONUT
DOPEY: CLAST RONDE WHOMP OOPED DOPEY
DOUBT: CLAST PROIN BOGUS DOUBT
DOUGH: CLAST RONDE BIDDY DOUGH
DOWDY: CLAST RONDE DHOWS DOWDY
DOWEL: CLAST OILED WOMYN DOWEL
DOWNY: CLAST RONDE WHUMP DOWNY
DOWRY: CLAST RONDE BOURD DOWRY
DOZEN: CLAST RONDE DITZY DOZEN
DRAFT: CLAST PRUNE KIDGE DRAFT
DRAIN: CLAST DRONE DRAWN DRAIN
DRAKE: CLAST DRONE VESPA DRAKE
DRAMA: CLAST DRONE DRAMA
DRANK: CLAST DRONE DRANK
DRAPE: CLAST DRONE VESPA DRAPE
DRAWL: CLAST LIVRE DEBAG DRAWL
DRAWN: CLAST DRONE DRAWN
DREAD: CLAST MARAE DEBUR DREAD
DREAM: CLAST MARAE BRUNG DREAM
DRESS: CLAST IRONE PRESS DRESS
DRIED: CLAST RONDE DRIER DRIED
DRIER: CLAST RONDE DRIER
DRIFT: CLAST PROIN DRIFT
DRILL: CLAST OILED DRILL
DRINK: CLAST RONDE UNRID DRINK
DRIVE: CLAST RONDE GREVE DRIVE
DROIT: CLAST PROIN DROIT
DROLL: CLAST OILED DROLL
DRONE: CLAST RONDE DRONE
DROOL: CLAST OILED DROLL DROOL
DROOP: CLAST RONDE DROOK DEBAG DROOP
DROSS: CLAST IRONE GYMPS DROSS
DROVE: CLAST RONDE MAWKS DROVE
DROWN: CLAST RONDE BROND DROWN
DRUID: CLAST RONDE MURRY DRUID
DRUNK: CLAST RONDE UNRID DRUNK
DRYER: CLAST RONDE DRIER DRYER
DRYLY: CLAST OILED DUPLY DRYLY
DUCHY: CLAST HONER FICHU DUCHY
DULLY: CLAST OILED DULLY
DUMMY: CLAST RONDE PIGMY DUMMY
DUMPY: CLAST RONDE PIGMY DUMPY
DUNCE: CLAST HONER MIXUP DUNCE
DUSKY: CLAST DONER SPIFS DUSKY
DUSTY: CLAST TORTE SHIMS DEBAG DUSTY
DUTCH: CLAST KIORE IMBED DUTCH
DUVET: CLAST PROIN MEWED DUVET
DWARF: CLAST DRONE DIARY DWARF
DWELL: CLAST OILED DEELY DWELL
DWELT: CLAST GEOID DWELT
DYING: CLAST RONDE BUDGE DYING
EAGER: CLAST MARAE PODGY JEWEL EAGER
EAGLE: CLAST MARAE HILLY GENIP EAGLE
EARLY: CLAST MARAE EARLY
EARTH: CLAST TORTE EARTH
EASEL: CLAST SALLE DRESS EASEL
EATEN: CLAST TORTE DAMPY EATEN
EATER: CLAST TORTE PAGED RHEME EATER
EBONY: CLAST RONDE ENJOY EBONY
ECLAT: CLAST LACET ECLAT
EDICT: CLAST HIRED EDICT
EDIFY: CLAST RONDE BEIGY EDIFY
EERIE: CLAST RONDE BEIGE EERIE
EGRET: CLAST PROIN REVET EGRET
EIGHT: CLAST PROIN TIMED EIGHT
EJECT: CLAST HIRED EJECT
EKING: CLAST RONDE HEMIN LANKY EKING
ELATE: CLAST ALBEE ELATE
ELBOW: CLAST BOUGE ELBOW
ELDER: CLAST BOUGE PREIF ELDER
ELECT: CLAST ELECT
ELEGY: CLAST BOUGE ELEGY
ELFIN: CLAST BOUGE PREIF ELFIN
ELIDE: CLAST BOUGE ELIDE
ELITE: CLAST BOEUF ELITE
ELOPE: CLAST BOUGE DYING ELOPE
ELUDE: CLAST BOUGE FLUME ELUDE
EMAIL: CLAST LIVRE EMAIL
EMBED: CLAST RONDE BEIGY EMBED
EMBER: CLAST RONDE FERER BUMPH EMBER
EMCEE: CLAST HONER VEXED EMCEE
EMPTY: CLAST TORTE HEIGH EMPTY
ENACT: CLAST ENFIX ENACT
ENDOW: CLAST RONDE DEVON ENDOW
ENEMA: CLAST MARAE EMEND ENEMA
ENEMY: CLAST RONDE HEMIN ENEMY
ENJOY: CLAST RONDE ENJOY
ENNUI: CLAST RONDE PENNY ENNUI
ENSUE: CLAST DONER SEINE ENSUE
ENTER: CLAST TORTE MINED ENTER
ENTRY: CLAST TORTE MINED ENTRY
ENVOY: CLAST RONDE ENJOY ENVOY
EPOCH: CLAST HONER EPOCH
EPOXY: CLAST RONDE BEMIX EPOXY
EQUAL: CLAST MARAE DELPH UVEAL EQUAL
EQUIP: CLAST RONDE WIMPY EQUIP
ERASE: CLAST RHEUM PRASE ERASE
ERECT: CLAST HIRED RECUT ERECT
ERODE: CLAST RONDE ERODE
ERROR: CLAST RONDE BREER ERROR
ERUPT: CLAST PROIN ERUPT
ESSAY: CLAST NARES SEPIA ESSAY
ESTER: CLAST TORTE RITES ESTER
ETHER: CLAST TORTE MINED UPTER ETHER
ETHIC: CLAST KIORE THEIC ETHIC
ETHOS: CLAST TORTE SETON ETHOS
ETUDE: CLAST TORTE HINKY ETUDE
EVADE: CLAST DRONE EVADE
EVENT: CLAST PROIN KEDGE EVENT
EVERY: CLAST RONDE FERER EMERG EVERY
EVICT: CLAST HIRED EVICT
EVOKE: CLAST RONDE CHIMP EVOKE
EXACT: CLAST ENFIX EXACT
EXALT: CLAST FENDY EXALT
EXCEL: CLAST LOCIE EXCEL
EXERT: CLAST PROIN REVET EXERT
EXILE: CLAST OILED VENGE EXILE
EXIST: CLAST OURIE FENDY EXIST
EXPEL: CLAST OILED BEVER WHEEL EXPEL
EXTOL: CLAST TOILE KETOL EXTOL
EXTRA: CLAST TORTE PAGED RETIA EXTRA
EXULT: CLAST GEOID KNELT EXULT
EYING: CLAST RONDE HEMIN LANKY EYING
FABLE: CLAST MARAE HILLY GENIP FABLE
FACET: CLAST TACET FACET
FAINT: CLAST GRONE THIRD FAINT
FAIRY: CLAST MARAE POIND FURTH FAIRY
FAITH: CLAST TORTE BANYA FAITH
FALSE: CLAST LYSSA FURTH FALSE
FANCY: CLAST NICER HOODY FANCY
FANNY: CLAST MARAE DINGY WHARF FANNY
FARCE: CLAST NICER FARCE
FATAL: CLAST TALEA DHIKR FATAL
FATTY: CLAST TORTE NUBIA FATTY
FAULT: CLAST VAGUE FURTH FAULT
FAUNA: CLAST MARAE KINDY NAPPA FAUNA
FAVOR: CLAST MARAE POIND RAZOO FAVOR
FEAST: CLAST BROGH FEAST
FECAL: CLAST RACED ANCLE FECAL
FEIGN: CLAST RONDE HEMIN FEIGN
FELLA: CLAST MARAE WILGA FELLA
FELON: CLAST OILED POWNY FAMED FELON
FEMME: CLAST RONDE GUIMP FEHME FEMME
FEMUR: CLAST RONDE FERER FEMUR
FENCE: CLAST HONER MIXUP FENCE
FERAL: CLAST MARAE NERAL FERAL
FERRY: CLAST RONDE FERER FERRY
FETAL: CLAST TALEA EMPTS FETAL
FETCH: CLAST KIORE FUNKY FETCH
FETID: CLAST TORTE DEIFY FETID
FETUS: CLAST TORTE MINES HOWDY FETUS
FEVER: CLAST RONDE FERER WELLY FEVER
FEWER: CLAST RONDE FERER WELLY FEWER
FIBER: CLAST RONDE FERER VIBEX FIBER
FIBRE: CLAST RONDE BEIGE FIBRE
FICUS: CLAST KIORE DISCS FICUS
FIELD: CLAST OILED WOOFY FIELD
FIEND: CLAST RONDE EIKED FIEND
FIERY: CLAST RONDE FERER FIERY
FIFTH: CLAST TORTE FUNKY FIFTH
FIFTY: CLAST TORTE FUNKY FIFTY
FIGHT: CLAST PROIN TIMED WAKFS FIGHT
FILER: CLAST OILED PAVER FILER
FILET: CLAST GEOID FILET
FILLY: CLAST OILED FUGLY FILLY
FILMY: CLAST OILED FUGLY FILMY
FILTH: CLAST TOILE FUNKY FILTH
FINAL: CLAST MARAE YUPON VIFDA FINAL
FINCH: CLAST HONER FRUMP FINCH
FINER: CLAST RONDE NIMBI VINER FINER
FIRST: CLAST OURIE FIRST
FISHY: CLAST DONER SIMPS FISHY
FIXER: CLAST RONDE FERER VIBEX FIXER
FIZZY: CLAST RONDE PIGMY BIZZY FIZZY
FJORD: CLAST RONDE DROOK FIORD FJORD
FLACK: CLAST BLYPE FLACK
FLAIL: CLAST FERNY AMIAS FLAIL
FLAIR: CLAST FERNY FLAIR
FLAKE: CLAST FERNY FLAME FLAKE
FLAKY: CLAST FERNY MAWKS FLAKY
FLAME: CLAST FERNY FLAME
FLANK: CLAST FERNY FLANK
FLARE: CLAST FERNY FLARE
FLASH: CLAST HESPS BLASH FLASH
FLASK: CLAST HESPS FLASK
FLECK: CLAST BEFIT FLECK
FLEET: CLAST FREON FLEET
FLESH: CLAST SEIFS FLESH
FLICK: CLAST BEFIT FLICK
FLIER: CLAST BOUGE PREIF FLIER
FLING: CLAST BOUGE FLING
FLINT: CLAST FREON FLINT
FLIRT: CLAST FREON FLIRT
FLOAT: CLAST PROFS FLOAT
FLOCK: CLAST BEFIT FLOCK
FLOOD: CLAST BOUGE FLOOR FLOOD
FLOOR: CLAST BOUGE FLOOR
FLORA: CLAST AGONE FLORA
FLOSS: CLAST SEIFS FLOSS
FLOUR: CLAST BOUGE FLOUR
FLOUT: CLAST FREON FLOUT
FLOWN: CLAST BOUGE FLOOR FLOWN
FLUFF: CLAST BOUGE NIPPY FLUFF
FLUID: CLAST BOUGE NIPPY FLUID
FLUKE: CLAST BOUGE FLUME FLUKE
FLUME: CLAST BOUGE FLUME
FLUNG: CLAST BOUGE FLUNG
FLUNK: CLAST BOUGE NIPPY FLUNK
FLUSH: CLAST SEIFS FLUSH
FLUTE: CLAST BOEUF FLUTE
FLYER: CLAST BOUGE PREIF FLYER
FOAMY: CLAST DRONE MOGUL FOAMY
FOCAL: CLAST RACED FOLLY FOCAL
FOCUS: CLAST KIORE HOUND FOCUS
FOGGY: CLAST RONDE BUMPY KAGUS FOGGY
FOIST: CLAST OURIE FEHME FOIST
FOLIO: CLAST OILED POLIO FOLIO
FOLLY: CLAST OILED POLLY JUGUM WHARF FOLLY
FORAY: CLAST MARAE BODHI FORAY
FORCE: CLAST HONER FORCE
FORGE: CLAST RONDE GRIEF FORGE
FORGO: CLAST RONDE GURRY FORGO
FORTE: CLAST TORTE FORTE
FORTH: CLAST TORTE BANDY WORTH FORTH
FORTY: CLAST TORTE BANDY FURRS FORTY
FORUM: CLAST RONDE GURRY FORUM
FOUND: CLAST RONDE WHUMP BOUND FOUND
FOYER: CLAST RONDE WHUMP KIRBY FOYER
FRAIL: CLAST LIVRE FUDGE FRAIL
FRAME: CLAST DRONE GAMBA FRAME
FRANK: CLAST DRONE GOPIK BRANK FRANK
FRAUD: CLAST DRONE FRAUD
FREAK: CLAST MARAE DEBUR FREAK
FREED: CLAST RONDE DRIER GRUFE FREED
FREER: CLAST RONDE FERER FREER
FRESH: CLAST IRONE PRESS FRESH
FRIAR: CLAST MARAE BROND FRIAR
FRIED: CLAST RONDE DRIER WATAP FRIED
FRILL: CLAST OILED GRUMP FLUBS FRILL
FRISK: CLAST IRONE KEMBS FRISK
FRITZ: CLAST TORTE BIGHT FRITZ
FROCK: CLAST HONER BREID FROCK
FROND: CLAST RONDE BROND FROND
FRONT: CLAST PROIN FRONT
FROST: CLAST OURIE FROST
FROTH: CLAST TORTE WOOFY FROTH
FROWN: CLAST RONDE GIPON BROWN FROWN
FROZE: CLAST RONDE PROBE WHARF FROZE
FRUIT: CLAST PROIN FRUIT
FUDGE: CLAST RONDE BEDIM SPOOF FUDGE
FUGUE: CLAST RONDE GUIMP FUGUE
FULLY: CLAST OILED GULPH BULLY FULLY
FUNGI: CLAST RONDE PIING FUNGI
FUNKY: CLAST RONDE PIING BHAJI FUNKY
FUNNY: CLAST RONDE PIING FLUBS FUNNY
FUROR: CLAST RONDE GROOM FUROR
FURRY: CLAST RONDE GUIMP WHARF FURRY
FUSSY: CLAST IRONE PASHM WOOFY FUSSY
FUZZY: CLAST RONDE PIGMY FLYBY FUZZY
GAFFE: CLAST MARAE FUNGI GAFFE
GAILY: CLAST MARAE DILLY HAILY GAILY
GAMER: CLAST MARAE NAMER GAMER
GAMMA: CLAST MARAE PIGMY GAMMA
GAMUT: CLAST GRONE GAITT GAMUT
GASSY: CLAST MAIRE GASSY
GAUDY: CLAST MARAE DINGY GAUDY
GAUGE: CLAST MARAE FUNGI GAUGE
GAUNT: CLAST GRONE GAUNT
GAUZE: CLAST MARAE FUNGI GAUJE GAUZE
GAVEL: CLAST MARAE LOWND VUGHY GAVEL
GAWKY: CLAST MARAE DINGY WHAUP GAWKY
GAYER: CLAST MARAE PODGY YAGER GAYER
GAYLY: CLAST MARAE DILLY SEGNI GAYLY
GAZER: CLAST MARAE PODGY JEWEL GAZER
GECKO: CLAST HONER DECOY GECKO
GEEKY: CLAST RONDE WIMPY FUZEE GEEKY
GEESE: CLAST IRONE GUSHY GEESE
GENIE: CLAST RONDE BEWIG GENIE
GENRE: CLAST RONDE GENRE
GHOST: CLAST OURIE DONGS GHOST
GHOUL: CLAST OILED GURLY GHOUL
GIANT: CLAST PRUNE GIANT
GIDDY: CLAST RONDE DWAUM KAGUS GIDDY
GIPSY: CLAST IRONE SYPHS GIPSY
GIRLY: CLAST OILED GUNKY GIRLY
GIRTH: CLAST TORTE GUMMY GIRTH
GIVEN: CLAST RONDE HEMIN VIXEN GIVEN
GIVER: CLAST RONDE FERER BUMPH VEGES GIVER
GLADE: CLAST FERNY MUDGE GLADE
GLAND: CLAST FERNY AGOOD GLAND
GLARE: CLAST FERNY GLARE
GLASS: CLAST HESPS GLASS
GLAZE: CLAST FERNY MUDGE GLAZE
GLEAM: CLAST AGONE GLEBA GLEAM
GLEAN: CLAST AGONE GLEAN
GLIDE: CLAST BOUGE MAKIS GLIDE
GLINT: CLAST FREON BLUNT GLINT
GLOAT: CLAST PROFS GLOAT
GLOBE: CLAST BOUGE GLOBE
GLOOM: CLAST BOUGE POOFY GLOOM
GLORY: CLAST BOUGE POOFY GLORY
GLOSS: CLAST SEIFS GLOSS
GLOVE: CLAST BOUGE DITZY GLOVE
GLYPH: CLAST BOUGE FLING GLYPH
GNASH: CLAST RHEUM SHEWN GNASH
GNOME: CLAST RONDE OOMPH GNOME
GODLY: CLAST OILED DROLL GODLY
GOING: CLAST RONDE GIMPY GOING
GOLEM: CLAST OILED PHYLE GOLEM
GOLLY: CLAST OILED POLLY JUGUM GOLLY
GONAD: CLAST MARAE BIDON GONAD
GONER: CLAST RONDE ZOMBI HONER GONER
GOODY: CLAST RONDE DHOWS GAMBA GOODY
GOOEY: CLAST RONDE GYMPS GOOEY
GOOFY: CLAST RONDE BUMPY KAGUS GOOFY
GOOSE: CLAST IRONE GOMBO GOOSE
GORGE: CLAST RONDE GRIEF GORGE
GOUGE: CLAST RONDE GIMPY GOUGE
GOURD: CLAST RONDE BOURD GOURD
GRACE: CLAST BROKE GRACE
GRADE: CLAST DRONE GRADE
GRAFT: CLAST PRUNE KIDGE GRAFT
GRAIL: CLAST LIVRE FUDGE GRAIL
GRAIN: CLAST DRONE BRAWN GRAIN
GRAND: CLAST DRONE GRAND
GRANT: CLAST PRUNE TOGED GRANT
GRAPE: CLAST DRONE GAMBA VESPA GRAPE
GRAPH: CLAST DRONE PIGMY GRAPH
GRASP: CLAST RHEUM FLOGS GRASP
GRASS: CLAST RHEUM FLOGS GRASS
GRATE: CLAST TRONE FUGIE GRATE
GRAVE: CLAST DRONE GAMBA VESPA GRAVE
GRAVY: CLAST DRONE PIGMY GRAVY
GRAZE: CLAST DRONE GAMBA VESPA GRAZE
GREAT: CLAST GRONE GREAT
GREED: CLAST RONDE DRIER GRUFE GREED
GREEN: CLAST RONDE GIVEN GREEN
GREET: CLAST PROIN FREET GREET
GRIEF: CLAST RONDE FERER DEBAG GRIEF
GRILL: CLAST OILED GRUMP GRILL
GRIME: CLAST RONDE BEIGE KEMPT GRIME
GRIMY: CLAST RONDE GUIMP GRIMY
GRIND: CLAST RONDE UNRID GRIND
GRIPE: CLAST RONDE BEIGE KEMPT GRIPE
GROAN: CLAST MARAE BROND GROAN
GROIN: CLAST RONDE GIPON GROIN
GROOM: CLAST RONDE GROOM
GROPE: CLAST RONDE PROBE GROPE
GROSS: CLAST IRONE GYMPS GROSS
GROUP: CLAST RONDE GROOM GROUP
GROUT: CLAST PROIN GROUT
GROVE: CLAST RONDE PROBE WHARF GROVE
GROWL: CLAST OILED GURLY GROWL
GROWN: CLAST RONDE GIPON GROWN
GRUEL: CLAST OILED BEVER JUREL GRUEL
GRUFF: CLAST RONDE GUIMP GRUFF
GRUNT: CLAST PROIN DEBYE GRUNT
GUARD: CLAST DRONE INCUS GUARD
GUAVA: CLAST DRONE DUMKA GUAVA
GUESS: CLAST IRONE YEESH GUESS
GUEST: CLAST OURIE QUEST GUEST
GUIDE: CLAST RONDE EMYDE GUIDE
GUILD: CLAST OILED BUILD GUILD
GUILE: CLAST OILED VENGE GUILE
GUILT: CLAST GEOID GUILT
GUISE: CLAST IRONE SEWEL GUISE
GULCH: CLAST LOCIE MULCH GULCH
GULLY: CLAST OILED GULPH GULLY
GUMBO: CLAST RONDE BUMPH JUMBO GUMBO
GUMMY: CLAST RONDE PIGMY GUMMY
GUPPY: CLAST RONDE PIGMY GUPPY
GUSTO: CLAST TORTE SINHS GUSTO
GUSTY: CLAST TORTE SHIMS DEBAG GUSTY
GYPSY: CLAST IRONE PASHM GYPSY
HABIT: CLAST GRONE UMIAK HABIT
HAIRY: CLAST MARAE POIND FURTH HAIRY
HALVE: CLAST MARAE HILLY HALVE
HANDY: CLAST MARAE DINGY BOKEH HANDY
HAPPY: CLAST MARAE DINGY BUMPH HAPPY
HARDY: CLAST MARAE BIPOD HARDY
HAREM: CLAST MARAE HAREM
HARPY: CLAST MARAE BIPOD PARRY HARPY
HARRY: CLAST MARAE BIPOD KARZY HARRY
HARSH: CLAST MAIRE HARSH
HASTE: CLAST TERTS WHAUP HASTE
HASTY: CLAST TERTS SOPHY HASTY
HATCH: CLAST AROHA MINGY HOWBE HATCH
HATER: CLAST TORTE PAGED RHEME HATER
HAUNT: CLAST GRONE THIRD HAUNT
HAUTE: CLAST TORTE WINCH HAUTE
HAVEN: CLAST MARAE WONKY PHIZZ HAVEN
HAVOC: CLAST NICER VAUCH HAVOC
HAZEL: CLAST MARAE LOWND VUGHY HAZEL
HEADY: CLAST DRONE BAAED HEADY
HEARD: CLAST DRONE HOODY HEARD
HEART: CLAST PRUNE HEART
HEATH: CLAST TRONE HIMBO HEATH
HEAVE: CLAST DRONE WEIGH HEAME HEAVE
HEAVY: CLAST DRONE VAMPY HEAVY
HEDGE: CLAST RONDE BEDIM SHEWN HEDGE
HEFTY: CLAST TORTE HEIGH HEFTY
HEIST: CLAST OURIE FENDY GEIST HEIST
HELIX: CLAST OILED KEYER HELIX
HELLO: CLAST OILED POWNY FURTH HELLO
HENCE: CLAST HONER HENCE
HERON: CLAST RONDE GROOF HERON
HILLY: CLAST OILED FUGLY SHEWN HILLY
HINGE: CLAST RONDE BEWIG RHEME HINGE
HIPPO: CLAST RONDE BUMPH HIPPO
HIPPY: CLAST RONDE PIGMY DZHOS HIPPY
HITCH: CLAST KIORE HOWDY HITCH
HOARD: CLAST DRONE HOARD
HOBBY: CLAST RONDE BUMPY SHOGI HOBBY
HOIST: CLAST OURIE FEHME HOIST
HOLLY: CLAST OILED POLLY JUGUM WHARF HOLLY
HOMER: CLAST RONDE WHUMP HOMER
HONEY: CLAST RONDE NYMPH HONEY
HONOR: CLAST RONDE HONOR
HORDE: CLAST RONDE HORDE
HORNY: CLAST RONDE PLUMY HORNY
HORSE: CLAST IRONE DOUGH HORSE
HOTEL: CLAST TOILE RHEME HOTEL
HOTLY: CLAST TOILE HOTLY
HOUND: CLAST RONDE WHUMP HOUND
HOUSE: CLAST IRONE BUSHY HOUSE
HOVEL: CLAST OILED NERVY VOWEL HOVEL
HOVER: CLAST RONDE WHUMP HOVER
HOWDY: CLAST RONDE DHOWS HOWDY
HUMAN: CLAST MARAE GUQIN HUMAN
HUMID: CLAST RONDE PIGMY HUMID
HUMOR: CLAST RONDE GROOM HUMOR
HUMPH: CLAST RONDE PIGMY BUMPH HUMPH
HUMUS: CLAST DONER SIMPS FEHME HUMUS
HUNCH: CLAST HONER HUNCH
HUNKY: CLAST RONDE PIING BHAJI HUNKY
HURRY: CLAST RONDE GUIMP WHARF HURRY
HUSKY: CLAST DONER SIMPS HUSKY
HUSSY: CLAST IRONE PASHM HUSSY
HUTCH: CLAST KIORE IMBED HUTCH
HYDRO: CLAST RONDE DROOK HYDRO
HYENA: CLAST MARAE HOUND HYENA
HYMEN: CLAST RONDE HEMIN HYMEN
HYPER: CLAST RONDE FERER BUMPH HYPER
ICILY: CLAST LOCIE HAMZA ICILY
ICING: CLAST HONER ICING
IDEAL: CLAST MARAE DELPH IDEAL
IDIOM: CLAST RONDE HUMID IDIOM
IDIOT: CLAST PROIN GIBES IDIOT
IDLER: CLAST OILED IDLER
IDYLL: CLAST OILED DRILL IDYLL
IGLOO: CLAST OILED POLIO IGLOO
ILIAC: CLAST ILIAC
IMAGE: CLAST DRONE WEIGH IMAGE
IMBUE: CLAST RONDE GUIMP IMBUE
IMPEL: CLAST OILED IMPEL
IMPLY: CLAST OILED GRUMP IMPLY
INANE: CLAST DRONE MEANE INANE
INBOX: CLAST RONDE GUIMP INBOX
INCUR: CLAST HONER INCUR
INDEX: CLAST RONDE EIKED INDEW INDEX
INEPT: CLAST PROIN INPUT INEPT
INERT: CLAST PROIN INERT
INFER: CLAST RONDE GIVEN INKER INFER
INGOT: CLAST PROIN JOINT INGOT
INLAY: CLAST MARAE YUPON INLAY
INLET: CLAST GEOID FILET INLET
INNER: CLAST RONDE NIMBI INNER
INPUT: CLAST PROIN INPUT
INTER: CLAST TORTE MINED INTER
INTRO: CLAST TORTE NITRO INTRO
IONIC: CLAST HONER MELTY IONIC
IRATE: CLAST TRONE FUGIE IRATE
IRONY: CLAST RONDE GIPON IRONY
ISLET: CLAST AMPLE ISLET
ISSUE: CLAST DONER SMEKE VISIE ISSUE
ITCHY: CLAST KIORE TYPIC ITCHY
IVORY: CLAST RONDE GROOM IVORY
JAUNT: CLAST GRONE THIRD JIVES JAUNT
JAZZY: CLAST MARAE DINGY BUMPH FAFFY JAZZY
JELLY: CLAST OILED FUNKY BEWIG JELLY
JERKY: CLAST RONDE FERER KEMPT JERKY
JETTY: CLAST TORTE BUNJY JETTY
JEWEL: CLAST OILED BEVER MINGY JEWEL
JIFFY: CLAST RONDE PIGMY BIZZY JIFFY
JOINT: CLAST PROIN JOINT
JOIST: CLAST OURIE FEHME ZOIST JOIST
JOKER: CLAST RONDE WHUMP KIRBY JOKER
JOLLY: CLAST OILED POLLY JUGUM JOLLY
JOUST: CLAST OURIE JOUST
JUDGE: CLAST RONDE BEDIM SPOOF JUDGE
JUICE: CLAST HONER DEICE JUICE
JUICY: CLAST HONER DUMKY JUICY
JUMBO: CLAST RONDE BUMPH JUMBO
JUMPY: CLAST RONDE PIGMY JOBES JUMPY
JUNTA: CLAST TORTE BANYA JUNTA
JUNTO: CLAST TORTE PUNTO JUNTO
JUROR: CLAST RONDE GROOM FUROR JUROR
KAPPA: CLAST MARAE KINDY KAPPA
KARMA: CLAST MARAE PARMA KARMA
KAYAK: CLAST MARAE PWNED KAYAK
KEBAB: CLAST MARAE BENDY KEBAB
KHAKI: CLAST DRONE DUMKA KHAKI
KINKY: CLAST RONDE PIING KHETH KINKY
KIOSK: CLAST IRONE KIOSK
KITTY: CLAST TORTE BINGY DOWDS KITTY
KNACK: CLAST BROKE WINDY KNACK
KNAVE: CLAST DRONE KNAVE
KNEAD: CLAST MARAE BENDY KNEAD
KNEED: CLAST RONDE EIKED KNEED
KNEEL: CLAST OILED BEVER WHEEL KNEEL
KNELT: CLAST GEOID KNELT
KNIFE: CLAST RONDE WEENY KNIFE
KNOCK: CLAST HONER INCOG KNOCK
KNOLL: CLAST OILED GURLY KNOLL
KNOWN: CLAST RONDE GUIMP KNOWN
KOALA: CLAST LIVRE DORMY KOALA
KRILL: CLAST OILED GRUMP FLUBS KRILL
LABEL: CLAST MARAE LOWND LABEL
LABOR: CLAST MARAE FOLLY LABOR
LADEN: CLAST MARAE LOWND LADEN
LADLE: CLAST MARAE HILLY LADLE
LAGER: CLAST MARAE WYLED GAVEL LAGER
LANCE: CLAST RACED LANCE
LANKY: CLAST MARAE DILLY LANKY
LAPEL: CLAST MARAE LOWND LABEL LAPEL
LAPSE: CLAST LYSSA LAPSE
LARGE: CLAST MARAE FUGLE LARGE
LARVA: CLAST MARAE LARVA
LASSO: CLAST LYSSA INCUS LASSO
LATCH: CLAST TICAL LATCH
LATER: CLAST TALEA RONDO LATER
LATHE: CLAST TALEA FURTH LATHE
LATTE: CLAST TALEA FURTH LATTE
LAUGH: CLAST MARAE DILLY LAZZO LAUGH
LAYER: CLAST MARAE WYLED LAYER
LEACH: CLAST POUPE LEACH
LEAFY: CLAST LIVRE FLUNK LEAFY
LEAKY: CLAST LIVRE FLUNK LEAKY
LEANT: CLAST FENDY LEANT
LEAPT: CLAST FENDY LEAPT
LEARN: CLAST LIVRE LEARN
LEASE: CLAST LEASH LEASE
LEASH: CLAST LEASH
LEAST: CLAST LEAST
LEAVE: CLAST LIVRE LEAVE
LEDGE: CLAST OILED DEELY LEDGE
LEECH: CLAST LOCIE LEECH
LEERY: CLAST OILED MURLY LEERY
LEFTY: CLAST TOILE FEYED LEFTY
LEGAL: CLAST MARAE DELPH GENAL LEGAL
LEGGY: CLAST OILED MURLY LEGGY
LEMON: CLAST OILED BOURN LEMON
LEMUR: CLAST OILED MURLY LEMUR
LEPER: CLAST OILED BEVER LEPER
LEVEL: CLAST OILED BEVER KNOLL LEVEL
LEVER: CLAST OILED BEVER LEVER
LIBEL: CLAST OILED RANGY URBEX LIBEL
LIEGE: CLAST OILED VERGE LIEGE
LIGHT: CLAST GEOID LIGHT
LIKEN: CLAST OILED RANGY MAWKS LIKEN
LILAC: CLAST RACED LINAC LILAC
LIMBO: CLAST OILED RIGOL LIMBO
LIMIT: CLAST GEOID UNLIT LIMIT
LINEN: CLAST OILED RANGY LINEN
LINER: CLAST OILED RANGY LINER
LINGO: CLAST OILED RIGOL LINGO
LIPID: CLAST OILED LIPID
LITHE: CLAST TOILE LITHE
LIVER: CLAST OILED RANGY FLUBS LIVER
LIVID: CLAST OILED LIPID LIVID
LLAMA: CLAST FERNY PUNGA LLAMA
LOAMY: CLAST LIVRE LOAMY
LOATH: CLAST THALI LOATH
LOBBY: CLAST OILED GURLY KNOSP LOBBY
LOCAL: CLAST RACED FOLLY LOCAL
LOCUS: CLAST HOKIS LOCOS LOCUS
LODGE: CLAST OILED GOORY LODGE
LOFTY: CLAST TOILE JOLTY LOFTY
LOGIC: CLAST LOCIE LORIC LOGIC
LOGIN: CLAST OILED ROOPY LOGIN
LOOPY: CLAST OILED GURLY KNOSP LOOPY
LOOSE: CLAST NEUME LOOSE
LORRY: CLAST OILED GURLY LORRY
LOSER: CLAST SOLEI DRUMS LOSER
LOUSE: CLAST NEUME LOUSE
LOUSY: CLAST NEUME LOUSY
LOVER: CLAST OILED NERVY LOVER
LOWER: CLAST OILED NERVY ROWEL LOWER
LOWLY: CLAST OILED GURLY NOHOW LOWLY
LOYAL: CLAST MARAE YUPON LOYAL
LUCID: CLAST LOCIE LUCID
LUCKY: CLAST LOCIE LUCKY
LUMEN: CLAST OILED BEVER KUGEL LUMEN
LUMPY: CLAST OILED BURGH LUMMY LUMPY
LUNAR: CLAST MARAE LIVOR LUNAR
LUNCH: CLAST LOCIE LURCH LUNCH
LUNGE: CLAST OILED MURLY LUNGE
LUPUS: CLAST SOLEI BRUNG SKIPS LUPUS
LURCH: CLAST LOCIE LURCH
LURID: CLAST OILED BUILD LURID
LUSTY: CLAST TELOS STILL LUSTY
LYING: CLAST OILED GRUMP LYING
LYMPH: CLAST OILED BURGH LYMPH
LYNCH: CLAST LOCIE LURCH LYNCH
LYRIC: CLAST LOCIE LUDIC LYRIC
MACAW: CLAST NICER KHAYA MACAW
MACHO: CLAST NICER KHAYA MACHO
MACRO: CLAST NICER MACRO
MADAM: CLAST MARAE INCUS MADAM
MADLY: CLAST MARAE MANLY MADLY
MAFIA: CLAST MARAE HONGI MAFIA
MAGIC: CLAST NICER GAMIC MAGIC
MAGMA: CLAST MARAE HONGI MAGMA
MAIZE: CLAST MARAE VYING MAIZE
MAJOR: CLAST MARAE MINGY MAJOR
MAKER: CLAST MARAE MAZER MAKER
MAMBO: CLAST MARAE UNKID MAMMY MAMBO
MAMMA: CLAST MARAE HONGI MAMMA
MAMMY: CLAST MARAE UNKID MAMMY
MANGA: CLAST MARAE HONGI MANGA
MANGE: CLAST MARAE VYING MANGE
MANGO: CLAST MARAE UNKID MANGY MANGO
MANGY: CLAST MARAE UNKID MANGY
MANIA: CLAST MARAE HONGI MANIA
MANIC: CLAST NICER GAMBA MANIC
MANLY: CLAST MARAE MANLY
MANOR: CLAST MARAE MINGY MANOR
MAPLE: CLAST MARAE MAPLE
MARCH: CLAST NICER DAMPY MARCH
MARRY: CLAST MARAE RORID MARRY
MARSH: CLAST MAIRE MARSH
MASON: CLAST NARES GOBAN SAYON MASON
MASSE: CLAST MAIRE MANSE MASSE
MATCH: CLAST AROHA MINGY MATCH
MATEY: CLAST TORTE DAMPY MATEY
MAUVE: CLAST MARAE VYING MAUVE
MAXIM: CLAST MARAE UNKID MAXIM
MAYBE: CLAST MARAE VYING MAYBE
MAYOR: CLAST MARAE MINGY MAYOR
MEALY: CLAST LIVRE WELLY MEALY
MEANT: CLAST PRUNE MEANT
MEATY: CLAST TRONE HIMBO MEATY
MECCA: CLAST NICER FAMED MECCA
MEDAL: CLAST MARAE MEDAL
MEDIA: CLAST MARAE MEKKA MEDIA
MEDIC: CLAST HONER DEICE MEDIC
MELEE: CLAST OILED BUMPY MELEE
MELON: CLAST OILED POWNY FAMED MELON
MERCY: CLAST HONER PRIDE RECCY MERCY
MERGE: CLAST RONDE BEIGE MERGE
MERIT: CLAST PROIN FAMED MERIT
MERRY: CLAST RONDE FERER BUMPH MERRY
METAL: CLAST TALEA EMPTS METAL
METER: CLAST TORTE MINED MUTER METER
METRO: CLAST TORTE RETOX METRO
MICRO: CLAST HONER BREID MICRO
MIDGE: CLAST RONDE BEDIM MIDGE
MIDST: CLAST OURIE DWALM MIDST
MIGHT: CLAST PROIN TIMED MIGHT
MILKY: CLAST OILED FUGLY MILKY
MIMIC: CLAST HONER DUMKY MIMIC
MINCE: CLAST HONER MIXUP MINCE
MINER: CLAST RONDE NIMBI MINER
MINIM: CLAST RONDE PIING MINIM
MINOR: CLAST RONDE MINOR
MINTY: CLAST TORTE FUNKY MINTY
MINUS: CLAST DONER SKUGS BUNNS MINUS
MIRTH: CLAST TORTE GUMMY MIRTH
MISER: CLAST DONER SPIKY MORRA MISER
MISSY: CLAST IRONE SYPHS MISSY
MOCHA: CLAST NICER KHAYA MOCHA
MODAL: CLAST MARAE DONGS MODAL
MODEL: CLAST OILED WOMYN MODEL
MODEM: CLAST RONDE WHOMP MOZED MODEM
MOGUL: CLAST OILED GURLY MOGUL
MOIST: CLAST OURIE FEHME MOIST
MOLAR: CLAST MARAE MYLAR MOLAR
MOLDY: CLAST OILED MOLDY
MONEY: CLAST RONDE NYMPH MONEY
MONTH: CLAST TORTE BUNJY MONTH
MOODY: CLAST RONDE DHOWS GAMBA MOODY
MOOSE: CLAST IRONE GOMBO MOOSE
MORAL: CLAST MARAE MURAL MORAL
MORON: CLAST RONDE PLUMY MORON
MORPH: CLAST RONDE GURRY MORPH
MOSSY: CLAST IRONE BUSHY MOSSY
MOTEL: CLAST TOILE RHEME MOTEL
MOTIF: CLAST TORTE MINGY MOTIF
MOTOR: CLAST TORTE ROTON MOTOR
MOTTO: CLAST TORTE NYMPH MOTTO
MOULT: CLAST GEOID PRAMS MOULT
MOUND: CLAST RONDE WHUMP MOUND
MOUNT: CLAST PROIN MOUNT
MOURN: CLAST RONDE PLUMY MOURN
MOUSE: CLAST IRONE BUSHY DUMMY MOUSE
MOUTH: CLAST TORTE BUNJY MOUTH
MOVER: CLAST RONDE WHUMP MOVER
MOVIE: CLAST RONDE GIMPY URBEX MOVIE
MOWER: CLAST RONDE WHUMP MOWER
MUCKY: CLAST HONER DUMKY MUCKY
MUCUS: CLAST KIORE SUMPS MUCUS
MUDDY: CLAST RONDE DWAUM MUDDY
MULCH: CLAST LOCIE MULCH
MUMMY: CLAST RONDE PIGMY MUMMY
MUNCH: CLAST HONER FRUMP MUNCH
MURAL: CLAST MARAE MURAL
MURKY: CLAST RONDE GUIMP MURRY MURKY
MUSHY: CLAST DONER SIMPS MUSKY MUSHY
MUSIC: CLAST KIORE MUCUS MUSIC
MUSKY: CLAST DONER SIMPS MUSKY
MUSTY: CLAST TORTE SHIMS MUSTY
MYRRH: CLAST RONDE GUIMP MYRRH
NADIR: CLAST MARAE POIND NADIR
NAIVE: CLAST MARAE FUNGI DAINE NAIVE
NANNY: CLAST MARAE DINGY WHARF JANNY NANNY
NASAL: CLAST SALLE BRINK NASAL
NASTY: CLAST TERTS SOPHY MANES NASTY
NATAL: CLAST TALEA DHIKR FATAL NATAL
NAVAL: CLAST MARAE GHYLL FUNKY NAVAL
NAVEL: CLAST MARAE LOWND PANEL NAVEL
NEEDY: CLAST RONDE NEEDY
NEIGH: CLAST RONDE HEMIN NEIGH
NERDY: CLAST RONDE NERDY
NERVE: CLAST RONDE BEING NERVE
NEVER: CLAST RONDE GIVEN NEVER
NEWER: CLAST RONDE GIVEN NEWER
NEWLY: CLAST OILED MURLY SHEWN NEWLY
NICER: CLAST HONER NICER
NICHE: CLAST HONER NICHE
NIECE: CLAST HONER NIECE
NIGHT: CLAST PROIN FEINT NIGHT
NINJA: CLAST MARAE POIND NUBIA NINJA
NINNY: CLAST RONDE PIING NYMPH NINNY
NINTH: CLAST TORTE FUNKY NINTH
NOBLE: CLAST OILED BOURN NOBLE
NOBLY: CLAST OILED GURLY NOHOW NOBLY
NOISE: CLAST IRONE NOISE
NOISY: CLAST IRONE NOISY
NOMAD: CLAST MARAE GUQIN NOMAD
NOOSE: CLAST IRONE NOOSE
NORTH: CLAST TORTE BANDY NORTH
NOSEY: CLAST DONER XYSTS NOSEY
NOTCH: CLAST KIORE BRUNG NOTCH
NOVEL: CLAST OILED NERVY NOVEL
NUDGE: CLAST RONDE UNDEE NUDIE NUDGE
NURSE: CLAST IRONE NURSE
NUTTY: CLAST TORTE BINGY NUTTY
NYLON: CLAST OILED POLLY NYLON
NYMPH: CLAST RONDE HUMPY NYMPH
OAKEN: CLAST MARAE WONKY OAKEN
OBESE: CLAST IRONE BUSHY OBESE
OCCUR: CLAST HONER MUCOR OCCUR
OCEAN: CLAST NICER PHONS OCEAN
OCTAL: CLAST TICAL OCTAL
OCTET: CLAST HIRED ONCET OCTET
ODDER: CLAST RONDE ODDER
ODDLY: CLAST OILED ODDLY
OFFAL: CLAST MARAE YUPON KOGAL OFFAL
OFFER: CLAST RONDE BREER OFFER
OFTEN: CLAST TORTE BETON OFTEN
OLDEN: CLAST BOUGE SDEIN OLDEN
OLDER: CLAST BOUGE SDEIN OLDER
OLIVE: CLAST BOUGE DYING OLIVE
OMBRE: CLAST RONDE PROBE OMBRE
OMEGA: CLAST MARAE EMEND OMEGA
ONION: CLAST RONDE GUIMP INION ONION
ONSET: CLAST ROUEN ONSET
OPERA: CLAST MARAE PINED APERY OPERA
OPINE: CLAST RONDE OOMPH OPINE
OPIUM: CLAST RONDE BUMPH OPIUM
OPTIC: CLAST KIORE XOANA OPTIC
ORBIT: CLAST PROIN ORBIT
ORDER: CLAST RONDE ODDER ORDER
ORGAN: CLAST MARAE BROND ORGAN
OTHER: CLAST TORTE RETOX OTHER
OTTER: CLAST TORTE OTTER
OUGHT: CLAST PROIN BOGUS OUGHT
OUNCE: CLAST HONER OUNCE
OUTDO: CLAST TORTE BIPOD OUTDO
OUTER: CLAST TORTE RETOX FURTH OUTER
OUTGO: CLAST TORTE BIPOD OUTGO
OVARY: CLAST DRONE GOETH OVARY
OVATE: CLAST TRONE OVATE
OVERT: CLAST PROIN ROBOT OVERT
OVINE: CLAST RONDE OOMPH OVINE
OVOID: CLAST RONDE HUMID PYOID OVOID
OWING: CLAST RONDE GUIMP OHING OWING
OWNER: CLAST RONDE OWNER
OXIDE: CLAST RONDE EPODE OXIDE
OZONE: CLAST RONDE OOMPH OZONE
PADDY: CLAST MARAE DINGY UPBOW PADDY
PAGAN: CLAST MARAE PWNED PAVAN PAGAN
PAINT: CLAST GRONE THIRD FAINT PAINT
PALER: CLAST MARAE WYLED PHONS PALER
PALSY: CLAST LYSSA PALSY
PANEL: CLAST MARAE LOWND PANEL
PANIC: CLAST NICER GAMBA PANIC
PANSY: CLAST MAIRE GASSY PANSY
PAPAL: CLAST MARAE GHYLL FUNKY PAPAL
PAPER: CLAST MARAE PODGY SWIVE PAPER
PARER: CLAST MARAE POWND SEVER PARER
PARKA: CLAST MARAE BINGY PARRA PARKA
PARRY: CLAST MARAE BIPOD PARRY
PARSE: CLAST MAIRE FARSE PARSE
PARTY: CLAST TORTE HAPPY PARTY
PASTA: CLAST TERTS SOPHY PASTA
PASTE: CLAST TERTS WHAUP PASTE
PASTY: CLAST TERTS SOPHY PASTY
PATCH: CLAST AROHA MINGY HOWBE PATCH
PATIO: CLAST TORTE MANES PATIO
PATSY: CLAST NOTER PATSY
PATTY: CLAST TORTE NUBIA FATTY PATTY
PAUSE: CLAST MAIRE SHUNT PAUSE
PAYEE: CLAST MARAE FUNGI PAYEE
PAYER: CLAST MARAE PODGY PAYER
PEACE: CLAST BROKE PEACE
PEACH: CLAST BROKE PEACH
PEARL: CLAST LIVRE PEARL
PECAN: CLAST NICER PECAN
PEDAL: CLAST MARAE DELPH PEDAL
PENAL: CLAST MARAE DELPH PENAL
PENCE: CLAST HONER MIXUP PENCE
PENNE: CLAST RONDE BEWIG VENUE PENNE
PENNY: CLAST RONDE PENNY
PERCH: CLAST HONER PERCH
PERIL: CLAST OILED VENGE MERIL PERIL
PERKY: CLAST RONDE FERER KEMPT PERKY
PESKY: CLAST DONER SMEKE PESKY
PESTO: CLAST TORTE MESTO PESTO
PETAL: CLAST TALEA EMPTS PETAL
PETTY: CLAST TORTE BUNJY PETTY
PHASE: CLAST RHEUM PHASE
PHONE: CLAST RONDE OOMPH PHONE
PHONY: CLAST RONDE GUIMP PHONY
PHOTO: CLAST TORTE PUNTO PHOTO
PIANO: CLAST DRONE GUANO PIANO
PICKY: CLAST HONER DUMKY WATAP PICKY
PIECE: CLAST HONER DEICE PIECE
PIETY: CLAST TORTE HEIGH PIETY
PIGGY: CLAST RONDE PIGMY PIGGY
PILOT: CLAST GEOID LIROT PILOT
PINCH: CLAST HONER FRUMP PINCH
PINEY: CLAST RONDE PENNY PINEY
PINKY: CLAST RONDE PIING PINKY
PINTO: CLAST TORTE PUNTO PINTO
PIPER: CLAST RONDE FERER BUMPH PAPAW PIPER
PIQUE: CLAST RONDE GUIMP PIQUE
PITCH: CLAST KIORE HOWDY GYMPS PITCH
PITHY: CLAST TORTE PITHY
PIVOT: CLAST PROIN PIVOT
PIXEL: CLAST OILED RANGY URBEX PIXEL
PIXIE: CLAST RONDE GUIMP PIXIE
PIZZA: CLAST MARAE POIND PIZZA
PLACE: CLAST BLYPE PLACE
PLAID: CLAST FERNY PUNGA PLAID
PLAIN: CLAST FERNY PLAIN
PLAIT: CLAST UNRIP PLAIT
PLANE: CLAST FERNY ALANE PLANE
PLANK: CLAST FERNY AGOOD PLANK
PLANT: CLAST UNRIP PLANT
PLATE: CLAST ALBEE PLATE
PLAZA: CLAST FERNY PUNGA PLAZA
PLEAD: CLAST AGONE MBIRA PLEAD
PLEAT: CLAST PROFS PLEAT
PLIED: CLAST BOUGE PREIF PLIED
PLIER: CLAST BOUGE PREIF PLIER
PLUCK: CLAST BEFIT PLUCK
PLUMB: CLAST BOUGE PLUMB
PLUME: CLAST BOUGE FLUME PLUME
PLUMP: CLAST BOUGE NIPPY PLUMP
PLUNK: CLAST BOUGE NIPPY PLUNK
PLUSH: CLAST SEIFS BLUSH PLUSH
POESY: CLAST IRONE POESY
POINT: CLAST PROIN POINT
POISE: CLAST IRONE HOISE POISE
POKER: CLAST RONDE WHUMP POKER
POLAR: CLAST MARAE LIVOR POLAR
POLKA: CLAST MARAE VIOLA POLKA
POLYP: CLAST OILED POLLY POLYP
POOCH: CLAST HONER GUIMP POOCH
POPPY: CLAST RONDE BUMPY PAPAW POPPY
PORCH: CLAST HONER PORCH
POSER: CLAST DONER SPREW POSER
POSIT: CLAST ROUEN GOSHT POSIT
POSSE: CLAST IRONE BUSHY FLOGS POSSE
POUCH: CLAST HONER GUIMP POUCH
POUND: CLAST RONDE WHUMP POUND
POUTY: CLAST TORTE BUNJY GOUTY POUTY
POWER: CLAST RONDE WHUMP POWER
PRANK: CLAST DRONE GOPIK PRANK
PRAWN: CLAST DRONE BRAWN PRAWN
PREEN: CLAST RONDE GIVEN PREEN
PRESS: CLAST IRONE PRESS
PRICE: CLAST HONER PRIDE PRICE
PRICK: CLAST HONER WIMPY PRICK
PRIDE: CLAST RONDE BEWIG PRIDE
PRIED: CLAST RONDE DRIER WATAP PRIED
PRIME: CLAST RONDE BEIGE FRIZE PRIME
PRIMO: CLAST RONDE GROOM PRIMO
PRINT: CLAST PROIN PRINT
PRIOR: CLAST RONDE GROOM PRIOR
PRISM: CLAST IRONE KEMBS PRISM
PRIVY: CLAST RONDE GUIMP PRIVY
PRIZE: CLAST RONDE BEIGE FRIZE PRIZE
PROBE: CLAST RONDE PROBE
PRONE: CLAST RONDE PIKED PRONE
PRONG: CLAST RONDE GIPON PRONG
PROOF: CLAST RONDE GROOM PROOF
PROSE: CLAST IRONE PHEER PROSE
PROUD: CLAST RONDE DROOK PROUD
PROVE: CLAST RONDE PROBE QUIRK PROVE
PROWL: CLAST OILED GURLY WHORL PROWL
PROXY: CLAST RONDE GROOM FRORY PROXY
PRUDE: CLAST RONDE BEWIG PRUDE
PRUNE: CLAST RONDE BEING PRUNE
PSALM: CLAST SPELD PSALM
PUBIC: CLAST HONER DUMKY PUBIC
PUDGY: CLAST RONDE PIGMY PUDGY
PUFFY: CLAST RONDE PIGMY PUPPY PUFFY
PULPY: CLAST OILED GULPH PULPY
PULSE: CLAST NEUME DEBAG PULSE
PUNCH: CLAST HONER FRUMP PUNCH
PUPAL: CLAST MARAE YUPON PUPAL
PUPIL: CLAST OILED GRUMP LUPIN PUPIL
PUPPY: CLAST RONDE PIGMY PUPPY
PUREE: CLAST RONDE BEIGE FRUMP PUREE
PURER: CLAST RONDE FERER WIRER PURER
PURGE: CLAST RONDE BEIGE PURGE
PURSE: CLAST IRONE BUMPH PURSE
PUSHY: CLAST DONER SIMPS PUSHY
PUTTY: CLAST TORTE BINGY VESPA PUTTY
PYGMY: CLAST RONDE PIGMY PYGMY
QUACK: CLAST BROKE WINDY QUACK
QUAIL: CLAST LIVRE QUAIL
QUAKE: CLAST DRONE WEIGH AMAZE QUAKE
QUALM: CLAST LIVRE DORMY QUALM
QUARK: CLAST DRONE QUIFF QUARK
QUART: CLAST PRUNE TUART QUART
QUASH: CLAST RHEUM QUASH
QUASI: CLAST RHEUM QUASS QUASI
QUEEN: CLAST RONDE HEMIN UNPEN QUEEN
QUEER: CLAST RONDE FERER BUMPH QUEER
QUELL: CLAST OILED MURLY FUGLE QUELL
QUERY: CLAST RONDE FERER PREMY QUERY
QUEST: CLAST OURIE QUEST
QUEUE: CLAST RONDE GUIMP FUZEE QUEUE
QUICK: CLAST HONER DUMKY QUICK
QUIET: CLAST PROIN TIMED QUIET
QUILL: CLAST OILED GRUMP QUILL
QUILT: CLAST GEOID BUILT QUILT
QUIRK: CLAST RONDE GUIMP QUIRK
QUITE: CLAST TORTE WEENY MIXTE QUITE
QUOTA: CLAST TORTE DUOMI QUOTA
QUOTE: CLAST TORTE EMOTE QUOTE
QUOTH: CLAST TORTE PUNTO QUOTH
RABBI: CLAST MARAE POIND FLUBS RABBI
RABID: CLAST MARAE POIND RABID
RACER: CLAST NICER FRUMP RACER
RADAR: CLAST MARAE BANDY RADAR
RADII: CLAST MARAE POIND RADII
RADIO: CLAST MARAE POIND RADIO
RAINY: CLAST MARAE POIND RAINY
RAISE: CLAST MAIRE RAISE
RAJAH: CLAST MARAE BANDY GAZAR RAJAH
RALLY: CLAST MARAE FOLLY RALLY
RALPH: CLAST MARAE FOLLY RALPH
RAMEN: CLAST MARAE NAMER RAMEN
RANCH: CLAST NICER RANCH
RANDY: CLAST MARAE POIND RANDY
RANGE: CLAST MARAE EIGNE RANGE
RAPID: CLAST MARAE POIND RAPID
RARER: CLAST MARAE POWND BOYFS RARER
RASPY: CLAST NARES OVARY RASPY
RATIO: CLAST TORTE GATOR RATIO
RATTY: CLAST TORTE RATTY
RAVEN: CLAST MARAE PODGY WAKFS HAVER RAVEN
RAYON: CLAST MARAE POIND RAYON
RAZOR: CLAST MARAE POIND RAZOO RAZOR
REACH: CLAST BROKE REACH
REACT: CLAST ENFIX REACT
READY: CLAST DRONE HOODY READY
REALM: CLAST LIVRE REALO REALM
REARM: CLAST DRONE REAMY REARM
REBAR: CLAST MARAE DEBUR REBAR
REBEL: CLAST OILED BEVER REBEL
REBUS: CLAST DONER SEMIE BUSKY REBUS
REBUT: CLAST PROIN REVET REBUT
RECAP: CLAST NICER RACHE RECAP
RECUR: CLAST HONER RECUR
RECUT: CLAST HIRED RECUT
REEDY: CLAST RONDE REDDY REEDY
REFER: CLAST RONDE MIFTY REFER
REFIT: CLAST PROIN FAMED REFIT
REGAL: CLAST MARAE RELAY RENAL REGAL
REHAB: CLAST MARAE DEBUR REHAB
REIGN: CLAST RONDE REPIN REIGN
RELAX: CLAST MARAE RELAY RELAX
RELAY: CLAST MARAE RELAY
RELIC: CLAST LOCIE RELIC
REMIT: CLAST PROIN FAMED REMIT
RENAL: CLAST MARAE RELAY RENAL
RENEW: CLAST RONDE MINGY RENEW
REPAY: CLAST MARAE DEBUR RENAY REPAY
REPEL: CLAST OILED BEVER FRUMP REPEL
REPLY: CLAST OILED MURLY REPLY
RERUN: CLAST RONDE REPIN RERUN
RESET: CLAST ROUEN RESET
RESIN: CLAST DONER BERKS RESIN
RETCH: CLAST KIORE RETCH
RETRO: CLAST TORTE RETOX RETRO
RETRY: CLAST TORTE MINED RETRY
REUSE: CLAST IRONE BUMPH REUSE
REVEL: CLAST OILED BEVER REVEL
REVUE: CLAST RONDE MIEVE REVUE
RHINO: CLAST RONDE RHINO
RHYME: CLAST RONDE MIEVE RHYME
RIDER: CLAST RONDE BIDDY RIDER
RIDGE: CLAST RONDE RUDIE RIDGE
RIFLE: CLAST OILED VERGE RIFLE
RIGHT: CLAST PROIN RIVET RIGHT
RIGID: CLAST RONDE RIDGY RIGID
RIGOR: CLAST RONDE RUMBO RIGOR
RINSE: CLAST IRONE RINSE
RIPEN: CLAST RONDE REPIN RIPEN
RIPER: CLAST RONDE MIFTY RIVER RIPER
RISEN: CLAST DONER RISEN
RISER: CLAST DONER SPIKY MORRA RISER
RISKY: CLAST DONER RURPS RISKY
RIVAL: CLAST MARAE LIVOR RIVAL
RIVER: CLAST RONDE MIFTY RIVER
RIVET: CLAST PROIN RIVET
ROACH: CLAST BROKE ROACH
ROAST: CLAST BROGH ROAST
ROBIN: CLAST RONDE ROBIN
ROBOT: CLAST PROIN ROBOT
ROCKY: CLAST HONER RIDES ROCKY
RODEO: CLAST RONDE VODKA RODEO
ROGER: CLAST RONDE PAVER KAGUS ROGER
ROGUE: CLAST RONDE WIGAN ROGUE
ROOMY: CLAST RONDE FRUMP ROOMY
ROOST: CLAST OURIE FROST ROOST
ROTOR: CLAST TORTE ROTON ROTOR
ROUGE: CLAST RONDE WIGAN ROUGE
ROUGH: CLAST RONDE FRUMP ROUGH
ROUND: CLAST RONDE ROUND
ROUSE: CLAST IRONE DOUGH ROUSE
ROUTE: CLAST TORTE RONTE ROUTE
ROVER: CLAST RONDE PAVER ROVER
ROWDY: CLAST RONDE ROWDY
ROWER: CLAST RONDE PAVER KAGUS ROWER
ROYAL: CLAST MARAE LIVOR ROLAG ROYAL
RUDDY: CLAST RONDE RUDDY
RUDER: CLAST RONDE BIDDY RUDER
RUGBY: CLAST RONDE RHUMB RUBBY RUGBY
RULER: CLAST OILED BUMPY RULER
RUMBA: CLAST MARAE AMOUR RUMBA
RUMOR: CLAST RONDE RUMBO RUMOR
RUPEE: CLAST RONDE MIEVE REBBE RUPEE
RURAL: CLAST MARAE ROUGH RURAL
RUSTY: CLAST TORTE BINGY RUSTY
SADLY: CLAST SALLE LORIS SADLY
SAFER: CLAST NARES BOSKY GOWFS SAFER
SAINT: CLAST URSAE SAINT
SALAD: CLAST SALLE ORPIN SALAD
SALLY: CLAST SALLE SALLY
SALON: CLAST SALLE ORPIN SALON
SALSA: CLAST LYSSA SALSA
SALTY: CLAST TOLAS SALTY
SALVE: CLAST SALLE SALUE SALVE
SALVO: CLAST SALLE ORPIN SALVO
SANDY: CLAST NARES GOBAN SAUNA SANDY
SANER: CLAST NARES SANER
SAPPY: CLAST NARES IMSHY AGAVE SAPPY
SASSY: CLAST MAIRE GASSY SASSY
SATIN: CLAST TERTS OSTIA SATIN
SATYR: CLAST TERTS ASTIR SATYR
SAUCE: CLAST MARES SAICE SAUCE
SAUCY: CLAST MARES SAUCY
SAUNA: CLAST NARES GOBAN SAUNA
SAUTE: CLAST TERTS WHAUP SAUTE
SAVOR: CLAST NARES OVARY SAVOR
SAVOY: CLAST NARES IMSHY AGAVE SAVOY
SAVVY: CLAST NARES IMSHY AGAVE SAVVY
SCALD: CLAST DELLY SCALD
SCALE: CLAST DELLY SCALE
SCALP: CLAST DELLY SCALP
SCALY: CLAST DELLY SCALY
SCAMP: CLAST PERCS AMIAS SCAMP
SCANT: CLAST FURTH SCANT
SCARE: CLAST PERCS SCARE
SCARF: CLAST PERCS SCARF
SCARY: CLAST PERCS SCARF SCARY
SCENE: CLAST KIORE SYCEE SCENE
SCENT: CLAST POUPE SCENT
SCION: CLAST KIORE SCION
SCOFF: CLAST KIORE UPDOS SCOFF
SCOLD: CLAST HOKIS SCOLD
SCONE: CLAST KIORE SCOPE SCONE
SCOOP: CLAST KIORE UPDOS SCOOP
SCOPE: CLAST KIORE SCOPE
SCORE: CLAST KIORE SCORE
SCORN: CLAST KIORE SCORN
SCOUR: CLAST KIORE SCOUR
SCOUT: CLAST POUPE SCOUT
SCOWL: CLAST HOKIS SCOLD SCOWL
SCRAM: CLAST MARES SCRAM
SCRAP: CLAST MARES POWNY SCRAP
SCREE: CLAST KIORE SCREE
SCREW: CLAST KIORE PERCS SCREW
SCRUB: CLAST KIORE SCRUB
SCRUM: CLAST KIORE SCRUB SCRUM
SCUBA: CLAST MARES PHOCA SCUBA
SEDAN: CLAST NARES KNEAD SEDAN
SEEDY: CLAST DONER WEEDY SEEDY
SEGUE: CLAST DONER SMEKE SEGUE
SEIZE: CLAST DONER SMEKE SEGUE SEIZE
SEMEN: CLAST DONER WEEKS MELTY SEMEN
SENSE: CLAST IRONE SMEKE SENSE
SEPIA: CLAST NARES SEPIA
SERIF: CLAST DONER SEMIE SERIF
SERUM: CLAST DONER SEMIE SERUM
SERVE: CLAST DONER SEMIE GLARE SERVE
SETUP: CLAST TORTE MINES STEDD SETUP
SEVEN: CLAST DONER WEEKS MELTY SEVEN
SEVER: CLAST DONER SPIKY WERSH ENFIX SEVER
SEWER: CLAST DONER SPIKY WERSH SEWER
SHACK: CLAST PERCS SHEWN SHACK
SHADE: CLAST PRONE VEHME SHAKE SHADE
SHADY: CLAST PRONE WHIDS SHADY
SHAFT: CLAST PARKI SHAFT
SHAKE: CLAST PRONE VEHME SHAKE
SHAKY: CLAST PRONE WHIDS SHAYA SHAKY
SHALE: CLAST SPELD SWALE SHALE
SHALL: CLAST SPELD HILLY SHALL
SHALT: CLAST RHEME SHALT
SHAME: CLAST PRONE VEHME SHAME
SHANK: CLAST PRONE SKUGS SHANK
SHAPE: CLAST PRONE SPADE SHAPE
SHARD: CLAST PRONE KADIS SWARD SHARD
SHARE: CLAST PRONE RHEME SHARE
SHARK: CLAST PRONE KADIS SHARK
SHARP: CLAST PRONE DZHOS SHARP
SHAVE: CLAST PRONE VEHME SHAVE
SHAWL: CLAST SPELD SWINE SHAWL
SHEAR: CLAST NARES SEWAR CHOMP SHEAR
SHEEN: CLAST DONER WEEKS SHEEN
SHEEP: CLAST DONER SIMPS SHEEP
SHEER: CLAST DONER SPIKY WERSH SHEER
SHEET: CLAST ROUEN SHEWN SHEET
SHEIK: CLAST DONER SMEKE GYMPS SHEIK
SHELF: CLAST SOLEI PIKUL HOODY SHELF
SHELL: CLAST SOLEI PIKUL SHEWN SHELL
SHIED: CLAST DONER WISPS SHIED
SHIFT: CLAST ROUEN WISHT SHIFT
SHINE: CLAST DONER SEINE SHEWN SHINE
SHINY: CLAST DONER SKIPS SUING SHINY
SHIRE: CLAST DONER SEMIE SHEWN SHIRE
SHIRK: CLAST DONER RURPS SHIRK
SHIRT: CLAST ROUEN SHTIK SHIRT
SHOAL: CLAST SALLE YOICK SHOAL
SHOCK: CLAST KIORE SHOCK
SHONE: CLAST DONER PEONS SHONE
SHOOK: CLAST DONER MISOS SPOOF SHOOK
SHOOT: CLAST ROUEN WHOOP SHOOT
SHORE: CLAST DONER HERMS SHORE
SHORN: CLAST DONER SWINE SHORN
SHORT: CLAST ROUEN PHONS SHORT
SHOUT: CLAST ROUEN CHOMP SHOUT
SHOVE: CLAST DONER KEMPS SYBOE SHOVE
SHOWN: CLAST DONER KNOWS SHOWN
SHOWY: CLAST DONER MISOS SHOYU SHOWY
SHREW: CLAST DONER RISUS SPREW SHREW
SHRUB: CLAST DONER RURPS SHRUG SHRUB
SHRUG: CLAST DONER RURPS SHRUG
SHUCK: CLAST KIORE SYPHS SHUCK
SHUNT: CLAST ROUEN SHUNT
SHUSH: CLAST IRONE PASHM SHUSH
SHYLY: CLAST SOLEI FLUNK SHYLY
SIEGE: CLAST DONER SMEKE SIEVE SIEGE
SIEVE: CLAST DONER SMEKE SIEVE
SIGHT: CLAST ROUEN WISHT SIGHT
SIGMA: CLAST NARES SUSHI SIMBA SIGMA
SILKY: CLAST SOLEI DIALS SILKY
SILLY: CLAST SOLEI DIALS SILLY
SINCE: CLAST KIORE SINCE
SINEW: CLAST DONER SIMPS SINEW
SINGE: CLAST DONER PIGMY SINGE
SIREN: CLAST DONER RISEN SIREN
SISSY: CLAST IRONE SYPHS SISSY
SIXTH: CLAST TORTE SHIMS SIXTH
SIXTY: CLAST TORTE SHIMS SIXTY
SKATE: CLAST TRITE SKATE
SKIER: CLAST DONER SPIKY SKIER
SKIFF: CLAST DONER SIMPS MAUZY SKIFF
SKILL: CLAST SOLEI MIRKY SKILL
SKIMP: CLAST DONER SIMPS SKIMP
SKIRT: CLAST ROUEN SHTIK SKIRT
SKULK: CLAST SOLEI FLUNK SKULK
SKULL: CLAST SOLEI FLUNK SKULL
SKUNK: CLAST DONER SKIPS SKUNK
SLACK: CLAST SLACK
SLAIN: CLAST SPEND SLAIN
SLANG: CLAST SPEND SLANG
SLANT: CLAST SLART SLANT
SLASH: CLAST HESPS SLASH
SLATE: CLAST SPIFS SLATY SLATE
SLAVE: CLAST SPEND SLAVE
SLEEK: CLAST BOEPS SLEEK
SLEEP: CLAST BOEPS SLEEP
SLEET: CLAST POUPE SLEET
SLEPT: CLAST POUPE SLEPT
SLICE: CLAST JOBES SLICE
SLICK: CLAST JOBES SLICK
SLIDE: CLAST BOEPS AMIDE SLIDE
SLIME: CLAST BOEPS AMIDE SLIME
SLIMY: CLAST BOEPS MINGY SLIMY
SLING: CLAST BOEPS MINGY SLING
SLINK: CLAST BOEPS MINGY SLINK
SLOOP: CLAST BOEPS SLOOP
SLOPE: CLAST BOEPS SLOPE
SLOSH: CLAST SEIFS SLOSH
SLOTH: CLAST GOBIS SLOTH
SLUMP: CLAST BOEPS SLUMP
SLUNG: CLAST BOEPS MINGY SLUNG
SLUNK: CLAST BOEPS MINGY SLUNK
SLURP: CLAST BOEPS SLUMP SLURP
SLUSH: CLAST SEIFS SLOSH SLUSH
SLYLY: CLAST BOEPS MINGY SLYLY
SMACK: CLAST PERCS SHEWN SMACK
SMALL: CLAST SPELD HILLY SMALL
SMART: CLAST PARKI ATMAN SMART
SMASH: CLAST RHEUM SMASH
SMEAR: CLAST NARES SEWAR CHOMP SMEAR
SMELL: CLAST SOLEI PIKUL SHEWN SMELL
SMELT: CLAST AMPLE SMELT
SMILE: CLAST SOLEI SWIPE SMILE
SMIRK: CLAST DONER RURPS SHIRK SMIRK
SMITE: CLAST TORTE GUIMP SMITE
SMITH: CLAST TORTE SHIMS SMITH
SMOCK: CLAST KIORE SHOCK SMOCK
SMOKE: CLAST DONER KEMPS SMOKE
SMOKY: CLAST DONER MISOS SMOKY
SMOTE: CLAST TORTE SMOTE
SNACK: CLAST PERCS SHEWN SNACK
SNAIL: CLAST SPELD SWINE SNAIL
SNAKE: CLAST PRONE SNAKE
SNAKY: CLAST PRONE SNIGS SNAKY
SNARE: CLAST PRONE SNARE
SNARL: CLAST SPELD SWINE SNARL
SNEAK: CLAST NARES KNEAD SNEAK
SNEER: CLAST DONER SNEER
SNIDE: CLAST DONER SNIPY SNIDE
SNIFF: CLAST DONER SKIPS SUING SNIFF
SNIPE: CLAST DONER SEINE SNIPE
SNOOP: CLAST DONER KNOWS SNOOP
SNORE: CLAST DONER SERON SNORE
SNORT: CLAST ROUEN SNORT
SNOUT: CLAST ROUEN SNOUT
SNOWY: CLAST DONER KNOWS SNOWY
SNUCK: CLAST KIORE SYPHS SNUCK
SNUFF: CLAST DONER SKIPS SNUFF
SOAPY: CLAST PRONE SOAPS SOAPY
SOBER: CLAST DONER SPREW SOBER
SOGGY: CLAST DONER BUMPH GOOFS SOGGY
SOLAR: CLAST SALLE HORNY SOLAR
SOLID: CLAST SOLEI SOLID
SOLVE: CLAST SOLEI SOLVE
SONAR: CLAST NARES SONAR
SONIC: CLAST KIORE SCION SONIC
SOOTH: CLAST TORTE SHOPS SOOTH
SOOTY: CLAST TORTE SHOPS SOOTY
SORRY: CLAST DONER MURKY SORRY
SOUND: CLAST DONER SOWND SOUND
SOUTH: CLAST TORTE SHOPS SOUTH
SOWER: CLAST DONER SPREW SOWER
SPACE: CLAST PERCS SPACE
SPADE: CLAST PRONE SPADE
SPANK: CLAST PRONE FLOGS SPANK
SPARE: CLAST PRONE SPARE
SPARK: CLAST PRONE DZHOS SPARK
SPASM: CLAST RHEUM SPASM
SPAWN: CLAST PRONE SPAWN
SPEAK: CLAST NARES SEPIA SPEAK
SPEAR: CLAST NARES SEWAR CHOMP SPEAR
SPECK: CLAST KIORE NYMPH PECKS SPECK
SPEED: CLAST DONER WISPS SPEED
SPELL: CLAST SOLEI PIKUL SPELL
SPELT: CLAST AMPLE SPELT
SPEND: CLAST DONER SNIPY SPEND
SPENT: CLAST ROUEN STIRP SPENT
SPERM: CLAST DONER SEMIE SPERM
SPICE: CLAST KIORE SPICE
SPICY: CLAST KIORE MUCUS SPICY
SPIED: CLAST DONER WISPS SPIED
SPIEL: CLAST SOLEI SHIEL SPIEL
SPIKE: CLAST DONER SMEKE SPIKE
SPIKY: CLAST DONER SIMPS SPIKY
SPILL: CLAST SOLEI MIRKY SHEWN SPILL
SPILT: CLAST AMPLE SPILT
SPINE: CLAST DONER SEINE SHEWN SPINE
SPINY: CLAST DONER SKIPS SPINY
SPIRE: CLAST DONER SEMIE SHEWN SPIRE
SPITE: CLAST TORTE GUIMP SPITE
SPLAT: CLAST POUPE SPLAT
SPLIT: CLAST AMPLE SPLIT
SPOIL: CLAST SOLEI SPOIL
SPOKE: CLAST DONER KEMPS SPOKE
SPOOF: CLAST DONER MISOS SPOOF
SPOOK: CLAST DONER MISOS SPOOF SPOOK
SPOOL: CLAST SOLEI PHONO SPOOL
SPOON: CLAST DONER KNOWS SPOON
SPORE: CLAST DONER HERMS SPORE
SPORT: CLAST ROUEN PHONS SPORT
SPOUT: CLAST ROUEN CHOMP SPOUT
SPRAY: CLAST NARES DOUGH SIRRA SPRAY
SPREE: CLAST DONER RISUS SPREW SPREE
SPRIG: CLAST DONER RURPS SPRIG
SPUNK: CLAST DONER SKIPS SPUNK
SPURN: CLAST DONER PURGE SPURN
SPURT: CLAST ROUEN STURT SPURT
SQUAD: CLAST NARES SUSHI DEBAG SQUAD
SQUAT: CLAST URSAE SQUAT
SQUIB: CLAST DONER SIMPS MAUZY SQUIB
STACK: CLAST SCATS STACK
STAFF: CLAST TRITE PUNGS STAFF
STAGE: CLAST TRITE DONGS STAGE
STAID: CLAST TRITE SEGNI STAID
STAIN: CLAST TRITE SEGNI STAIN
STAIR: CLAST TRITE STAIR
STAKE: CLAST TRITE DONGS STAVE STAKE
STALE: CLAST SALLE STALE
STALK: CLAST SALLE STALK
STALL: CLAST SALLE STALL
STAMP: CLAST TRITE PUNGS STAPH STAMP
STAND: CLAST TRITE PUNGS STAND
STANK: CLAST TRITE PUNGS STAND STANK
STARE: CLAST TRITE STARE
STARK: CLAST TRITE NARKS STARK
START: CLAST PARKI ATMAN START
STASH: CLAST TRASS STASH
STATE: CLAST TRITE STATE
STAVE: CLAST TRITE DONGS STAVE
STEAD: CLAST TERTS AMEND STEAD
STEAK: CLAST TERTS AMEND STEAK
STEAL: CLAST TOLAS STEAL
STEAM: CLAST TERTS AMEND STEAM
STEED: CLAST TORTE MINES DIPPY STEED
STEEL: CLAST TELOS ESILE STEEL
STEEP: CLAST TORTE MINES DIPPY STEEP
STEER: CLAST TORTE RITES STEER
STEIN: CLAST TORTE MINES STEIN
STERN: CLAST TORTE RITES STERN
STICK: CLAST KIORE STICK
STIFF: CLAST TORTE MUNIS STIVY STIFF
STILL: CLAST TELOS STILL
STILT: CLAST AMPLE STILT
STING: CLAST TORTE MUNIS STINK STING
STINK: CLAST TORTE MUNIS STINK
STINT: CLAST ROUEN SKINT STINT
STOCK: CLAST KIORE STOCK
STOIC: CLAST KIORE STOIC
STOKE: CLAST TORTE PEKIN STOKE
STOLE: CLAST TELOS STOLE
STOMP: CLAST TORTE YUPON STOWP STOMP
STONE: CLAST TORTE PEKIN STONE
STONY: CLAST TORTE YUPON STONY
STOOD: CLAST TORTE YUPON STOOD
STOOL: CLAST TELOS SOTOL STOOL
STOOP: CLAST TORTE YUPON STOOP
STORE: CLAST TORTE STORE
STORK: CLAST TORTE YUKOS STORK
STORM: CLAST TORTE YUKOS STORM
STORY: CLAST TORTE YUKOS STORY
STOUT: CLAST ROUEN CHOMP STOUT
STOVE: CLAST TORTE PEKIN STOVE
STRAP: CLAST TERTS WINDY KAGUS STRAP
STRAW: CLAST TERTS WINDY STRAW
STRAY: CLAST TERTS WINDY STRAY
STRIP: CLAST TORTE MOGUL STRIP
STRUT: CLAST ROUEN STRUT
STUCK: CLAST KIORE STUCK
STUDY: CLAST TORTE MUNIS STUFF STUDY
STUFF: CLAST TORTE MUNIS STUFF
STUMP: CLAST TORTE MUNIS STUMP
STUNG: CLAST TORTE MUNIS STUNG
STUNK: CLAST TORTE MUNIS STUNG STUNK
STUNT: CLAST ROUEN SHUNT STUNT
STYLE: CLAST TELOS ESILE STYLE
SUAVE: CLAST PRONE VEHME SUAVE
SUGAR: CLAST NARES PULMO SUGAR
SUING: CLAST DONER SKIPS SUING
SUITE: CLAST TORTE GUIMP SUITE
SULKY: CLAST SOLEI HULKY SULKY
SULLY: CLAST SOLEI HULKY SULLY
SUMAC: CLAST MARES SUMAC
SUNNY: CLAST DONER SKUGS SUNNY
SUPER: CLAST DONER SPIKY SUPER
SURER: CLAST DONER SPIKY WERSH SURER
SURGE: CLAST DONER SEMIE SPYRE SURGE
SURLY: CLAST SOLEI FLUNK SURLY
SUSHI: CLAST DONER SIMPS SUSHI
SWAMI: CLAST PRONE WHIDS SWAMI
SWAMP: CLAST PRONE AWAYS SWAMP
SWARM: CLAST PRONE KADIS SMARM SWARM
SWASH: CLAST RHEUM SHEWN SWASH
SWATH: CLAST TRITE BOUGH SWATH
SWEAR: CLAST NARES SEWAR SWEAR
SWEAT: CLAST URSAE SPEAT SWEAT
SWEEP: CLAST DONER SIMPS SHEEP SWEEP
SWEET: CLAST ROUEN SHEWN SWEET
SWELL: CLAST SOLEI PIKUL SHEWN SWELL
SWEPT: CLAST ROUEN SWEPT
SWIFT: CLAST ROUEN WISHT SWIFT
SWILL: CLAST SOLEI MIRKY SHEWN SWILL
SWINE: CLAST DONER SEINE SHEWN SWINE
SWING: CLAST DONER SKIPS SUING SWING
SWIRL: CLAST SOLEI MIRKY SWIRL
SWISH: CLAST IRONE SYPHS SHISH SWISH
SWOON: CLAST DONER KNOWS SWOON
SWOOP: CLAST DONER MISOS SPOOF SWOOP
SWORD: CLAST DONER PRODS SWORD
SWORE: CLAST DONER HERMS SPORE SWORE
SWORN: CLAST DONER SWINE SWORN
SWUNG: CLAST DONER SKIPS SNUFF SWUNG
SYNOD: CLAST DONER SYNOD
SYRUP: CLAST DONER RURPS SIRUP SYRUP
TABBY: CLAST TORTE AMNIA BEFOG TABBY
TABLE: CLAST TALEA TABLE
TABOO: CLAST TORTE TAXON TABOO
TACIT: CLAST TACET TACIT
TACKY: CLAST AROHA TACKY
TAFFY: CLAST TORTE AMNIA BEFOG TAFFY
TAINT: CLAST GRONE THIRD TAINT
TAKEN: CLAST TORTE PANIM TAKEN
TAKER: CLAST TORTE MAWKS TAKER
TALLY: CLAST TALEA TALKY TALLY
TALON: CLAST TALEA TALKY TALON
TAMER: CLAST TORTE MAWKS TAMER
TANGO: CLAST TORTE TAXON TANGO
TANGY: CLAST TORTE AMNIA TANGY
TAPER: CLAST TORTE MAWKS VIBEX TAPER
TAPIR: CLAST TORTE TAIRA TAPIR
TARDY: CLAST TORTE TARRY TARDY
TAROT: CLAST GRONE MORAT TAROT
TASTE: CLAST TERTS TASTE
TASTY: CLAST TERTS TASTY
TATTY: CLAST TORTE TANTY TATTY
TAUNT: CLAST GRONE THIRD TAUNT
TAWNY: CLAST TORTE AMNIA TAWNY
TEACH: CLAST TRACK TEACH
TEARY: CLAST TRONE TEARY
TEASE: CLAST TRASS TEASE
TEDDY: CLAST TORTE PIEND TEDDY
TEETH: CLAST TORTE TEETH
TEMPO: CLAST TORTE TENON TEMPO
TENET: CLAST PROIN KEDGE BENET TENET
TENOR: CLAST TORTE TWOER TENOR
TENSE: CLAST IRONE TENSE
TENTH: CLAST TORTE TEETH TENTH
TEPEE: CLAST TORTE EMEND TEPEE
TEPID: CLAST TORTE PIEND TEPID
TERRA: CLAST TORTE TERRA
TERSE: CLAST IRONE TERSE
TESTY: CLAST TORTE SORNS TESTY
THANK: CLAST TRONE CHEKA THANK
THEFT: CLAST PROIN MEWED THEFT
THEIR: CLAST TORTE WRIED THEIR
THEME: CLAST TORTE EMEND THEME
THERE: CLAST TORTE DRINK THERE
THESE: CLAST IRONE THESE
THETA: CLAST TORTE THETA
THICK: CLAST KIORE THICK
THIEF: CLAST TORTE PIEND THIEF
THIGH: CLAST TORTE GIMPY THING THIGH
THING: CLAST TORTE GIMPY THING
THINK: CLAST TORTE GIMPY THINK
THIRD: CLAST TORTE TRUMP THIRD
THONG: CLAST TORTE TIMBO THONG
THORN: CLAST TORTE PRION THORN
THOSE: CLAST IRONE THOSE
THREE: CLAST TORTE TERFE THREE
THREW: CLAST TORTE WELLY THREW
THROB: CLAST TORTE THROW THROB
THROW: CLAST TORTE THROW
THRUM: CLAST TORTE THRIP THRUM
THUMB: CLAST TORTE GIMPY THUMB
THUMP: CLAST TORTE GIMPY THUMP
THYME: CLAST TORTE EMEND THYME
TIARA: CLAST TRONE TIARA
TIBIA: CLAST TORTE AMNIA TIBIA
TIDAL: CLAST TALEA BOING TIDAL
TIGER: CLAST TORTE WRIED TIMER TIGER
TIGHT: CLAST PROIN TIMED TIGHT
TILDE: CLAST TOILE TILDE
TIMER: CLAST TORTE WRIED TIMER
TIMID: CLAST TORTE GIMPY TIMID
TIPSY: CLAST IRONE BITSY TIPSY
TITAN: CLAST TORTE TITAN
TITHE: CLAST TORTE TITHE
TITLE: CLAST TOILE TITLE
TOAST: CLAST BROGH TOAST
TODAY: CLAST TORTE KINDA TODAY
TODDY: CLAST TORTE DUING TODDY
TOKEN: CLAST TORTE PUNKY TOKEN
TONAL: CLAST TALEA BOING TONAL
TONGA: CLAST TORTE KINDA TONGA
TONIC: CLAST KIORE XOANA TONIC
TOOTH: CLAST TORTE TOOTH
TOPAZ: CLAST TORTE KINDA TOPAZ
TOPIC: CLAST KIORE XOANA TOPIC
TORCH: CLAST KIORE TORCH
TORSO: CLAST IRONE TORSO
TORUS: CLAST TORTE EMURE TORUS
TOTAL: CLAST TALEA BOING TOTAL
TOTEM: CLAST TORTE TOTEM
TOUCH: CLAST KIORE BRUNG TOUCH
TOUGH: CLAST TORTE DUING TOUGH
TOWEL: CLAST TOILE TOWEL
TOWER: CLAST TORTE POWNY TOWER
TOXIC: CLAST KIORE XOANA TOXIC
TOXIN: CLAST TORTE DUING TOXIN
TRACE: CLAST TRACK TRACE
TRACK: CLAST TRACK
TRACT: CLAST ENFIX BRACT TRACT
TRADE: CLAST TRONE VESPA TRADE
TRAIL: CLAST THALI TRAIL
TRAIN: CLAST TRONE TRAIN
TRAIT: CLAST PRUNE KIDGE TRAIT
TRAMP: CLAST TRONE FLING TRAMP
TRASH: CLAST TRASS TRASH
TRAWL: CLAST THALI TRAWL
TREAD: CLAST TORTE MAWKS TREAD
TREAT: CLAST GRONE ARRET TREAT
TREND: CLAST TORTE WRIED TREND
TRIAD: CLAST TORTE TAIRA TRIAD
TRIAL: CLAST TALEA BOING TRIAL
TRIBE: CLAST TORTE DRINK TRIPE TRIBE
TRICE: CLAST KIORE TRICE
TRICK: CLAST KIORE TRICK
TRIED: CLAST TORTE WRIED TRIED
TRIPE: CLAST TORTE DRINK TRIPE
TRITE: CLAST TORTE TRITE
TROLL: CLAST TOILE TROLL
TROOP: CLAST TORTE PRION TROOP
TROPE: CLAST TORTE DEVON TROKE TROPE
TROUT: CLAST PROIN GROUT TROUT
TROVE: CLAST TORTE DEVON TROVE
TRUCE: CLAST KIORE TERCE TRUCE
TRUCK: CLAST KIORE TRUCK
TRUER: CLAST TORTE WRIED TRYER TRUER
TRULY: CLAST TOILE TRULL TRULY
TRUMP: CLAST TORTE TRUMP
TRUNK: CLAST TORTE TRUMP TRUNK
TRUSS: CLAST IRONE TRUSS
TRUST: CLAST OURIE TAFIA TRUST
TRUTH: CLAST TORTE TRUTH
TRYST: CLAST OURIE TRYST
TUBAL: CLAST TALEA BOING TUBAL
TUBER: CLAST TORTE WRIED LANKY TUBER
TULIP: CLAST TOILE TULIP
TULLE: CLAST TOILE TUPLE TULLE
TUMOR: CLAST TORTE PRION TUMOR
TUNIC: CLAST KIORE TYPIC TUNIC
TURBO: CLAST TORTE THROW TURBO
TUTOR: CLAST TORTE TUTOR
TWANG: CLAST TRONE CHEKA TWANG
TWEAK: CLAST TORTE PANIM TWEAK
TWEED: CLAST TORTE PIEND TWEED
TWEET: CLAST PROIN MEWED TWEET
TWICE: CLAST KIORE TWICE
TWINE: CLAST TORTE EMEND THINE TWINE
TWIRL: CLAST TOILE THIRL TWIRL
TWIST: CLAST OURIE DWALM TWIST
TWIXT: CLAST PROIN TIMED TWIXT
TYING: CLAST TORTE GIMPY TYING
UDDER: CLAST RONDE DRIER EDGER UDDER
ULCER: CLAST BEFIT ULCER
ULTRA: CLAST ALTER ULTRA
UMBRA: CLAST MARAE AMOUR UMBRA
UNCLE: CLAST LOCIE UNCLE
UNCUT: CLAST HIRED UNCUT
UNDER: CLAST RONDE UNRED UNDER
UNDID: CLAST RONDE BUDGE UNDID
UNDUE: CLAST RONDE UNDEE UNDUE
UNFED: CLAST RONDE EIKED FLUBS UNFED
UNFIT: CLAST PROIN INWIT UNFIT
UNIFY: CLAST RONDE HUMPY UNIFY
UNION: CLAST RONDE GUIMP UNION
UNITE: CLAST TORTE WEENY UNITE
UNITY: CLAST TORTE FUNKY UNITY
UNLIT: CLAST GEOID UNLIT
UNMET: CLAST PROIN KEDGE UNMET
UNSET: CLAST ROUEN UNSET
UNTIE: CLAST TORTE HINKY UNTIE
UNTIL: CLAST TOILE FUNKY UNTIL
UNWED: CLAST RONDE EIKED FLUBS UNWED
UNZIP: CLAST RONDE HUMPY UNPIN UNZIP
UPPER: CLAST RONDE FERER BUMPH UPPER
UPSET: CLAST ROUEN UPSET
URBAN: CLAST MARAE BROND URBAN
URINE: CLAST RONDE BEING URINE
USAGE: CLAST PRONE VEHME USAGE
USHER: CLAST DONER SPIKY MUSER USHER
USING: CLAST DONER SKIPS USING
USUAL: CLAST SALLE MIROS USUAL
USURP: CLAST DONER RURPS USURP
UTILE: CLAST TOILE UTILE
UTTER: CLAST TORTE UTTER
VAGUE: CLAST MARAE FUNGI GAUJE VAGUE
VALET: CLAST VAGUE VALET
VALID: CLAST MARAE DILLY VALID
VALOR: CLAST MARAE FOLLY VALOR
VALUE: CLAST MARAE HILLY VALVE VALUE
VALVE: CLAST MARAE HILLY VALVE
VAPID: CLAST MARAE DINGY VAPID
VAPOR: CLAST MARAE POIND VAPOR
VAULT: CLAST VAGUE VAULT
VAUNT: CLAST GRONE THIRD JIVES VAUNT
VEGAN: CLAST MARAE BENDY PEKAN VEGAN
VENOM: CLAST RONDE VENOM
VENUE: CLAST RONDE BEWIG VENUE
VERGE: CLAST RONDE BEIGE MERGE VERGE
VERSE: CLAST IRONE BUMPH VERSE
VERSO: CLAST IRONE VERSO
VERVE: CLAST RONDE BEIGE VESPA VERVE
VICAR: CLAST NICER VICAR
VIDEO: CLAST RONDE BEFOG VIDEO
VIGIL: CLAST OILED GUNKY VIGIL
VIGOR: CLAST RONDE GROOM VIGOR
VILLA: CLAST MARAE VIOLA VILLA
VINYL: CLAST OILED GUNKY VINYL
VIOLA: CLAST MARAE VIOLA
VIPER: CLAST RONDE FERER BUMPH PAPAW VIPER
VIRAL: CLAST MARAE ROUGH PYRAL VIRAL
VIRUS: CLAST DONER RURPS GYRUS VIRUS
VISIT: CLAST ROUEN WISHT VISIT
VISOR: CLAST DONER SMOOR VISOR
VISTA: CLAST TERTS SOPHY FASTI VISTA
VITAL: CLAST TALEA DROLL VITAL
VIVID: CLAST RONDE PIGMY BIFID VIVID
VIXEN: CLAST RONDE HEMIN VIXEN
VOCAL: CLAST RACED FOLLY VOCAL
VODKA: CLAST MARAE POIND VODKA
VOGUE: CLAST RONDE GIMPY VOGUE
VOICE: CLAST HONER INCUS VOICE
VOILA: CLAST MARAE VIOLA VOILA
VOMIT: CLAST PROIN OOBIT VOMIT
VOTER: CLAST TORTE DONGS VOTER
VOUCH: CLAST HONER GUIMP VOUCH
VOWEL: CLAST OILED NERVY VOWEL
VYING: CLAST RONDE HUMPY NYING VYING
WACKY: CLAST NICER KHAYA JACKY WACKY
WAFER: CLAST MARAE PODGY WAKFS WAFER
WAGER: CLAST MARAE PODGY JEWEL WAGER
WAGON: CLAST MARAE DINGY GAZON WAGON
WAIST: CLAST WAIDE WAIST
WAIVE: CLAST MARAE FUNGI WAIDE WAIVE
WALTZ: CLAST TALEA WALTY WALTZ
WARTY: CLAST TORTE HAPPY WARTY
WASTE: CLAST TERTS WHAUP WASTE
WATCH: CLAST AROHA MINGY HOWBE WATCH
WATER: CLAST TORTE PAGED RHEME WATER
WAVER: CLAST MARAE PODGY WAKFS WAVER
WAXEN: CLAST MARAE WONKY WAXEN
WEARY: CLAST DRONE REAMY WEARY
WEAVE: CLAST DRONE WEIGH WEAVE
WEDGE: CLAST RONDE BEDIM SHEWN WEDGE
WEEDY: CLAST RONDE DAYCH WEEDY
WEIGH: CLAST RONDE WIMPY WEIGH
WEIRD: CLAST RONDE DRIER WEIRD
WELCH: CLAST LOCIE WEMBS WELCH
WELSH: CLAST NEUME LEISH WELSH
WENCH: CLAST HONER BAWKS WENCH
WHACK: CLAST BROKE WINDY WHACK
WHALE: CLAST LIVRE WHALE
WHARF: CLAST DRONE QUIFF WHARF
WHEAT: CLAST GRONE HEXED WHEAT
WHEEL: CLAST OILED BEVER WHEEL
WHELP: CLAST OILED MURLY KNELL WHELP
WHERE: CLAST RONDE BEIGE FRUMP WHERE
WHICH: CLAST HONER FICHU WHICH
WHIFF: CLAST RONDE PIGMY QUIFF WHIFF
WHILE: CLAST OILED VENGE WHILE
WHINE: CLAST RONDE WEENY WHINE
WHINY: CLAST RONDE HUMPY WHINY
WHIRL: CLAST OILED GRUMP WHIRL
WHISK: CLAST IRONE SYPHS WHISK
WHITE: CLAST TORTE WEENY WHITE
WHOLE: CLAST OILED BOURN WHOLE
WHOOP: CLAST RONDE BUMPH WHOOP
WHOSE: CLAST IRONE GOMBO WHOSE
WIDEN: CLAST RONDE EIKED DIZEN WIDEN
WIDER: CLAST RONDE DRIER HOWBE WIDER
WIDOW: CLAST RONDE HUMID WIDOW
WIDTH: CLAST TORTE FUNKY WIDTH
WIELD: CLAST OILED WOOFY WIELD
WIGHT: CLAST PROIN TIMED WAKFS WIGHT
WILLY: CLAST OILED FUGLY SHEWN WILLY
WIMPY: CLAST RONDE PIGMY WIMPY
WINCE: CLAST HONER MIXUP YINCE WINCE
WINCH: CLAST HONER FRUMP WINCH
WINDY: CLAST RONDE FLUKY WINDY
WISER: CLAST DONER SPIKY MORRA WISER
WISPY: CLAST DONER SIMPS WISPY
WITCH: CLAST KIORE HOWDY WITCH
WITTY: CLAST TORTE BINGY DOWDS WITTY
WOKEN: CLAST RONDE SHMEK WOKEN
WOMAN: CLAST MARAE GUQIN WOMAN
WOMEN: CLAST RONDE SHMEK NOMEN WOMEN
WOODY: CLAST RONDE DHOWS WOODY
WOOER: CLAST RONDE WHUMP WOKER WOOER
WOOLY: CLAST OILED GURLY NOHOW WOOLY
WOOZY: CLAST RONDE BUMPY KAGUS WOOFY WOOZY
WORDY: CLAST RONDE WORDY
WORLD: CLAST OILED WRONG WORLD
WORRY: CLAST RONDE GURRY WORRY
WORSE: CLAST IRONE DOUGH WORSE
WORST: CLAST OURIE WORST
WORTH: CLAST TORTE BANDY WORTH
WOULD: CLAST OILED WRONG WOULD
WOUND: CLAST RONDE WHUMP WOUND
WOVEN: CLAST RONDE SHMEK BOXEN WOVEN
WRACK: CLAST BROKE FAMED WRACK
WRATH: CLAST TRONE FURTH WRATH
WREAK: CLAST MARAE DEBUR FREAK WREAK
WRECK: CLAST HONER PRIDE WRECK
WREST: CLAST OURIE TEWED WREST
WRING: CLAST RONDE IBRIK WRING
WRIST: CLAST OURIE TWIGS WRIST
WRITE: CLAST TORTE WRITE
WRONG: CLAST RONDE GIPON WRONG
WROTE: CLAST TORTE WROTE
WRUNG: CLAST RONDE IBRIK WRUNG
WRYLY: CLAST OILED BURGH WRYLY
YACHT: CLAST TACET YACHT
YEARN: CLAST DRONE YEARN
YEAST: CLAST BROGH FEAST YEAST
YIELD: CLAST OILED WOOFY YIELD
YOUNG: CLAST RONDE GIMPY YOUNG
YOUTH: CLAST TORTE BUNJY YOUTH
ZEBRA: CLAST MARAE PINED ZEBRA
ZESTY: CLAST TORTE SINHS YUFTS ZESTY
ZONAL: CLAST MARAE YUPON NODAL ZONAL
Success: 2315
Fail: 0
Avg guess: 3.955
