ABACK: CROST LIANE HOKKU ABACK
ABASE: CROST MAILE SETUP ABASE
ABATE: CROST TATIE GLEBE ABATE
ABBEY: CROST LIANE MAWKY ABBEY
ABBOT: CROST GIBEL ABBOT
ABHOR: CROST RARED BULGY ABHOR
ABIDE: CROST LIANE ADMIX ABIDE
ABLED: CROST LIANE BEDEL ABLED
ABODE: CROST ELAND ABODE
ABORT: CROST BEPAT ABORT
ABOUT: CROST AWFUL ABOUT
ABOVE: CROST ELAND KOMBU ABOVE
ABUSE: CROST MAILE SETUP ABUSE
ABYSS: CROST MAILE SUNKS ABYSS
ACORN: CROST ACORN
ACRID: CROST AIRER ACRID
ACTOR: CROST ROTCH ACTOR
ACUTE: CROST TATIE ACUTE
ADAGE: CROST LIANE WEDGY ADAGE
ADAPT: CROST ALIEN NUKED ADAPT
ADEPT: CROST ALIEN ADEPT
ADMIN: CROST LIANE MANGA ANIMI ADMIN
ADMIT: CROST ALIEN ADMIT
ADOBE: CROST ELAND ABODE ADOBE
ADOPT: CROST AWFUL AYONT ADOPT
ADORE: CROST HEARD ADORE
ADORN: CROST HEARD ADORN
ADULT: CROST ALIEN ADULT
AFFIX: CROST LIANE PADMA GETUP AFFIX
AFIRE: CROST RARED BELAY DWAUM AFIRE
AFOOT: CROST AWFUL AFOOT
AFOUL: CROST ELAND VIOLA AFOUL
AFTER: CROST TATIE EXPEL AFTER
AGAIN: CROST LIANE AGAIN
AGAPE: CROST LIANE WEDGY TOPAZ AGAPE
AGATE: CROST TATIE GLEBE AGATE
AGENT: CROST ALIEN MIGHT AGENT
AGILE: CROST LIANE AXILE AGILE
AGING: CROST LIANE WAGGA AGING
AGLOW: CROST LADEN GLIAL AGLOW
AGONY: CROST ELAND AGONY
AGORA: CROST HEARD AINGA AGORA
AGREE: CROST RARED PEREA AGREE
AHEAD: CROST LIANE MAWKY BEDAD AHEAD
AIDER: CROST RARED ADULT AIDER
AISLE: CROST MAILE AISLE
ALARM: CROST RARED LINUM ALARM
ALBUM: CROST LIANE GAMAY ALBUM
ALERT: CROST EMAIL ALERT
ALGAE: CROST LIANE BADLY ALGAE
ALIBI: CROST LIANE HALAL ALIBI
ALIEN: CROST LIANE ALIEN
ALIGN: CROST LIANE AINGA ALIGN
ALIKE: CROST LIANE AXILE ALIKE
ALIVE: CROST LIANE AXILE ALIKE ALIVE
ALLAY: CROST LIANE GAMAY ALLAY
ALLEY: CROST LIANE BEDEL GALEA ALLEY
ALLOT: CROST GIBEL POULT ALLOT
ALLOW: CROST LADEN GLIAL ALLOY ALLOW
ALLOY: CROST LADEN GLIAL ALLOY
ALOFT: CROST AWFUL ALOFT
ALONE: CROST ELAND ALONE
ALONG: CROST ELAND ALONG
ALOOF: CROST ELAND ALOHA ALOOF
ALOUD: CROST ELAND ALOUD
ALPHA: CROST LIANE GAMAY ALPHA
ALTAR: CROST TATIE ANTRA ALTAR
ALTER: CROST TATIE EXPEL ALTER
AMASS: CROST MAILE SMASH AMASS
AMAZE: CROST LIANE WEDGY AMAZE
AMBER: CROST RARED LUNGI AMEER AMBER
AMBLE: CROST LIANE BADLY ABELE AMBLE
AMEND: CROST LIANE FEHME AMEND
AMISS: CROST MAILE AGISM AMISS
AMITY: CROST TATIE AGITA AMITY
AMONG: CROST ELAND AGONY AMONG
AMPLE: CROST LIANE BADLY AMPLE
AMPLY: CROST LIANE GAMAY AMPLY
AMUSE: CROST MAILE AMUSE
ANGEL: CROST LIANE PAVEN ANGEL
ANGER: CROST RARED LUNGI ANGER
ANGLE: CROST LIANE WHELK ANGLE
ANGRY: CROST RARED LINUM ANGRY
ANGST: CROST WEIGH ANGST
ANIME: CROST LIANE ANIME
ANKLE: CROST LIANE WHELK ANKLE
ANNEX: CROST LIANE MANED ANNEX
ANNOY: CROST LADEN GINNY ANNOY
ANNUL: CROST LIANE UNLAY ANNUL
ANODE: CROST ELAND ANODE
ANTIC: CROST TATIE ACTIN ANTIC
ANVIL: CROST LIANE AINGA ANVIL
AORTA: CROST TATER AORTA
APART: CROST EMAIL TUART APART
APHID: CROST LIANE PADMA APHID
APING: CROST LIANE WAGGA HOPAK APING
APNEA: CROST LIANE MANED ANNEX APNEA
APPLE: CROST LIANE BADLY AMPLE APPLE
APPLY: CROST LIANE GAMAY APPLY
APRON: CROST RARED LIMAN APRON
APTLY: CROST TATIE UNTAX APTLY
ARBOR: CROST ANGER NAMED ARBOR
ARDOR: CROST ANGER NAMED ARDOR
ARENA: CROST ABIDE PARRA ARENA
ARGUE: CROST ABIDE GUAVA ARGUE
ARISE: CROST BIGAE ARISE
ARMOR: CROST ANGER NAMED ARMOR
AROMA: CROST PIEND GAUMY AROMA
AROSE: CROST PEAGS AROSE
ARRAY: CROST ABIDE HYING ARRAY
ARROW: CROST ANGER ARROZ ARROW
ARSON: CROST ELAIN ARSON
ARTSY: CROST HULES ARTSY
ASCOT: CROST ESCOT ASCOT
ASHEN: CROST MAILE PENDS ASHEN
ASIDE: CROST MAILE ASIDE
ASKEW: CROST MAILE PENDS ESSAY ASKEW
ASSAY: CROST MAILE SPUNK HOWDY ASSAY
ASSET: CROST ALEPH ASSET
ATOLL: CROST PHYLA ATOLL
ATONE: CROST PHYLA ATOKE ATONE
ATTIC: CROST TATIE ATTIC
AUDIO: CROST LADEN SIDHA AUDIO
AUDIT: CROST ALIEN ADMIT AUDIT
AUGUR: CROST RARED LINUM AUGUR
AUNTY: CROST TATIE WHATA AUNTY
AVAIL: CROST LIANE AGUED AVAIL
AVERT: CROST EMAIL AVERT
AVIAN: CROST LIANE MANGA APIAN AVIAN
AVOID: CROST ELAND AXOID AVOID
AWAIT: CROST ALIEN ADMIT AWAIT
AWAKE: CROST LIANE WEDGY AWAKE
AWARD: CROST RARED AINGA AWARD
AWARE: CROST RARED BELAY DWAUM AWARE
AWASH: CROST MAILE SUNKS AWASH
AWFUL: CROST LIANE GAMAY UVULA AWFUL
AWOKE: CROST ELAND KOMBU AWOKE
AXIAL: CROST LIANE HALAL AXIAL
AXIOM: CROST LADEN PIGMY AXIOM
AXION: CROST LADEN BOGEY UNMIX AXION
AZURE: CROST RARED BELAY DWAUM AZURE
BACON: CROST LANCH MACON BACON
BADGE: CROST LIANE GUMBO BADGE
BADLY: CROST LIANE GAMAY DWELL BADLY
BAGEL: CROST LIANE BEDEL BABEL BAGEL
BAGGY: CROST LIANE BUMPY WODGE BAGGY
BAKER: CROST RARED GLYPH WAKFS JAMBS BAKER
BALER: CROST RARED GLYPH WELKE BALER
BALMY: CROST LIANE GAMAY ABAMP BALMY
BANAL: CROST LIANE UNLAY FINCH BANAL
BANJO: CROST LADEN GOMBO BANJO
BARGE: CROST RARED PYGAL BARGE
BARON: CROST RARED GLOOM BARON
BASAL: CROST MAILE BUNAS BASAL
BASIC: CROST KAIES SALIC BASIC
BASIL: CROST MAILE KILPS BASIL
BASIN: CROST MAILE SYNDS NASHI BASIN
BASIS: CROST MAILE SYNDS BASIS
BASTE: CROST TEATS UPBOW BASTE
BATCH: CROST TATIE PLONG WEMBS BATCH
BATHE: CROST TATIE WELKE BATHE
BATON: CROST LATEN BATON
BATTY: CROST TATIE BUNIA BATTY
BAWDY: CROST LIANE BUMPY WODGE BAWDY
BAYOU: CROST LADEN MAWKY YAHOO BAYOU
BEACH: CROST LIANE BEACH
BEADY: CROST LIANE DUMPY BEADY
BEARD: CROST RARED YERBA BEARD
BEAST: CROST WEIGH BLADY BEAST
BEECH: CROST LIANE BEAKY BEECH
BEEFY: CROST LIANE DUMKY BEZES BEEFY
BEFIT: CROST ALIEN BETED BEFIT
BEGAN: CROST LIANE MANED VEGAN BEGAN
BEGAT: CROST ALIEN PEAGE BEGAT
BEGET: CROST ALIEN MEWED BEGET
BEGIN: CROST LIANE UNPIN BEGIN
BEGUN: CROST LIANE WEEDY BEGUN
BEING: CROST LIANE HEMPY BEING
BELCH: CROST LIANE BEEFS BELCH
BELIE: CROST LIANE DULLY BELIE
BELLE: CROST LIANE BEGEM BELLE
BELLY: CROST LIANE DEBEL BELLY
BELOW: CROST LADEN BILLY BELOW
BENCH: CROST LIANE HOWDY KENCH BENCH
BERET: CROST EMAIL REWET BERET
BERRY: CROST RARED JUMPY BOKEH BERRY
BERTH: CROST TATIE BURGH BERTH
BESET: CROST ALEPH UNSET BESET
BETEL: CROST TATIE FULLY BETEL
BEVEL: CROST LIANE DEBEL BEVEL
BEZEL: CROST LIANE DEBEL BEVEL BEZEL
BIBLE: CROST LIANE MOBLE BIBLE
BICEP: CROST LIANE DICED BICEP
BIDDY: CROST LIANE PYGMY VIFDA DAWKS BIDDY
BIGOT: CROST GIBEL BIGOT
BILGE: CROST LIANE MOBLE BILGE
BILLY: CROST LIANE GHYLL BAWDS BILLY
BINGE: CROST LIANE GENOM HOWDY BINGE
BINGO: CROST LADEN GUIMP BOWRS BINGO
BIOME: CROST ELAND THYME BIOME
BIRCH: CROST AIRER BIRCH
BIRTH: CROST TATIE FUBSY BIRTH
BISON: CROST NALED KINGS BISON
BITTY: CROST TATIE NUKED WITTY BITTY
BLACK: CROST LIANE ABAMP BLACK
BLADE: CROST LIANE DEBUG BLADE
BLAME: CROST LIANE DEBUG BLAZE BLAME
BLAND: CROST LIANE DEBAG BLAND
BLANK: CROST LIANE DEBAG BLANK
BLARE: CROST RARED BELAY BLARE
BLAST: CROST WEIGH ALBUM BLAST
BLAZE: CROST LIANE DEBUG BLAZE
BLEAK: CROST LIANE BEDEL BLEAK
BLEAT: CROST ALIEN PLEAT BLEAT
BLEED: CROST LIANE DEBEL BLEED
BLEEP: CROST LIANE DEBEL BLEEP
BLEND: CROST LIANE BLEND
BLESS: CROST MAILE FLESH BLESS
BLIMP: CROST LIANE FULLY BLIMP
BLIND: CROST LIANE PUDGY BLIND
BLINK: CROST LIANE PUDGY BLINI BLINK
BLISS: CROST MAILE SMOGS BLISS
BLITZ: CROST TATIE FILMY BLITZ
BLOAT: CROST AWFUL GETUP BLOAT
BLOCK: CROST PEKAN FLOCK BLOCK
BLOKE: CROST ELAND BEVVY BLOKE
BLOND: CROST ELAND BLOND
BLOOD: CROST ELAND FLOOD BLOOD
BLOOM: CROST ELAND BUMPY BLOOM
BLOWN: CROST ELAND FLOWN BLOWN
BLUER: CROST RARED PLING FLEER BLUER
BLUFF: CROST LIANE PUDGY FLUFF BLUFF
BLUNT: CROST ALIEN BLUNT
BLURB: CROST RARED KNURL BLURB
BLURT: CROST EMAIL BLURT
BLUSH: CROST MAILE SPIFF BLUSH
BOARD: CROST RARED BOARD
BOAST: CROST HADJI OBELI BOAST
BOBBY: CROST LADEN BUMPY BOBBY
BONEY: CROST LADEN BUMPY BONEY
BONGO: CROST LADEN GUIMP BONGO
BONUS: CROST NALED KINGS MONOS BONUS
BOOBY: CROST ELAND BUMPH FLICK GAZED BOOBY
BOOST: CROST HYING BOOST
BOOTH: CROST PHYLA TOOTH BOOTH
BOOTY: CROST PHYLA BIFFO BOOTY
BOOZE: CROST ELAND THYME BOOZE
BOOZY: CROST ELAND BUMPH FLICK GAZED BOOZY
BORAX: CROST RARED LIMAN HEXYL BORAX
BORNE: CROST RARED GENOM BORNE
BOSOM: CROST NALED BUMPY BOSOM
BOSSY: CROST ULYIE SPIMS BOSSY
BOTCH: CROST POTIN BAUKS BOTCH
BOUGH: CROST LADEN BUMPY BOUGH
BOULE: CROST LADEN BILLY BOGLE BOULE
BOUND: CROST LADEN GUNKY WHOMP BOUND
BOWEL: CROST LADEN VUGHY BOWEL
BOXER: CROST RARED WOMYN GULPH KOKER BOXER
BRACE: CROST ABIDE BRACE
BRAID: CROST ABIDE BRAID
BRAIN: CROST ABIDE ULNAD BRAIN
BRAKE: CROST ABIDE MAVEN BRAKE
BRAND: CROST ABIDE BRAND
BRASH: CROST BIGAE BRASS BRASH
BRASS: CROST BIGAE BRASS
BRAVE: CROST ABIDE MAVEN BRAVE
BRAVO: CROST ANGER ORVAL BRAVO
BRAWL: CROST ABIDE WONKY BRAWL
BRAWN: CROST ABIDE WONKY BRAWN
BREAD: CROST ABIDE BREAD
BREAK: CROST ABIDE BREAK
BREED: CROST ABIDE BREED
BRIAR: CROST ABIDE BRIAR
BRIBE: CROST ABIDE SENZA BRIBE
BRICK: CROST ABIDE BRICK
BRIDE: CROST ABIDE BRIDE
BRIEF: CROST ABIDE BRIER BRIEF
BRINE: CROST ABIDE SENZA BRINE
BRING: CROST ABIDE MILKY BRING
BRINK: CROST ABIDE MILKY BRINK
BRINY: CROST ABIDE MILKY BRINY
BRISK: CROST BIGAE BRISK
BROAD: CROST PIEND BROAD
BROIL: CROST PIEND IROKO BROIL
BROKE: CROST PIEND KBARS BROKE
BROOD: CROST PIEND BROAD BROOD
BROOK: CROST PIEND GAUMY BROOK
BROOM: CROST PIEND GAUMY VROOM BROOM
BROTH: CROST TAPEN BIFFO BROTH
BROWN: CROST PIEND GOWFS BROWN
BRUNT: CROST APING STUDY BRUNT
BRUSH: CROST BIGAE BRUSH
BRUTE: CROST PIETA BRUTE
BUDDY: CROST LIANE PYGMY BIFID BUDDY
BUDGE: CROST LIANE DUMPY BIFFO BUDGE
BUGGY: CROST LIANE PYGMY VUGHY FUGGY BUGGY
BUGLE: CROST LIANE BEGEM BUGLE
BUILD: CROST LIANE FULLY BUILD
BUILT: CROST ALIEN DEBUG BUILT
BULGE: CROST LIANE BEGEM BULGE
BULKY: CROST LIANE PUDGY BUHLS BULKY
BULLY: CROST LIANE PUDGY BUHLS BULLY
BUNCH: CROST LIANE DUMPS HUNCH BUNCH
BUNNY: CROST LIANE DEBUG BUNNY
BURLY: CROST RARED LUMBI BURLY
BURNT: CROST EMAIL TURNT BURNT
BURST: CROST WAIVE CHADO BURST
BUSED: CROST MAILE PENED SEIFS BUSED
BUSHY: CROST MAILE DUNKS GOBBY BUSHY
BUTCH: CROST TATIE DUMBO BUTCH
BUTTE: CROST TATIE BUTTE
BUXOM: CROST LADEN BUMPY BUXOM
BUYER: CROST RARED PLING BEEFY BUYER
BYLAW: CROST LIANE GAMAY BYLAW
CABAL: CROST MAILE CANAL CABAL
CABBY: CROST MAILE BANDY CABBY
CABIN: CROST MAILE CANID CABIN
CABLE: CROST MAILE CAPLE CABLE
CACAO: CROST PANEL CABOB CACAO
CACHE: CROST MAILE CADEE CACHE
CACTI: CROST ULYIE CACTI
CADDY: CROST MAILE BANDY CADDY
CADET: CROST PANEL CADET
CAGEY: CROST MAILE DWANG CAGEY
CAIRN: CROST DARRE CAURI CAIRN
CAMEL: CROST MAILE CAMEL
CAMEO: CROST PANEL CAMEO
CANAL: CROST MAILE CANAL
CANDY: CROST MAILE BANDY CANDY
CANNY: CROST MAILE BANDY CANNY
CANOE: CROST PANEL CANOE
CANON: CROST PANEL CANON
CAPER: CROST DARRE PRANG CAPER
CAPUT: CROST PANEL CAPUT
CARAT: CROST EARLY CARAT
CARGO: CROST YERBA MELON CARGO
CAROL: CROST YERBA MELON CAROL
CARRY: CROST DARRE CARRY
CARVE: CROST DARRE CARLE CARVE
CASTE: CROST LIANE CASTE
CATCH: CROST ULYIE CWTCH CATCH
CATER: CROST PIETA CATER
CATTY: CROST ULYIE CATTY
CAULK: CROST MAILE CAULD CAULK
CAUSE: CROST HAEMS CAUSE
CAVIL: CROST MAILE FEDEX CAVIL
CEASE: CROST HAEMS CEASE
CEDAR: CROST DARRE CEDAR
CELLO: CROST PANEL COBLE CELLO
CHAFE: CROST MAILE PERCE CHAFE
CHAFF: CROST MAILE NAKFA CHAFF
CHAIN: CROST MAILE CHAIN
CHAIR: CROST DARRE CYMAR CHAIR
CHALK: CROST MAILE CHALK
CHAMP: CROST MAILE CHAMP
CHANT: CROST PANEL CHANT
CHAOS: CROST MALES CODAS CHAOS
CHARD: CROST DARRE CHARD
CHARM: CROST DARRE MILKY CHARM
CHART: CROST EARLY CHART
CHASE: CROST HAEMS CHASE
CHASM: CROST HAEMS CHASM
CHEAP: CROST MAILE CHEAP
CHEAT: CROST PANEL CHEAT
CHECK: CROST MAILE EWKED CHECK
CHEEK: CROST MAILE EWKED CHEEK
CHEER: CROST DARRE CYBER CHEER
CHESS: CROST HAEMS CHESS
CHEST: CROST CANST CHEST
CHICK: CROST MAILE PUNKY CHICK
CHIDE: CROST MAILE NUKED CHIDE
CHIEF: CROST MAILE CHIEF
CHILD: CROST MAILE DILLS CHILD
CHILI: CROST MAILE DILLS CHILI
CHILL: CROST MAILE DILLS CHILL
CHIME: CROST MAILE CHIME
CHINA: CROST MAILE CNIDA CHINA
CHIRP: CROST DARRE PIKUL CHIRP
CHOCK: CROST WHELK CHOOK CHOCK
CHOIR: CROST CHORE CHOIR
CHOKE: CROST WHELK CHOKE
CHORD: CROST CHORE CHORD
CHORE: CROST CHORE
CHOSE: CROST CHOSE
CHUCK: CROST MAILE NUKED CHUCK
CHUMP: CROST MAILE CHUMP
CHUNK: CROST MAILE NUKED CHUNK
CHURN: CROST DARRE PIKUL CHURN
CHUTE: CROST ULYIE CHUTE
CIDER: CROST DARRE TINTY CIDER
CIGAR: CROST DARRE CYMAR CIGAR
CINCH: CROST MAILE VINIC CINCH
CIRCA: CROST DARRE CIRCA
CIVIC: CROST MAILE VINIC CIVIC
CIVIL: CROST MAILE CYLIX CIVIL
CLACK: CROST MAILE CLANK CLACK
CLAIM: CROST MAILE CLAIM
CLAMP: CROST MAILE CLAMP
CLANG: CROST MAILE CLANK CLANG
CLANK: CROST MAILE CLANK
CLASH: CROST HAEMS CLASH
CLASP: CROST HAEMS CLASP
CLASS: CROST HAEMS CLASS
CLEAN: CROST MAILE CECAL CLEAN
CLEAR: CROST DARRE CLEAR
CLEAT: CROST PANEL CLEAT
CLEFT: CROST PANEL CLEFT
CLERK: CROST DARRE CLERK
CLICK: CROST MAILE CLINK CLICK
CLIFF: CROST MAILE CLINK CLIFF
CLIMB: CROST MAILE CLIMB
CLING: CROST MAILE CLINK CLING
CLINK: CROST MAILE CLINK
CLOAK: CROST WHELK FARCE CLOAK
CLOCK: CROST WHELK FARCE CLOCK
CLONE: CROST WHELK ZINGY CLONE
CLOSE: CROST CHOSE CLOSE
CLOTH: CROST CHOTA CLOTH
CLOUD: CROST WHELK TRUMP CLOUD
CLOUT: CROST HOKKU CLOUT
CLOVE: CROST WHELK ZINGY CLOVE
CLOWN: CROST WHELK CLOWN
CLUCK: CROST MAILE CLUNG CLUCK
CLUED: CROST MAILE PUKED CLUED
CLUMP: CROST MAILE CLUMP
CLUNG: CROST MAILE CLUNG
COACH: CROST PANEL BIMAH COACH
COAST: CROST COAST
COBRA: CROST YERBA COBRA
COCOA: CROST PANEL BIMAH COADY COCOA
COLON: CROST PANEL COLON
COLOR: CROST YERBA CHIRO COLOR
COMET: CROST PAVEN COMET
COMFY: CROST PANEL KIMBO COMFY
COMIC: CROST PANEL KIMBO COMIX COMIC
COMMA: CROST PANEL BIMAH COMMA
CONCH: CROST PANEL HYING CONCH
CONDO: CROST PANEL HYING CONVO CONDO
CONIC: CROST PANEL HYING CONIC
COPSE: CROST NUKED COPSE
CORAL: CROST YERBA MELON CORAL
CORER: CROST YERBA CORER
CORNY: CROST YERBA CORKY CORNY
COUCH: CROST PANEL KIMBO COUGH COUCH
COUGH: CROST PANEL KIMBO COUGH
COULD: CROST PANEL FILLY COULD
COUNT: CROST PAVEN COUNT
COUPE: CROST PANEL COUPE
COURT: CROST COURT
COVEN: CROST PANEL HIVED COVEN
COVER: CROST YERBA DUMPS COWER COVER
COVET: CROST PAVEN COVET
COVEY: CROST PANEL VODDY COVEY
COWER: CROST YERBA DUMPS COWER
COYLY: CROST PANEL FILLY COYLY
CRACK: CROST PILAE CRANK CRACK
CRAFT: CROST PIETA CRAFT
CRAMP: CROST PILAE CRAMP
CRANE: CROST PILAE MAVEN CRANE
CRANK: CROST PILAE CRANK
CRASH: CROST HULES CRASH
CRASS: CROST HULES CRASS
CRATE: CROST CRWTH CRATE
CRAVE: CROST PILAE MAVEN CRAVE
CRAWL: CROST PILAE CRAWL
CRAZE: CROST PILAE MAVEN KOORI CRAZE
CRAZY: CROST PILAE CRANK CRAZY
CREAK: CROST PILAE CREAK
CREAM: CROST PILAE CREAK CREAM
CREDO: CROST CRUDO CREDO
CREED: CROST PILAE CREED
CREEK: CROST PILAE CREED CREEK
CREEP: CROST PILAE CREPY CREEP
CREME: CROST PILAE DUMPS CREME
CREPE: CROST PILAE CREPE
CREPT: CROST PIETA CREPT
CRESS: CROST HULES CRESS
CREST: CROST CREST
CRICK: CROST PILAE CRICK
CRIED: CROST PILAE CRIED
CRIER: CROST PILAE CRIED CRIER
CRIME: CROST PILAE CRINE CRIME
CRIMP: CROST PILAE CRIMP
CRISP: CROST HULES CRISP
CROAK: CROST EIKON CROCK CROAK
CROCK: CROST EIKON CROCK
CRONE: CROST EIKON CRONE
CRONY: CROST EIKON CRONY
CROOK: CROST EIKON CROOK
CROSS: CROST CROSS
CROUP: CROST EIKON NUKED CROUP
CROWD: CROST EIKON NUKED CROWD
CROWN: CROST EIKON CROWN
CRUDE: CROST PILAE DUMPS CRUDE
CRUEL: CROST PILAE CRUEL
CRUMB: CROST PILAE NUKED CRUMB
CRUMP: CROST PILAE CRUMP
CRUSH: CROST HULES CRUSH
CRUST: CROST CREST CRUST
CRYPT: CROST PIETA CRYPT
CUBIC: CROST MAILE VINIC CUBIC
CUMIN: CROST MAILE CUMIN
CURIO: CROST YERBA AMNIO CURIO
CURLY: CROST DARRE LAVVY CURLY
CURRY: CROST DARRE CURRY
CURSE: CROST CURSE
CURVE: CROST DARRE DEVON CURVE
CURVY: CROST DARRE LAVVY CURVY
CUTIE: CROST ULYIE CUTIE
CYBER: CROST DARRE CYBER
CYCLE: CROST MAILE CYCLE
CYNIC: CROST MAILE VINIC CYNIC
DADDY: CROST LIANE BUMPY FADGE WADDY DADDY
DAILY: CROST LIANE HALAL GAILY DAILY
DAIRY: CROST RARED DAMAR DAIRY
DAISY: CROST MAILE PAISA DAISY
DALLY: CROST LIANE GAMAY DWELL DALLY
DANCE: CROST LIANE HYPED DANCE
DANDY: CROST LIANE PADMA BOUGH KANDY DANDY
DATUM: CROST TATIE HALFA DATUM
DAUNT: CROST ALIEN THUDS DAUNT
DEALT: CROST ALIEN EXALT DEALT
DEATH: CROST TATIE HEMPY NUKED DEATH
DEBAR: CROST RARED GYNIE DEBAR
DEBIT: CROST ALIEN BETED DEBIT
DEBUG: CROST LIANE DUMKY DEBUG
DEBUT: CROST ALIEN DUETT DEBUT
DECAL: CROST LIANE FECAL DECAL
DECAY: CROST LIANE AMPED DECAF DECAY
DECOR: CROST HIRER DECOR
DECOY: CROST LANCH DOGEY DECOY
DECRY: CROST AIRER REECH DECRY
DEFER: CROST RARED ENDUE DEFER
DEIGN: CROST LIANE UNPIN FEIGN DEIGN
DEITY: CROST TATIE MEITH DEITY
DELAY: CROST LIANE BEDEL DELAY
DELTA: CROST TATIE HEMPY DELTA
DELVE: CROST LIANE BEGEM HELVE DELVE
DEMON: CROST LADEN DEVON DEMON
DEMUR: CROST RARED DEBUR DEMUR
DENIM: CROST LIANE UNPIN DENIM
DENSE: CROST MAILE NEEDY DENSE
DEPOT: CROST GIBEL DEPOT
DEPTH: CROST TATIE FLUKY DEPTH
DERBY: CROST RARED DUNGY DERBY
DETER: CROST TATIE LEMED DETER
DETOX: CROST LATEN MOTTE DETOX
DEUCE: CROST LIANE PEECE DEUCE
DEVIL: CROST LIANE KEVEL DEVIL
DIARY: CROST RARED DIARY
DICEY: CROST LIANE DICED DICEY
DIGIT: CROST ALIEN BIFID DIXIT DIGIT
DILLY: CROST LIANE GHYLL BAWDS DILLY
DIMLY: CROST LIANE GHYLL DIMLY
DINER: CROST RARED ENDUE DINER
DINGO: CROST LADEN GUNKY DINGO
DINGY: CROST LIANE KINDY DINGY
DIODE: CROST ELAND DIODE
DIRGE: CROST RARED DUNGY DIRGE
DIRTY: CROST TATIE FUBSY DIRTY
DISCO: CROST SOKEN PIMAS DISCO
DITCH: CROST TATIE WODGE DITCH
DITTO: CROST LATEN HUMPY DITTO
DITTY: CROST TATIE NUKED DITTY
DIVER: CROST RARED ENDUE MILKY DIVER
DIZZY: CROST LIANE PYGMY VIFDA DIZZY
DODGE: CROST LADEN DUMPS DODGE
DODGY: CROST LADEN VODDY DODGY
DOGMA: CROST LADEN DOUMA DOGMA
DOING: CROST LADEN GUNKY DOING
DOLLY: CROST LADEN GOYIM DOWLY DOLLY
DONOR: CROST RARED DONOR
DONUT: CROST GIBEL FOUNT DONUT
DOPEY: CROST LADEN HUMPY DOPEY
DOUBT: CROST GIBEL BOWAT DOUBT
DOUGH: CROST LADEN HIMBO VOZHD DOUGH
DOWDY: CROST LADEN HIMBO DOGGY DOWDY
DOWEL: CROST LADEN DOWPS DOWEL
DOWNY: CROST LADEN GUNKY DOWNY
DOWRY: CROST RARED DONOR DOWRY
DOZEN: CROST LADEN LAVVY DOZEN
DRAFT: CROST APING KRAFT DRAFT
DRAIN: CROST ABIDE DRAIL DRAIN
DRAKE: CROST ABIDE KEMPS DRAKE
DRAMA: CROST ABIDE ALAND DRAMA
DRANK: CROST ABIDE ALAND DRANK
DRAPE: CROST ABIDE KEMPS DRAPE
DRAWL: CROST ABIDE ALAND DRAWL
DRAWN: CROST ABIDE ALAND DRAWN
DREAD: CROST ABIDE NAMED DREAD
DREAM: CROST ABIDE NAMED DREAM
DRESS: CROST BIGAE PRESS DRESS
DRIED: CROST ABIDE DOWDS DRIED
DRIER: CROST ABIDE DOWDS DRIER
DRIFT: CROST APING DRIFT
DRILL: CROST ABIDE DRILY DRILL
DRINK: CROST ABIDE DRILY DRINK
DRIVE: CROST ABIDE DRIVE
DROIT: CROST TANGI DROIT
DROLL: CROST PIEND BLOOK DROLL
DRONE: CROST PIEND DRONE
DROOL: CROST PIEND BLOOK DROOL
DROOP: CROST PIEND DROOP
DROSS: CROST PEAGS DROSS
DROVE: CROST PIEND KEVEL DROVE
DROWN: CROST PIEND DROWN
DRUID: CROST ABIDE DRUID
DRUNK: CROST ABIDE DRUXY DRUNK
DRYER: CROST ABIDE EDGED DRYER
DRYLY: CROST ABIDE DRUXY DRYLY
DUCHY: CROST LIANE YIKED DUCHY
DULLY: CROST LIANE PUDGY DULLY
DUMMY: CROST LIANE PYGMY MUMMY DUMMY
DUMPY: CROST LIANE PYGMY DHOBI DUMPY
DUNCE: CROST LIANE DEPTH DUNCE
DUSKY: CROST MAILE DUNKS DUSKY
DUSTY: CROST TEATS BLIMY GURDY DUSTY
DUTCH: CROST TATIE DUMBO DUTCH
DUVET: CROST ALIEN MEWED DUVET
DWARF: CROST RARED DIARY DWARF
DWELL: CROST LIANE DEBEL DWELL
DWELT: CROST ALIEN VELDT DWELT
DYING: CROST LIANE DANNY DYING
EAGER: CROST RARED GLYPH JEWEL EAGER
EAGLE: CROST LIANE BADLY MAPLE EAGLE
EARLY: CROST RARED PYGAL EARLY
EARTH: CROST TATIE EARTH
EASEL: CROST MAILE LUSKS EASEL
EATEN: CROST TATIE DELPH MATEY EATEN
EATER: CROST TATIE LEMED EATER
EBONY: CROST ELAND EBONY
ECLAT: CROST HALID ECLAT
EDICT: CROST HALID EDICT
EDIFY: CROST LIANE MEWED EDIFY
EERIE: CROST RARED LINGY EERIE
EGRET: CROST EMAIL EXERT EGRET
EIGHT: CROST ALIEN BETED EIGHT
EJECT: CROST HALID EJECT
EKING: CROST LIANE HEMPY EXING EKING
ELATE: CROST TATIE GLEBE ELATE
ELBOW: CROST LADEN BILLY ELBOW
ELDER: CROST RARED ENDUE EIDER ELDER
ELECT: CROST HALID ELECT
ELEGY: CROST LIANE DEBEL ELEGY
ELFIN: CROST LIANE ELDIN ELFIN
ELIDE: CROST LIANE DULLY ELIDE
ELITE: CROST TATIE BUHLS ELITE
ELOPE: CROST ELAND ELOGY ELOPE
ELUDE: CROST LIANE BEGEM ELUDE
EMAIL: CROST LIANE EMAIL
EMBED: CROST LIANE DUMKY MEWED EMBED
EMBER: CROST RARED PLING BEEFY EMBER
EMCEE: CROST LIANE PEECE EMCEE
EMPTY: CROST TATIE FLUKY GENTY EMPTY
ENACT: CROST HALID PRANG ENACT
ENDOW: CROST LADEN ENDOW
ENEMA: CROST LIANE MANED ENEMA
ENEMY: CROST LIANE WEEDY ENEMY
ENJOY: CROST LADEN PENNI ENJOY
ENNUI: CROST LIANE UNPIN ENNUI
ENSUE: CROST MAILE UNDER ENSUE
ENTER: CROST TATIE LEMED ENTER
ENTRY: CROST TATIE LEMED ENTRY
ENVOY: CROST LADEN PENNI ENJOY ENVOY
EPOCH: CROST PEKAN EPOCH
EPOXY: CROST ELAND THYME EPOXY
EQUAL: CROST LIANE BEDEL WHEAL EQUAL
EQUIP: CROST LIANE MEWED EQUIP
ERASE: CROST BIGAE GETUP ERASE
ERECT: CROST TUBED ERECT
ERODE: CROST PIEND KEVEL ERODE
ERROR: CROST ANGER ERROR
ERUPT: CROST APING ERUPT
ESSAY: CROST MAILE PENDS ESSAY
ESTER: CROST TERAI SEGUE ESTER
ETHER: CROST TATIE BURGH ETHER
ETHIC: CROST TATIE ETHIC
ETHOS: CROST LATTE MONGS ETHOS
ETUDE: CROST TATIE FLUNK ETUDE
EVADE: CROST LIANE WEDGY EVADE
EVENT: CROST ALIEN MEYNT EVENT
EVERY: CROST RARED VENUE EVERY
EVICT: CROST HALID TINCT EVICT
EVOKE: CROST ELAND THYME EVOKE
EXACT: CROST HALID PRANG EXACT
EXALT: CROST ALIEN EXALT
EXCEL: CROST LIANE BEEFS EXCEL
EXERT: CROST EMAIL EXERT
EXILE: CROST LIANE DULLY WHILE EXILE
EXIST: CROST WEIGH EXIST
EXPEL: CROST LIANE DEBEL EXPEL
EXTOL: CROST LATEN KETOL EXTOL
EXTRA: CROST TATIE EXPEL EXTRA
EXULT: CROST ALIEN VELDT EXULT
EYING: CROST LIANE HEMPY EYING
FABLE: CROST LIANE BADLY HYING FABLE
FACET: CROST HALID TACET FACET
FAINT: CROST ALIEN TOPHE DAINT FAINT
FAIRY: CROST RARED KYLIN CHUFF FAIRY
FAITH: CROST TATIE HALFS FAITH
FALSE: CROST MAILE SELAH FALSE
FANCY: CROST LIANE HUDNA NANCY FANCY
FANNY: CROST LIANE BAWDY FUJIS FANNY
FARCE: CROST AIRER FARCE
FATAL: CROST TATIE HALFA FATAL
FATTY: CROST TATIE BUNIA FATTY
FAULT: CROST ALIEN FAUGH FAULT
FAUNA: CROST LIANE BAWDY NANNA FAUNA
FAVOR: CROST RARED VINYL FAVOR
FEAST: CROST WEIGH BLADY FEAST
FECAL: CROST LIANE FECAL
FEIGN: CROST LIANE UNPIN FEIGN
FELLA: CROST LIANE BEDEL PELAU FELLA
FELON: CROST LADEN FLUMP FELON
FEMME: CROST LIANE DUMPY FEMME
FEMUR: CROST RARED VENUE FEMUR
FENCE: CROST LIANE DEPTH FENCE
FERAL: CROST RARED BUNIA FERAL
FERRY: CROST RARED JUMPY BOKEH VERRY FERRY
FETAL: CROST TATIE FLUMP FETAL
FETCH: CROST TATIE FLICK FETCH
FETID: CROST TATIE FETID
FETUS: CROST TEATS HYMEN FETUS
FEVER: CROST RARED PLING BEEFY FEVER
FEWER: CROST RARED PLING BEEFY FEVER FEWER
FIBER: CROST RARED PLING BUMFS FIBER
FIBRE: CROST RARED VENUE FIBRE
FICUS: CROST KAIES FISCS FICUS
FIELD: CROST LIANE GYBED FIELD
FIEND: CROST LIANE PIEND FIEND
FIERY: CROST RARED VENUE FIERY
FIFTH: CROST TATIE FILMY FIFTH
FIFTY: CROST TATIE FILMY FIFTY
FIGHT: CROST ALIEN BIFID FIGHT
FILER: CROST RARED PLING FILKS FILER
FILET: CROST ALIEN GILET FILET
FILLY: CROST LIANE GHYLL BAWDS FILLY
FILMY: CROST LIANE GHYLL MILKY FILMY
FILTH: CROST TATIE FILMY FILTH
FINAL: CROST LIANE VIFDA FINAL
FINCH: CROST LIANE HAFIZ FINCH
FINER: CROST RARED PLING FINNY FINER
FIRST: CROST WAIVE FIRST
FISHY: CROST MAILE DUNKS WISPY FISHY
FIXER: CROST RARED PLING BUMFS ENFIX FIXER
FIZZY: CROST LIANE PYGMY VIFDA FIZZY
FJORD: CROST HEARD BIFFO FJORD
FLACK: CROST LIANE ABAMP FLACK
FLAIL: CROST LIANE AGUED FLAIL
FLAIR: CROST RARED LINUM FLAIR
FLAKE: CROST LIANE DEBUG WHELM FLAKE
FLAKY: CROST LIANE DUMPY WAKFS FLAKY
FLAME: CROST LIANE DEBUG WHELM FLAME
FLANK: CROST LIANE DEBAG FLANK
FLARE: CROST RARED BELAY GLARE FLARE
FLASH: CROST MAILE SPEKS FLASH
FLASK: CROST MAILE SPEKS FLASK
FLECK: CROST LIANE BEEFS FLECK
FLEET: CROST ALIEN GLEET FLEET
FLESH: CROST MAILE FLESH
FLICK: CROST LIANE HUFFY FLICK
FLIER: CROST RARED PLING FLIER
FLING: CROST LIANE PUDGY BLING FLING
FLINT: CROST ALIEN FLINT
FLIRT: CROST EMAIL FLIRT
FLOAT: CROST AWFUL FLOAT
FLOCK: CROST PEKAN FLOCK
FLOOD: CROST ELAND FLOOD
FLOOR: CROST HEARD FLUMP FLOOR
FLORA: CROST HEARD AINGA FLORA
FLOSS: CROST WHELK GLOSS FLOSS
FLOUR: CROST HEARD FLUMP FLOUR
FLOUT: CROST AWFUL FLOUT
FLOWN: CROST ELAND FLOWN
FLUFF: CROST LIANE PUDGY FLUFF
FLUID: CROST LIANE FULLY FLUID
FLUKE: CROST LIANE BEGEM PHYLE FLUKE
FLUME: CROST LIANE BEGEM PLUME FLUME
FLUNG: CROST LIANE BEFOG FLUNG
FLUNK: CROST LIANE BEFOG FLUNK
FLUSH: CROST MAILE SPIFF FLUSH
FLUTE: CROST TATIE FLUNK FLUTE
FLYER: CROST RARED PLING FLEER FLYER
FOAMY: CROST LADEN PIGMY FOAMY
FOCAL: CROST LANCH VOCAL FOCAL
FOCUS: CROST SOKEN HAULD FOCUS
FOGGY: CROST LADEN BUMPY FOGGY
FOIST: CROST HADJI ZOISM FOIST
FOLIO: CROST LADEN FILLY FOLIO
FOLLY: CROST LADEN FILLY FOLLY
FORAY: CROST RARED LIMAN HEXYL FORAY
FORCE: CROST HIRER FORCE
FORGE: CROST RARED GENOM PORGE FORGE
FORGO: CROST RARED BUNGY FORGO
FORTE: CROST TATER RONTE FORTE
FORTH: CROST TATER FORBY FORTH
FORTY: CROST TATER FORBY FORTY
FORUM: CROST RARED BUNGY JORUM FORUM
FOUND: CROST LADEN GUNKY WHOMP BOUND FOUND
FOYER: CROST RARED WOMYN FOYER
FRAIL: CROST ABIDE LOGIN FRAIL
FRAME: CROST ABIDE PYGMY FRAME
FRANK: CROST ABIDE PAGAN KRANZ FRANK
FRAUD: CROST ABIDE ALAND FRAUD
FREAK: CROST ABIDE FREAK
FREED: CROST ABIDE EDGED PREED FREED
FREER: CROST ABIDE PUNKY FREER
FRESH: CROST BIGAE PRESS FRESH
FRIAR: CROST ABIDE PRIAL FRIAR
FRIED: CROST ABIDE DOWDS PRIED FRIED
FRILL: CROST ABIDE FLUMP FRILL
FRISK: CROST BIGAE PRISM FRISK
FRITZ: CROST PIETA BAGHS FRITZ
FROCK: CROST FROCK
FROND: CROST PIEND BROND FROND
FRONT: CROST TANGI FRONT
FROST: CROST FROST
FROTH: CROST TAPEN BIFFO FROTH
FROWN: CROST PIEND GOWFS FROWN
FROZE: CROST PIEND KBARS FROZE
FRUIT: CROST APING BRUIT FRUIT
FUDGE: CROST LIANE DUMPY BIFFO FUDGE
FUGUE: CROST LIANE DUMPY FUZEE FUGUE
FULLY: CROST LIANE PUDGY BUHLS FULLY
FUNGI: CROST LIANE CUPID FUNGI
FUNKY: CROST LIANE BUNDH PORGY JUNKY FUNKY
FUNNY: CROST LIANE DEBUG POUFS FUNNY
FUROR: CROST RARED SULFO FUROR
FURRY: CROST RARED BLIMY HYING FURRY
FUSSY: CROST MAILE SYPHS WODGE FUSSY
FUZZY: CROST LIANE PYGMY BIFID FUZZY
GAFFE: CROST LIANE GUMBO GADGE GAFFE
GAILY: CROST LIANE HALAL GAILY
GAMER: CROST RARED GLYPH ZOISM GAMER
GAMMA: CROST LIANE BUMPY MAMMA GAMMA
GAMUT: CROST ALIEN MAKAR GAMUT
GASSY: CROST MAILE GASSY
GAUDY: CROST LIANE BUMPY GAUZY GAUDY
GAUGE: CROST LIANE GUMBO AJUGA GAUGE
GAUNT: CROST ALIEN THUDS GALVO GAUNT
GAUZE: CROST LIANE GUMBO AJUGA GAUZE
GAVEL: CROST LIANE BEDEL GALVO GAVEL
GAWKY: CROST LIANE BUMPY FADGE GAWKY
GAYER: CROST RARED GLYPH GAYER
GAYLY: CROST LIANE GAMAY GAYLY
GAZER: CROST RARED GLYPH ZOISM GAZER
GECKO: CROST LANCH DOGEY GECKO
GEEKY: CROST LIANE DUMKY GEEKY
GEESE: CROST MAILE NEEDY FEESE GEESE
GENIE: CROST LIANE UNIFY GENIE
GENRE: CROST RARED VENUE GENRE
GHOST: CROST HYING GHOST
GHOUL: CROST ELAND OBOLI GHOUL
GIANT: CROST ALIEN GIANT
GIDDY: CROST LIANE PYGMY GIDDY
GIPSY: CROST MAILE SOPHY GIPSY
GIRLY: CROST RARED LUMBI GIRLY
GIRTH: CROST TATIE FUBSY GIRTH
GIVEN: CROST LIANE PWNED VIXEN GIVEN
GIVER: CROST RARED PLING GIVER
GLADE: CROST LIANE DEBUG GLADE
GLAND: CROST LIANE DEBAG GLAND
GLARE: CROST RARED BELAY GLARE
GLASS: CROST MAILE SPEKS GLASS
GLAZE: CROST LIANE DEBUG GLAZE
GLEAM: CROST LIANE BEDEL AGILA GLEAM
GLEAN: CROST LIANE PAVEN GLEAN
GLIDE: CROST LIANE DULLY ELIDE GLIDE
GLINT: CROST ALIEN FLINT GLINT
GLOAT: CROST AWFUL GETUP GLOAT
GLOBE: CROST ELAND BEVVY GLOBE
GLOOM: CROST ELAND BUMPY GLOOM
GLORY: CROST HEARD PORGY GLORY
GLOSS: CROST WHELK GLOSS
GLOVE: CROST ELAND BEVVY GLOVE
GLYPH: CROST LIANE PUDGY GLYPH
GNASH: CROST MAILE SUNKS GNASH
GNOME: CROST ELAND KNOWE GNOME
GODLY: CROST LADEN GODLY
GOING: CROST LADEN GUIMP GOING
GOLEM: CROST LADEN VUGHY GOLEM
GOLLY: CROST LADEN FILLY WHOMP JOLLY GOLLY
GONAD: CROST LADEN DONGA GONAD
GONER: CROST RARED WOMYN GLEBA GONER
GOODY: CROST ELAND DUMBO WHEFT GOODY
GOOEY: CROST ELAND THYME ZOOEY GOOEY
GOOFY: CROST ELAND BUMPH GOWFS GOOFY
GOOSE: CROST WHELK GUMBO GOOSE
GORGE: CROST RARED GENOM GORGE
GOUGE: CROST LADEN BEIGE GOUGE
GOURD: CROST RARED BOURD GOURD
GRACE: CROST ABIDE GRACE
GRADE: CROST ABIDE GRADE
GRAFT: CROST APING GRAFT
GRAIL: CROST ABIDE LOGIN GRAIL
GRAIN: CROST ABIDE LOGIN GRAIN
GRAND: CROST ABIDE ALAND GRAND
GRANT: CROST APING GRANT
GRAPE: CROST ABIDE PYGMY GRAPE
GRAPH: CROST ABIDE PAGAN GRAPH
GRASP: CROST BIGAE GRASP
GRASS: CROST BIGAE GRASP GRASS
GRATE: CROST PIETA GOWFS GRATE
GRAVE: CROST ABIDE PYGMY GRAZE GRAVE
GRAVY: CROST ABIDE PAGAN GRAFF GRAVY
GRAZE: CROST ABIDE PYGMY GRAZE
GREAT: CROST APING GRAFT GREAT
GREED: CROST ABIDE EDGED GREED
GREEN: CROST ABIDE PUNKY ERVEN GREEN
GREET: CROST APING GREET
GRIEF: CROST ABIDE PRIEF GRIEF
GRILL: CROST ABIDE FLUMP KRILL GRILL
GRIME: CROST ABIDE GUIMP GRIME
GRIMY: CROST ABIDE FLUMP GRIMY
GRIND: CROST ABIDE DRILY GRIND
GRIPE: CROST ABIDE GUIMP GRIPE
GROAN: CROST PIEND GOWFS GROAN
GROIN: CROST PIEND GROIN
GROOM: CROST PIEND GAUMY GROOM
GROPE: CROST PIEND GROPE
GROSS: CROST PEAGS GROSS
GROUP: CROST PIEND GROUP
GROUT: CROST TANGI GROUT
GROVE: CROST PIEND KBARS FROZE GROVE
GROWL: CROST PIEND GAUMY GROOF GROWL
GROWN: CROST PIEND GOWFS GROWN
GRUEL: CROST ABIDE PUNKY URGER GRUEL
GRUFF: CROST ABIDE GRUMP GRUFF
GRUNT: CROST APING GRUNT
GUARD: CROST RARED AINGA GUARD
GUAVA: CROST LIANE DUMKA GUAVA
GUESS: CROST MAILE NEWSY GUESS
GUEST: CROST WEIGH GUEST
GUIDE: CROST LIANE GUIMP GUIDE
GUILD: CROST LIANE FULLY BUILD GUILD
GUILE: CROST LIANE DULLY GUILE
GUILT: CROST ALIEN DEBUG GUILT
GUISE: CROST MAILE SPUME GUISE
GULCH: CROST LIANE GULCH
GULLY: CROST LIANE PUDGY GULLY
GUMBO: CROST LADEN BUMPY GUMBO
GUMMY: CROST LIANE PYGMY GUMMY
GUPPY: CROST LIANE PYGMY GUPPY
GUSTO: CROST LATTE SUIDS GUSTO
GUSTY: CROST TEATS BLIMY GURDY GUSTY
GYPSY: CROST MAILE SYPHS GYPSY
HABIT: CROST ALIEN VIVAT HABIT
HAIRY: CROST RARED KYLIN CHUFF HAIRY
HALVE: CROST LIANE BADLY VALUE HALVE
HANDY: CROST LIANE PADMA BOUGH HANDY
HAPPY: CROST LIANE BUMPY PYGMY ZAPPY HAPPY
HARDY: CROST RARED DIMLY BUMPH HARDY
HAREM: CROST RARED SPUME HAREM
HARPY: CROST RARED MILKY BARBY HARPY
HARRY: CROST RARED BUMPY HARRY
HARSH: CROST HERMA HARSH
HASTE: CROST TEATS UPBOW HASTE
HASTY: CROST TEATS SPINA MONTH HASTY
HATCH: CROST TATIE PLONG WEMBS HATCH
HATER: CROST TATIE LEMED WHELP HATER
HAUNT: CROST ALIEN THUDS HAUNT
HAUTE: CROST TATIE VAUTE HAUTE
HAVEN: CROST LIANE MANED WHELK HAVEN
HAVOC: CROST LANCH MACHO HAVOC
HAZEL: CROST LIANE BEDEL GALVO HAZEL
HEADY: CROST LIANE DUMPY BEADY HEADY
HEARD: CROST RARED YERBA HEARD
HEART: CROST EMAIL PHYLA HEART
HEATH: CROST TATIE HEMPY HEATH
HEAVE: CROST LIANE WEDGY PASHM HEAVE
HEAVY: CROST LIANE DUMPY BEAKY HEAVY
HEDGE: CROST LIANE DUMPY HOKKU HEDGE
HEFTY: CROST TATIE FLUKY HEFTY
HEIST: CROST WEIGH HEIST
HELIX: CROST LIANE KEVEL FELID HELIX
HELLO: CROST LADEN BILLY HELLO
HENCE: CROST LIANE DEPTH HENCE
HERON: CROST RARED GENOM HERON
HILLY: CROST LIANE GHYLL HILLY
HINGE: CROST LIANE GENOM HOWDY HINGE
HIPPO: CROST LADEN BUMPY HYING HIPPO
HIPPY: CROST LIANE PYGMY CHADO HIPPY
HITCH: CROST TATIE WODGE BUMPY FITCH HITCH
HOARD: CROST RARED BOARD HOARD
HOBBY: CROST LADEN BUMPY HYING HOBBY
HOIST: CROST HADJI HOIST
HOLLY: CROST LADEN FILLY WHOMP HOLLY
HOMER: CROST RARED WOMYN HYING HOMER
HONEY: CROST LADEN BUMPY HONEY
HONOR: CROST RARED MINGY HONOR
HORDE: CROST RARED BORDE HORDE
HORNY: CROST RARED BUNGY HORNY
HORSE: CROST DEGUM WORSE HORSE
HOTEL: CROST LATEN MONTH HOTEL
HOTLY: CROST LATEN HOTLY
HOUND: CROST LADEN GUNKY WHOMP HOUND
HOUSE: CROST ULYIE SHAWM HOUSE
HOVEL: CROST LADEN VUGHY HOVEL
HOVER: CROST RARED WOMYN GULPH HOVER
HOWDY: CROST LADEN HIMBO HOWDY
HUMAN: CROST LIANE PADMA UNMAN HUMAN
HUMID: CROST LIANE MUMPS HUMID
HUMOR: CROST RARED MINGY HUMOR
HUMPH: CROST LIANE PYGMY HUMPH
HUMUS: CROST MAILE SYLPH HUMUS
HUNCH: CROST LIANE DUMPS HUNCH
HUNKY: CROST LIANE BUNDH HUNKY
HURRY: CROST RARED BLIMY HYING HURRY
HUSKY: CROST MAILE DUNKS HUSKY
HUSSY: CROST MAILE SYPHS HUSSY
HUTCH: CROST TATIE DUMBO HUTCH
HYDRO: CROST RARED DONOR HYDRO
HYENA: CROST LIANE FEHME HYENA
HYMEN: CROST LIANE WEEDY HYMEN
HYPER: CROST RARED PLING UPPER HYPER
ICILY: CROST LIANE HUFFY ICILY
ICING: CROST LIANE ICING
IDEAL: CROST LIANE ELIAD IDEAL
IDIOM: CROST LADEN HIMBO IDIOM
IDIOT: CROST GIBEL NOOPS IDIOT
IDLER: CROST RARED ENDUE MILKY IDLER
IDYLL: CROST LIANE FULLY IDYLL
IGLOO: CROST LADEN FILLY POLIO IGLOO
ILIAC: CROST LIANE MALIC ILIAC
IMAGE: CROST LIANE IMAGE
IMBUE: CROST LIANE GUIMP IMBUE
IMPEL: CROST LIANE KEVEL IMPEL
IMPLY: CROST LIANE FULLY IMPLY
INANE: CROST LIANE INANE
INBOX: CROST LADEN GUIMP INBOX
INCUR: CROST AIRER INCUR
INDEX: CROST LIANE UNPIN INDEW INDEX
INEPT: CROST ALIEN IDENT INEPT
INERT: CROST EMAIL PIERT INERT
INFER: CROST RARED PLING FINNY INFER
INGOT: CROST GIBEL INGOT
INLAY: CROST LIANE AINGA INLAY
INLET: CROST ALIEN INLET
INNER: CROST RARED PLING FINNY INNER
INPUT: CROST ALIEN UNWIT INPUT
INTER: CROST TATIE BINKS INTER
INTRO: CROST TATER NITRO INTRO
IONIC: CROST LANCH STYME IONIC
IRATE: CROST PIETA IRATE
IRONY: CROST PIEND IRONY
ISLET: CROST ALEPH ISLET
ISSUE: CROST MAILE VODUN ISSUE
ITCHY: CROST TATIE DICTY ITCHY
IVORY: CROST HEARD PORGY IVORY
JAUNT: CROST ALIEN THUDS GALVO JAUNT
JAZZY: CROST LIANE BUMPY FADGE JAZZY
JELLY: CROST LIANE DEBEL SKELF WODGE JELLY
JERKY: CROST RARED LINGY KEMPS JERKY
JETTY: CROST TATIE JUPON JETTY
JEWEL: CROST LIANE DEBEL WOMEN JEWEL
JIFFY: CROST LIANE PYGMY VIFDA BIFFY JIFFY
JOINT: CROST GIBEL NOOPS JOINT
JOIST: CROST HADJI JOIST
JOKER: CROST RARED WOMYN GULPH KOKER JOKER
JOLLY: CROST LADEN FILLY WHOMP JOLLY
JOUST: CROST HADJI JOUST
JUDGE: CROST LIANE DUMPY BIFFO JUDGE
JUICE: CROST LIANE JUICE
JUICY: CROST LIANE YUCCH JUICY
JUMBO: CROST LADEN BUMPY GUMBO JUMBO
JUMPY: CROST LIANE PYGMY DHOBI JUMPY
JUNTA: CROST TATIE WHATA JUNTA
JUNTO: CROST LATEN JIMPY JUNTO
JUROR: CROST RARED SULFO JUROR
KAPPA: CROST LIANE BUMPY KAPPA
KARMA: CROST RARED MILKY KARMA
KAYAK: CROST LIANE BUMPY WHYDA KAYAK
KEBAB: CROST LIANE MAWKY KEBAB
KHAKI: CROST LIANE AZUKI KHAKI
KINKY: CROST LIANE KINDY KINKY
KIOSK: CROST WHELK KIOSK
KITTY: CROST TATIE NUKED KITTY
KNACK: CROST LIANE KNACK
KNAVE: CROST LIANE KNAVE
KNEAD: CROST LIANE MANED KNEAD
KNEED: CROST LIANE WEEDY KNEED
KNEEL: CROST LIANE BEVEL KNEEL
KNELT: CROST ALIEN KNELT
KNIFE: CROST LIANE UNIFY KNIFE
KNOCK: CROST PEKAN KNOCK
KNOLL: CROST ELAND KNOLL
KNOWN: CROST ELAND QUOIN KNOWN
KOALA: CROST LADEN GLIAL BEAKY KOALA
KRILL: CROST ABIDE FLUMP KRILL
LABEL: CROST LIANE PADMA LABEL
LABOR: CROST RARED VINYL LABOR
LADEN: CROST LIANE LADEN
LADLE: CROST LIANE LAPJE LADLE
LAGER: CROST RARED GLYPH LAGER
LANCE: CROST LIANE LANCE
LANKY: CROST LIANE LAGAN LANKY
LAPEL: CROST LIANE PADMA LAPEL
LAPSE: CROST MAILE SELAH LAPSE
LARGE: CROST RARED PYGAL LARGE
LARVA: CROST RARED MILKY LARVA
LASSO: CROST ULYIE LASSO
LATCH: CROST TATIE PLONG LATCH
LATER: CROST TATIE LEMED LATER
LATHE: CROST TATIE WELKE LATHE
LATTE: CROST TATIE SMELT LATTE
LAUGH: CROST LIANE DUMMY LAUGH
LAYER: CROST RARED GLYPH LAYER
LEACH: CROST LIANE LEACH
LEAFY: CROST LIANE FIKED LEAFY
LEAKY: CROST LIANE FIKED LEAKY
LEANT: CROST ALIEN LEANT
LEAPT: CROST ALIEN EXALT LEAPT
LEARN: CROST RARED BELAY LEARE LEARN
LEASE: CROST MAILE LEASE
LEASH: CROST MAILE LEASH
LEAST: CROST WEIGH BLADY LEAST
LEAVE: CROST LIANE LEAVE
LEDGE: CROST LIANE BEGEM LEDGE
LEECH: CROST LIANE LEUCH LEECH
LEERY: CROST RARED VENUE PLATS LEERY
LEFTY: CROST TATIE FLUKY LEFTY
LEGAL: CROST LIANE PADMA LEGAL
LEGGY: CROST LIANE MIDGY LEGGY
LEMON: CROST LADEN LEMON
LEMUR: CROST RARED VENUE FEMUR LEMUR
LEPER: CROST RARED PLING LEPER
LEVEL: CROST LIANE MIDGY LEVEL
LEVER: CROST RARED PLING LUXER LEVER
LIBEL: CROST LIANE DUMKA LIBEL
LIEGE: CROST LIANE LIEVE LIEGE
LIGHT: CROST ALIEN LIMIT LIGHT
LIKEN: CROST LIANE DINKY LIKEN
LILAC: CROST LIANE LILAC
LIMBO: CROST LADEN BULGY LIMBO
LIMIT: CROST ALIEN LIMIT
LINEN: CROST LIANE DINKY LINEN
LINER: CROST RARED PLING LINER
LINGO: CROST LADEN LINGO
LIPID: CROST LIANE LIPID
LITHE: CROST TATIE HULKY LITHE
LIVER: CROST RARED PLING FILKS LIVER
LIVID: CROST LIANE LIPID LIVID
LLAMA: CROST LIANE LLAMA
LOAMY: CROST LADEN LOUMA LOAMY
LOATH: CROST LATEN LOATH
LOBBY: CROST LADEN BULGY LOBBY
LOCAL: CROST LANCH LOCAL
LOCUS: CROST SOKEN HAULD LOCUS
LODGE: CROST LADEN LODGE
LOFTY: CROST LATEN LOFTY
LOGIC: CROST LANCH LOGIC
LOGIN: CROST LADEN LOGIN
LOOPY: CROST ELAND OBOLI LOOPY
LOOSE: CROST WHELK LOOSE
LORRY: CROST RARED SULFO LORRY
LOSER: CROST DARES SLING LOSER
LOUSE: CROST ULYIE LOUSE
LOUSY: CROST ULYIE LOUSY
LOVER: CROST RARED WOMYN GULPH LOVER
LOWER: CROST RARED WOMYN BLOOP LOWER
LOWLY: CROST LADEN BULGY LOWLY
LOYAL: CROST LADEN LOUMA LOYAL
LUCID: CROST LIANE LUDIC LUCID
LUCKY: CROST LIANE LUCKY
LUMEN: CROST LIANE LEBEN LUMEN
LUMPY: CROST LIANE LYMPH LUMPY
LUNAR: CROST RARED LINUM LUNAR
LUNCH: CROST LIANE LUNCH
LUNGE: CROST LIANE LUNGE
LUPUS: CROST MAILE SKUGS LUPUS
LURCH: CROST AIRER LURCH
LURID: CROST RARED MURID LURID
LUSTY: CROST TEATS BLIMY LUSTY
LYING: CROST LIANE LYING
LYMPH: CROST LIANE LYMPH
LYNCH: CROST LIANE LUNCH LYNCH
LYRIC: CROST AIRER PYRIC LYRIC
MACAW: CROST LIANE MUCKY MACAW
MACHO: CROST LANCH MACHO
MACRO: CROST HIRER RACON MACRO
MADAM: CROST LIANE BUMPY MAGMA MADAM
MADLY: CROST LIANE GAMAY ABAMP MADLY
MAFIA: CROST LIANE PADMA ZAMIA MAFIA
MAGIC: CROST LIANE GAMIC MAGIC
MAGMA: CROST LIANE BUMPY MAGMA
MAIZE: CROST LIANE ADMIX MAIZE
MAJOR: CROST RARED VINYL MAJOR
MAKER: CROST RARED GLYPH WAKFS JAMBS MAKER
MAMBO: CROST LADEN MAWKY MAMBO
MAMMA: CROST LIANE BUMPY MAMMA
MAMMY: CROST LIANE BUMPY AGHAS MAMMY
MANGA: CROST LIANE PADMA MANGA
MANGE: CROST LIANE WENGE MANGE
MANGO: CROST LADEN GOMBO MANGO
MANGY: CROST LIANE PADMA MANKY MANGY
MANIA: CROST LIANE MANGA MANIA
MANIC: CROST LIANE MANIC
MANLY: CROST LIANE UNLAY MANLY
MANOR: CROST RARED VINYL MANOR
MAPLE: CROST LIANE BADLY MAPLE
MARCH: CROST AIRER BUMPY MARCH
MARRY: CROST RARED BUMPY MARRY
MARSH: CROST HERMA MARSH
MASON: CROST NALED MASON
MASSE: CROST MAILE MANSE MASSE
MATCH: CROST TATIE PLONG WEMBS MATCH
MATEY: CROST TATIE DELPH MATEY
MAUVE: CROST LIANE GUMBO MAUVE
MAXIM: CROST LIANE PADMA IMMIT MAXIM
MAYBE: CROST LIANE GUMBO MAYBE
MAYOR: CROST RARED VINYL MAYOR
MEALY: CROST LIANE WHELM MEALY
MEANT: CROST ALIEN MEANT
MEATY: CROST TATIE HEMPY MEATY
MECCA: CROST LIANE AMPED MECCA
MEDAL: CROST LIANE BEDEL PROMO MEDAL
MEDIA: CROST LIANE ADIEU MEDIA
MEDIC: CROST LIANE HEMIC MEDIC
MELEE: CROST LIANE BEGEM MELEE
MELON: CROST LADEN FLUMP MELON
MERCY: CROST AIRER PERCH MERCY
MERGE: CROST RARED LINGY TRUMP MERGE
MERIT: CROST EMAIL MERIT
MERRY: CROST RARED JUMPY MERRY
METAL: CROST TATIE FLUMP METAL
METER: CROST TATIE LEMED RETEM METER
METRO: CROST TATER RETRO METRO
MICRO: CROST HIRER MICRO
MIDGE: CROST LIANE KEDGE FIDGE MIDGE
MIDST: CROST WEIGH MIDST
MIGHT: CROST ALIEN BIFID TRUMP MIGHT
MILKY: CROST LIANE GHYLL MILKY
MIMIC: CROST LIANE KEMPY MIMIC
MINCE: CROST LIANE WHELM MINCE
MINER: CROST RARED PLING FINNY MAVEN MINER
MINIM: CROST LIANE KINDY PINUP MINIM
MINOR: CROST RARED MINGY MINOR
MINTY: CROST TATIE FILMY MINTY
MINUS: CROST MAILE UNKID MINUS
MIRTH: CROST TATIE FUBSY GIRTH MIRTH
MISER: CROST SERAI LIMEN MISER
MISSY: CROST MAILE MIMSY MISSY
MOCHA: CROST LANCH MOCHA
MODAL: CROST LADEN MODAL
MODEL: CROST LADEN STYME MODEL
MODEM: CROST LADEN PROMO MODEM
MOGUL: CROST LADEN FILLY BOBOL MOGUL
MOIST: CROST HADJI ZOISM MOIST
MOLAR: CROST RARED BULGY PROMO MOLAR
MOLDY: CROST LADEN GOYIM MOLDY
MONEY: CROST LADEN BUMPY MONEY
MONTH: CROST LATEN JIMPY MONTH
MOODY: CROST ELAND DUMBO MOODY
MOOSE: CROST WHELK GUMBO MOOSE
MORAL: CROST RARED LIMAN MORAL
MORON: CROST RARED BUNGY MORON
MORPH: CROST RARED BUNGY MORPH
MOSSY: CROST ULYIE SPIMS MOSSY
MOTEL: CROST LATEN MONTH MOTEL
MOTIF: CROST LATEN HUMPY MOTTO MOTIF
MOTOR: CROST TATER MOTOR
MOTTO: CROST LATEN HUMPY MOTTO
MOULT: CROST GIBEL POULT MOULT
MOUND: CROST LADEN GUNKY WHOMP MOUND
MOUNT: CROST GIBEL FOUNT MOUNT
MOURN: CROST RARED MINGY MOURN
MOUSE: CROST ULYIE SHAWM MOUSE
MOUTH: CROST LATEN TUMPY MOUTH
MOVER: CROST RARED WOMYN MOVER
MOVIE: CROST LADEN BEIGE COMFY MOVIE
MOWER: CROST RARED WOMYN MOWER
MUCKY: CROST LIANE YIKED MUCKY
MUCUS: CROST KAIES FLUMP MUCUS
MUDDY: CROST LIANE PYGMY DUMKY MUDDY
MULCH: CROST LIANE GULCH MULCH
MUMMY: CROST LIANE PYGMY MUMMY
MUNCH: CROST LIANE DUMPS MUNCH
MURAL: CROST RARED PILUM MURAL
MURKY: CROST RARED LUMBI MURKY
MUSHY: CROST MAILE KAGUS MUSHY
MUSIC: CROST KAIES SUCCI MUSIC
MUSKY: CROST MAILE KAGUS MUSKY
MUSTY: CROST TEATS BLIMY MUSTY
MYRRH: CROST RARED BLIMY MYRRH
NADIR: CROST RARED DAMAR NADIR
NAIVE: CROST LIANE ANIME NAIVE
NANNY: CROST LIANE BAWDY FUJIS NANNY
NASAL: CROST MAILE BUNAS NASAL
NASTY: CROST TEATS SPINA NASTY
NATAL: CROST TATIE HALFA NUKED NATAL
NAVAL: CROST LIANE UNLAY FINCH NAVAL
NAVEL: CROST LIANE PAVEN NAVEL
NEEDY: CROST LIANE WEEDY NEEDY
NEIGH: CROST LIANE UNPIN NEIGH
NERDY: CROST RARED DUNGY NERDY
NERVE: CROST RARED LINGY NERVE
NEVER: CROST RARED PLING NEVER
NEWER: CROST RARED PLING NEVER NEWER
NEWLY: CROST LIANE BEVEL NEWLY
NICER: CROST AIRER DICER NICER
NICHE: CROST LIANE WHELM NICHE
NIECE: CROST LIANE WHELM NIECE
NIGHT: CROST ALIEN UNWIT NIGHT
NINJA: CROST LIANE KAWAU NINJA
NINNY: CROST LIANE NYMPH NINNY
NINTH: CROST TATIE FILMY NINTH
NOBLE: CROST LADEN NOULE NOBLE
NOBLY: CROST LADEN NOBLY
NOISE: CROST ULYIE MONTH NOISE
NOISY: CROST ULYIE NOISY
NOMAD: CROST LADEN DONGA NOMAD
NOOSE: CROST WHELK GUMBO NOOSE
NORTH: CROST TATER FORBY WORTH NORTH
NOSEY: CROST NALED MOSEY NOSEY
NOTCH: CROST POTIN NOTCH
NOVEL: CROST LADEN NOVEL
NUDGE: CROST LIANE DEGUM NUDGE
NURSE: CROST HERMA BRINY NURSE
NUTTY: CROST TATIE PRANG NUTTY
NYLON: CROST LADEN NYLON
NYMPH: CROST LIANE BUNDH NYMPH
OAKEN: CROST LADEN OAKEN
OBESE: CROST ULYIE SOWFF OBESE
OCCUR: CROST HIRER MUCOR OCCUR
OCEAN: CROST LANCH ANCON OCEAN
OCTAL: CROST POTIN OCTAL
OCTET: CROST DEVON OCTET
ODDER: CROST RARED WOMEN ODDER
ODDLY: CROST LADEN GODLY ODDLY
OFFAL: CROST LADEN GLIAL JOUAL OFFAL
OFFER: CROST RARED WOMYN DILLS OFFER
OFTEN: CROST LATEN HOTEN OFTEN
OLDEN: CROST LADEN OLDEN
OLDER: CROST RARED WOMEN ODDER OLDER
OLIVE: CROST LADEN BILLY OLIVE
OMBRE: CROST RARED NEUME MOIRE OMBRE
OMEGA: CROST LADEN ZOEAE OMEGA
ONION: CROST LADEN PIGMY INURN ONION
ONSET: CROST PARES ONSET
OPERA: CROST RARED OPERA
OPINE: CROST LADEN PENNI OPINE
OPIUM: CROST LADEN BUMPY OPIUM
OPTIC: CROST POTIN OPTIC
ORBIT: CROST ARGOT ORBIT
ORDER: CROST ANGER ORDER
ORGAN: CROST ANGER ORGAN
OTHER: CROST TATER OTHER
OTTER: CROST TATER OTTER
OUGHT: CROST GIBEL MAGOT OUGHT
OUNCE: CROST LANCH UPBYE OUNCE
OUTDO: CROST LATEN HUMPY OUTGO OUTDO
OUTER: CROST TATER FONDU OUTER
OUTGO: CROST LATEN HUMPY OUTGO
OVARY: CROST RARED BULGY OVARY
OVATE: CROST LATEN TOAZE OVATE
OVERT: CROST TERRA OVERT
OVINE: CROST LADEN PENNI OVINE
OVOID: CROST ELAND HOMOS OVOID
OWING: CROST LADEN GUIMP HOING OWING
OWNER: CROST RARED WOMYN OWNER
OXIDE: CROST LADEN BEWIG OXIDE
OZONE: CROST ELAND PHONE OZONE
PADDY: CROST LIANE BUMPY PAWKY PADDY
PAGAN: CROST LIANE PADMA PAVAN PAGAN
PAINT: CROST ALIEN TOPHE PAINT
PALER: CROST RARED GLYPH PALER
PALSY: CROST MAILE LASSY PALSY
PANEL: CROST LIANE PAVEN PANEL
PANIC: CROST LIANE MANIC PANIC
PANSY: CROST MAILE GASSY PANSY
PAPAL: CROST LIANE GAMAY HELPS PAPAL
PAPER: CROST RARED GLYPH PAVER PAWER PAPER
PARER: CROST RARED BUMPY PARER
PARKA: CROST RARED MILKY PARKA
PARRY: CROST RARED BUMPY PARRY
PARSE: CROST HERMA FARSE PARSE
PARTY: CROST TATIE AWAYS PARTY
PASTA: CROST TEATS SPINA PASTA
PASTE: CROST TEATS UPBOW PASTE
PASTY: CROST TEATS SPINA PASTY
PATCH: CROST TATIE PLONG PATCH
PATIO: CROST LATEN TINTY PATIO
PATSY: CROST TAMIN PATSY
PATTY: CROST TATIE BUNIA FATTY PATTY
PAUSE: CROST MAILE SPINS PAUSE
PAYEE: CROST LIANE GUMBO PAYEE
PAYER: CROST RARED GLYPH PAYER
PEACE: CROST LIANE PEACE
PEACH: CROST LIANE BEACH PEACH
PEARL: CROST RARED BELAY LEARE PEARL
PECAN: CROST LIANE PECAN
PEDAL: CROST LIANE BEDEL PROMO PEDAL
PENAL: CROST LIANE PAVEN PENAL
PENCE: CROST LIANE DEPTH PENCE
PENNE: CROST LIANE BENNE PENNE
PENNY: CROST LIANE WHELP PENNY
PERCH: CROST AIRER PERCH
PERIL: CROST RARED LINGY PERIL
PERKY: CROST RARED LINGY KEMPS PERKY
PESKY: CROST MAILE PENED PESKY
PESTO: CROST LATTE PESTO
PETAL: CROST TATIE FLUMP PETAL
PETTY: CROST TATIE JUPON PETTY
PHASE: CROST MAILE SETUP PHASE
PHONE: CROST ELAND PHONE
PHONY: CROST ELAND MOCHY PHONY
PHOTO: CROST PHYLA PHOTO
PIANO: CROST LADEN GINNY PIANO
PICKY: CROST LIANE KEMPY PICKY
PIECE: CROST LIANE MICHE PIECE
PIETY: CROST TATIE MEITH PIETY
PIGGY: CROST LIANE PYGMY PIGGY
PILOT: CROST GIBEL PILOT
PINCH: CROST LIANE HAFIZ GETUP PINCH
PINEY: CROST LIANE PWNED PINEY
PINKY: CROST LIANE KINDY PHYLA PINKY
PINTO: CROST LATEN JIMPY PINTO
PIPER: CROST RARED PLING PIPER
PIQUE: CROST LIANE KEDGE PIQUE
PITCH: CROST TATIE WODGE BUMPY PITCH
PITHY: CROST TATIE WHELM PITHY
PIVOT: CROST GIBEL DEVON PIVOT
PIXEL: CROST LIANE GYBED PILEI PIXEL
PIXIE: CROST LIANE KEDGE PIQUE PIXIE
PIZZA: CROST LIANE BUMPH PIZZA
PLACE: CROST LIANE GLACE PLACE
PLAID: CROST LIANE AGUED PLAID
PLAIN: CROST LIANE PLAIN
PLAIT: CROST ALIEN PLAIT
PLANE: CROST LIANE APPLY PLANE
PLANK: CROST LIANE DEBAG FLANK PLANK
PLANT: CROST ALIEN PLANT
PLATE: CROST TATIE GLEBE PLATE
PLAZA: CROST LIANE DUMPY PLAZA
PLEAD: CROST LIANE BEDEL PLEAD
PLEAT: CROST ALIEN PLEAT
PLIED: CROST LIANE KEVEL PLIED
PLIER: CROST RARED PLING PLIER
PLUCK: CROST LIANE GULCH PLUCK
PLUMB: CROST LIANE PUDGY PLUMP PLUMB
PLUME: CROST LIANE BEGEM PLUME
PLUMP: CROST LIANE PUDGY PLUMP
PLUNK: CROST LIANE BEFOG PLUNK
PLUSH: CROST MAILE SPIFF PLUSH
POESY: CROST ULYIE POESY
POINT: CROST GIBEL NOOPS POINT
POISE: CROST ULYIE MONTH POISE
POKER: CROST RARED WOMYN GULPH POKER
POLAR: CROST RARED BULGY PROMO POLAR
POLKA: CROST LADEN GLIAL BEAKY POLKA
POLYP: CROST LADEN FILLY POLYP
POOCH: CROST PEKAN POOCH
POPPY: CROST LADEN BUMPY POPPY
PORCH: CROST HIRER PORCH
POSER: CROST DARES SLING POSER
POSIT: CROST PARES POSIT
POSSE: CROST ULYIE SOWFF POSSE
POUCH: CROST LANCH PYGMY POUCH
POUND: CROST LADEN GUNKY WHOMP POUND
POUTY: CROST LATEN TUMPY POUTY
POWER: CROST RARED WOMYN BLOOP POWER
PRANK: CROST ABIDE PAGAN PRANK
PRAWN: CROST ABIDE PAGAN PRAWN
PREEN: CROST ABIDE PUNKY PREEN
PRESS: CROST BIGAE PRESS
PRICE: CROST ABIDE GRICE PRICE
PRICK: CROST ABIDE PRICK
PRIDE: CROST ABIDE PRIDE
PRIED: CROST ABIDE DOWDS PRIED
PRIME: CROST ABIDE GUIMP PRIME
PRIMO: CROST ANGER ORLOP PRIMO
PRINT: CROST APING PRINT
PRIOR: CROST ANGER PRIOR
PRISM: CROST BIGAE PRISM
PRIVY: CROST ABIDE FLUMP PRINK PRIVY
PRIZE: CROST ABIDE GUIMP PRIZE
PROBE: CROST PIEND BLARE PROBE
PRONE: CROST PIEND PRONE
PRONG: CROST PIEND PRONG
PROOF: CROST PIEND FULLY PROOF
PROSE: CROST PEAGS PROSE
PROUD: CROST PIEND PROUD
PROVE: CROST PIEND BLARE PROVE
PROWL: CROST PIEND FULLY PROWL
PROXY: CROST PIEND FULLY PROXY
PRUDE: CROST ABIDE GRYDE PRUDE
PRUNE: CROST ABIDE PUDGY PRUNE
PSALM: CROST MAILE SMALL PSALM
PUBIC: CROST LIANE YUCCH PUBIC
PUDGY: CROST LIANE PYGMY PUDGY
PUFFY: CROST LIANE PYGMY DUMPS PUFFY
PULPY: CROST LIANE PUDGY PULPY
PULSE: CROST MAILE BUNDS PULSE
PUNCH: CROST LIANE DUMPS PUNCH
PUPAL: CROST LIANE GAMAY PUPAL
PUPIL: CROST LIANE FULLY PUPIL
PUPPY: CROST LIANE PYGMY DUMPS PUPPY
PUREE: CROST RARED SIMUL PUREE
PURER: CROST RARED FELID PURER
PURGE: CROST RARED LINGY TRUMP PURGE
PURSE: CROST HERMA BRINY PURSE
PUSHY: CROST MAILE DUNKS GOBBY HUSHY PUSHY
PUTTY: CROST TATIE PRANG PUTTY
PYGMY: CROST LIANE PYGMY
QUACK: CROST LIANE HOKKU QUACK
QUAIL: CROST LIANE AGUED QUAIL
QUAKE: CROST LIANE WEDGY AMAZE QUAKE
QUALM: CROST LIANE DUMPY QUALM
QUARK: CROST RARED LINUM AZURY QUARK
QUART: CROST EMAIL TUART QUART
QUASH: CROST MAILE SUNKS QUASH
QUASI: CROST MAILE QUASI
QUEEN: CROST LIANE WEEDY QUEEN
QUEER: CROST RARED PLING BEEFY EMEER QUEER
QUELL: CROST LIANE DEBEL KVELL QUELL
QUERY: CROST RARED VENUE QUERY
QUEST: CROST WEIGH QUEST
QUEUE: CROST LIANE DUMPY FUZEE QUEUE
QUICK: CROST LIANE YUCCH QUICK
QUIET: CROST ALIEN QUIET
QUILL: CROST LIANE FULLY QUILL
QUILT: CROST ALIEN DEBUG QUILT
QUIRK: CROST RARED KNURL QUIRK
QUITE: CROST TATIE BUHLS QUITE
QUOTA: CROST PHYLA DIOTA QUOTA
QUOTE: CROST PHYLA QUOTE
QUOTH: CROST PHYLA TOOTH QUOTH
RABBI: CROST RARED MINGY RAHUI RABBI
RABID: CROST RARED BRINY RABID
RACER: CROST AIRER RACER
RADAR: CROST RARED RADAR
RADII: CROST RARED RADII
RADIO: CROST RARED RADIO
RAINY: CROST RARED MINGY RAINY
RAISE: CROST HERMA RASSE RAISE
RAJAH: CROST RARED MINGY RALPH RAJAH
RALLY: CROST RARED MINGY RAWLY RALLY
RALPH: CROST RARED MINGY RALPH
RAMEN: CROST RARED MINKE RAMEN
RANCH: CROST AIRER LYCRA RANCH
RANDY: CROST RARED RADII RANDY
RANGE: CROST RARED HYING RANGE
RAPID: CROST RARED BRINY RAPID
RARER: CROST RARED RARER
RASPY: CROST SERAI GUNKY RASPY
RATIO: CROST TATER RATIO
RATTY: CROST TATIE RATTY
RAVEN: CROST RARED MINKE RAVEN
RAYON: CROST RARED RAZOO RAYON
RAZOR: CROST RARED RAZOR
REACH: CROST AIRER RECAP REACH
REACT: CROST RICHT REACT
READY: CROST RARED RUEDA READY
REALM: CROST RARED PYGAL REALM
REARM: CROST RARED REBAR REARM
REBAR: CROST RARED REBAR
REBEL: CROST RARED PILUM BIFFO REBEL
REBUS: CROST SERAI REDES RESUS REBUS
REBUT: CROST EMAIL REWET REBUT
RECAP: CROST AIRER RECAP
RECUR: CROST AIRER RECUR
RECUT: CROST RICHT RECUT
REEDY: CROST RARED ELUDE REEDY
REFER: CROST RARED FLIMP REFER
REFIT: CROST EMAIL REBIT REFIT
REGAL: CROST RARED PYGAL REGAL
REHAB: CROST RARED PYGAL REWAN REHAB
REIGN: CROST RARED GENIE REIGN
RELAX: CROST RARED PYGAL RELAX
RELAY: CROST RARED PYGAL RELAY
RELIC: CROST AIRER RELIC
REMIT: CROST EMAIL MERIT REMIT
RENAL: CROST RARED PYGAL RENAL
RENEW: CROST RARED PILUM RENEY RENEW
REPAY: CROST RARED PYGAL REPAY
REPEL: CROST RARED PILUM REPEL
REPLY: CROST RARED GENIE REFLY REPLY
RERUN: CROST RARED RERUN
RESET: CROST SPIAL RESET
RESIN: CROST SERAI KNIFE RESIN
RETCH: CROST RECTI RETCH
RETRO: CROST TATER RETRO
RETRY: CROST TATIE LEMED RETRY
REUSE: CROST HERMA REUSE
REVEL: CROST RARED PILUM BIFFO REVEL
REVUE: CROST RARED GENIE REVUE
RHINO: CROST RARED PONGY RHINO
RHYME: CROST RARED GENIE HULES RHYME
RIDER: CROST RARED RUDER RIDER
RIDGE: CROST RARED ELUDE RIDGE
RIFLE: CROST RARED GENIE RIFLE
RIGHT: CROST EMAIL RIGHT
RIGID: CROST RARED RIGID
RIGOR: CROST RARED RIGOR
RINSE: CROST HERMA RINSE
RIPEN: CROST RARED PILUM RIPEN
RIPER: CROST RARED FLIMP RIPER
RISEN: CROST SERAI LIMEN RISEN
RISER: CROST SERAI LIMEN SPUDS RISER
RISKY: CROST SERAI KNURL RISKS RISKY
RIVAL: CROST RARED BLIMY RIVAL
RIVER: CROST RARED FLIMP RIVER
RIVET: CROST EMAIL PIERT RIVET
ROACH: CROST HIRER ROACH
ROAST: CROST RAHUI ROAST
ROBIN: CROST RARED PONGY ROBIN
ROBOT: CROST TERRA ROBOT
ROCKY: CROST HIRER RACON ROCKY
RODEO: CROST RARED RODEO
ROGER: CROST RARED PAWKY ROGER
ROGUE: CROST RARED LUNGE ROGUE
ROOMY: CROST HEARD FLUMP ROOMY
ROOST: CROST ROOST
ROTOR: CROST TATER MOTOR ROTOR
ROUGE: CROST RARED LUNGE ROUGE
ROUGH: CROST RARED PONGY ROUGH
ROUND: CROST RARED ROWND ROUND
ROUSE: CROST DEGUM ROUSE
ROUTE: CROST TATER RONTE ROUTE
ROVER: CROST RARED PAWKY ROGER ROVER
ROWDY: CROST RARED ROWDY
ROWER: CROST RARED PAWKY ROWER
ROYAL: CROST RARED MILKY ROYAL
RUDDY: CROST RARED RUDDY
RUDER: CROST RARED RUDER
RUGBY: CROST RARED BLIMY RUGBY
RULER: CROST RARED FLIMP RULER
RUMBA: CROST RARED BLIMY RUMBA
RUMOR: CROST RARED RIGOR RUMOR
RUPEE: CROST RARED PILUM RUPEE
RURAL: CROST RARED RURAL
RUSTY: CROST TERAI RUNTS RUSTY
SADLY: CROST MAILE WHAUP GOLFS SADLY
SAFER: CROST SERAI WANEY FISKS SAFER
SAINT: CROST ALEPH SAUNT SAINT
SALAD: CROST MAILE BUNAS SALAL SALAD
SALLY: CROST MAILE WHAUP GOLFS SALLY
SALON: CROST NALED SALON
SALSA: CROST MAILE LASSY SALSA
SALTY: CROST TEATS SPINA SALTY
SALVE: CROST MAILE SALVE
SALVO: CROST NALED SALOP SALVO
SANDY: CROST MAILE HUNKY SANDY
SANER: CROST SERAI WANEY SANER
SAPPY: CROST MAILE HUNKY GYPPO SAPPY
SASSY: CROST MAILE GASSY SASSY
SATIN: CROST TEATS SATIN
SATYR: CROST TERAI KNUTS STARR SATYR
SAUCE: CROST KAIES SAUCE
SAUCY: CROST KAIES SAUCY
SAUNA: CROST MAILE HUNKY FAUNS SAUNA
SAUTE: CROST TEATS UPBOW SAUTE
SAVOR: CROST DARES SAVOR
SAVOY: CROST NALED SYKES SAVOY
SAVVY: CROST MAILE HUNKY GYPPO SAVVY
SCALD: CROST KAIES DUPLY SCALD
SCALE: CROST KAIES SCALE
SCALP: CROST KAIES DUPLY SCALP
SCALY: CROST KAIES DUPLY SCALY
SCAMP: CROST KAIES DUPLY SCAMP
SCANT: CROST PIETA SCANT
SCARE: CROST PEARS SCARE
SCARF: CROST PEARS SCARY SCARF
SCARY: CROST PEARS SCARY
SCENE: CROST KAIES SCENE
SCENT: CROST PIETA SCENT
SCION: CROST SOKEN SCION
SCOFF: CROST GULPS HYMEN SCOFF
SCOLD: CROST GULPS SCOLD
SCONE: CROST GULPS HYMEN SCONE
SCOOP: CROST GULPS SCOWP SCOOP
SCOPE: CROST GULPS SCOPE
SCORE: CROST SCORE
SCORN: CROST SCORE SCORN
SCOUR: CROST SCORE SCOUR
SCOUT: CROST SCOOT SCOUT
SCOWL: CROST GULPS SCOLD SCOWL
SCRAM: CROST PEARS MINGY SCRAM
SCRAP: CROST PEARS SCRAP
SCREE: CROST PEARS SCREW SCREE
SCREW: CROST PEARS SCREW
SCRUB: CROST PEARS SCRUM SCRUB
SCRUM: CROST PEARS SCRUM
SCUBA: CROST KAIES DUPLY SCUBA
SEDAN: CROST MAILE PENDS SEDAN
SEEDY: CROST MAILE PENED HOWDY SEEDY
SEGUE: CROST MAILE UNDER SEGUE
SEIZE: CROST MAILE POWND SKIVE SEIZE
SEMEN: CROST MAILE SEMEN
SENSE: CROST MAILE NEEDY SENSE
SEPIA: CROST MAILE AEGIS SEPIA
SERIF: CROST SERAI SERIN SERIF
SERUM: CROST SERAI EGERS SERUM
SERVE: CROST SERAI EGERS SERER SERVE
SETUP: CROST TEATS SETUP
SEVEN: CROST MAILE PENED AWAYS SEVEN
SEVER: CROST SERAI FEDEX SEWER SEVER
SEWER: CROST SERAI FEDEX SEWER
SHACK: CROST KAIES WHELM SHACK
SHADE: CROST MAILE SPUNK DERVS SHADE
SHADY: CROST MAILE SPUNK WHYDA SHADY
SHAFT: CROST ALEPH SHAKT SHAFT
SHAKE: CROST MAILE SPUNK SHAKE
SHAKY: CROST MAILE SPUNK SKAGS SHAKY
SHALE: CROST MAILE CHAWS SHALE
SHALL: CROST MAILE PUDGY SHALL
SHALT: CROST ALEPH SHALT
SHAME: CROST MAILE SEAME SHAME
SHANK: CROST MAILE SPUNK HOKKU SHANK
SHAPE: CROST MAILE SPUNK SHAPE
SHARD: CROST SERAI HUNKS SHARD
SHARE: CROST SERAI WANEY SHARE
SHARK: CROST SERAI HUNKS SHARK
SHARP: CROST SERAI HUNKS SHARD SHARP
SHAVE: CROST MAILE SPUNK DERVS SHAVE
SHAWL: CROST MAILE PUNGS SYLVA SHAWL
SHEAR: CROST SERAI WHOMP SHEAR
SHEEN: CROST MAILE PENED SKEEN SHEEN
SHEEP: CROST MAILE PENED SWEEP SHEEP
SHEER: CROST SERAI PUKEY WHELM SHEER
SHEET: CROST ALEPH SHEET
SHEIK: CROST MAILE PWNED KIEFS SHEIK
SHELF: CROST MAILE SKEEF SHELF
SHELL: CROST MAILE SKEEF POWND SHELL
SHIED: CROST MAILE PWNED SKIED SHIED
SHIFT: CROST ALEPH WISHT SHIFT
SHINE: CROST MAILE POWND SEINE SHINE
SHINY: CROST MAILE SPUNK SHINY
SHIRE: CROST SERAI PLIED SHIRE
SHIRK: CROST SERAI HULKS SHIRK
SHIRT: CROST SPIAL NUKED SHIRT
SHOAL: CROST PLANS SHOAL
SHOCK: CROST GULPS HYMEN SHOCK
SHONE: CROST PLANS SHONE
SHOOK: CROST PLANS SKIEY SHOOK
SHOOT: CROST WHUMP PIETA SHOOT
SHORE: CROST SPERM MONTH SHORE
SHORN: CROST SPERM SWORN SHORN
SHORT: CROST PEKAN SHORT
SHOUT: CROST WHUMP SHOUT
SHOVE: CROST PLANS SKIEY SHOVE
SHOWN: CROST PLANS KNOWE SHOWN
SHOWY: CROST PLANS SKIEY SHOWY
SHREW: CROST SERAI HYPED SHREW
SHRUB: CROST SERAI GULFY SHRUB
SHRUG: CROST SERAI GULFY SPRUG SHRUG
SHUCK: CROST KAIES SHUCK
SHUNT: CROST ALEPH WISHT SHUNT
SHUSH: CROST MAILE SYPHS SHUSH
SHYLY: CROST MAILE WHUPS SHYLY
SIEGE: CROST MAILE VODUN SIEGE
SIEVE: CROST MAILE VODUN SIEVE
SIGHT: CROST ALEPH WISHT SIGHT
SIGMA: CROST MAILE SWABS SIGMA
SILKY: CROST MAILE SINKS SILKY
SILLY: CROST MAILE LINKY SILLY
SINCE: CROST KAIES MESIC SINCE
SINEW: CROST MAILE PWNED WINES SINEW
SINGE: CROST MAILE VODUN SINGE
SIREN: CROST SERAI HINDS SIREN
SISSY: CROST MAILE SOPHY SISSY
SIXTH: CROST TEATS BLIMY SIXTH
SIXTY: CROST TEATS BLIMY FISTY SIXTY
SKATE: CROST TEATS FLICK SKATE
SKIER: CROST SERAI PLIED SHIER SKIER
SKIFF: CROST MAILE SPUNK LEADY SKIFF
SKILL: CROST MAILE PHYLA SKILL
SKIMP: CROST MAILE WHUMP SKIMP
SKIRT: CROST SPIAL NUKED SKIRT
SKULK: CROST MAILE WHUPS SKULL SKULK
SKULL: CROST MAILE WHUPS SKULL
SKUNK: CROST MAILE DUNKS SKUNK
SLACK: CROST KAIES WHELM SLACK
SLAIN: CROST MAILE PLANS SLAIN
SLANG: CROST MAILE PUNGS SLANG
SLANT: CROST ALEPH SLANT
SLASH: CROST MAILE SPEKS SLASH
SLATE: CROST TEATS FLICK SLATE
SLAVE: CROST MAILE NUKED SLAVE
SLEEK: CROST MAILE SEEDY WHELP SLEEK
SLEEP: CROST MAILE SEEDY WHELP SLEEP
SLEET: CROST ALEPH SLEET
SLEPT: CROST ALEPH SLEPT
SLICE: CROST KAIES SLICE
SLICK: CROST KAIES PRANG SLICK
SLIDE: CROST MAILE DERVS SLIDE
SLIME: CROST MAILE SLIME
SLIMY: CROST MAILE SPAGS SLIMY
SLING: CROST MAILE SPANG SLING
SLINK: CROST MAILE SPANG SLINK
SLOOP: CROST PLANS SLOPE SLOOP
SLOPE: CROST PLANS SLOPE
SLOSH: CROST WHELK FLOSH SLOSH
SLOTH: CROST PELTS SLOTH
SLUMP: CROST MAILE SLUMP
SLUNG: CROST MAILE SKUGS SLUNG
SLUNK: CROST MAILE SKUGS SLUNK
SLURP: CROST SERAI LUPUS SLURP
SLUSH: CROST MAILE SPIFF SLUSH
SLYLY: CROST MAILE WHUPS SLYLY
SMACK: CROST KAIES WHELM SMACK
SMALL: CROST MAILE SMALL
SMART: CROST SPIAL MAWKS SMART
SMASH: CROST MAILE SMASH
SMEAR: CROST SERAI WHOMP SMEAR
SMELL: CROST MAILE SKELM SMELL
SMELT: CROST ALEPH SMELT
SMILE: CROST MAILE SMILE
SMIRK: CROST SERAI HULKS SKIRR SMIRK
SMITE: CROST TEATS HIPLY NUKED SMITE
SMITH: CROST TEATS BLIMY SMITH
SMOCK: CROST GULPS HYMEN SMOCK
SMOKE: CROST PLANS SKIEY SMOKE
SMOKY: CROST PLANS SKIEY SOOKY SMOKY
SMOTE: CROST PELTS MONTH SMOTE
SNACK: CROST KAIES WHELM SNACK
SNAIL: CROST MAILE PLANS SNAIL
SNAKE: CROST MAILE SPUNK SNAKE
SNAKY: CROST MAILE SPUNK SNAKY
SNARE: CROST SERAI WANEY SNARE
SNARL: CROST SERAI HUNKS LEADY SNARL
SNEAK: CROST MAILE PENDS ASHEN SNEAK
SNEER: CROST SERAI PUKEY WHELM SNEER
SNIDE: CROST MAILE POWND SNIDE
SNIFF: CROST MAILE SPUNK SNIBS SNIFF
SNIPE: CROST MAILE POWND SNIPE
SNOOP: CROST PLANS SNOEP SNOOP
SNORE: CROST SPERM MONTH SNORE
SNORT: CROST PEKAN SNORT
SNOUT: CROST WHUMP STOUT SNOUT
SNOWY: CROST PLANS KNOWE SNOWY
SNUCK: CROST KAIES SHUCK SNUCK
SNUFF: CROST MAILE DUNKS SWUNG SNUFF
SOAPY: CROST NALED SOMAS SOAPY
SOBER: CROST DARES SLING SOWER SOBER
SOGGY: CROST NALED BUMPY SOGGY
SOLAR: CROST DARES LOWAN SOLAR
SOLID: CROST NALED SOLID
SOLVE: CROST NALED SOLVE
SONAR: CROST DARES LOWAN SONAR
SONIC: CROST SOKEN SONIC
SOOTH: CROST PELTS SOOTY SOOTH
SOOTY: CROST PELTS SOOTY
SORRY: CROST DARES SORGO SORRY
SOUND: CROST NALED SOUND
SOUTH: CROST LATTE SUIDS SOUTH
SOWER: CROST DARES SLING SOWER
SPACE: CROST KAIES SCALE SPACE
SPADE: CROST MAILE SPUNK SPADE
SPANK: CROST MAILE SPUNK SPANK
SPARE: CROST SERAI WANEY SHARE SPARE
SPARK: CROST SERAI HUNKS SPARK
SPASM: CROST MAILE SMASH SPASM
SPAWN: CROST MAILE SPUNK SPAWN
SPEAK: CROST MAILE PENDS SPEAK
SPEAR: CROST SERAI WHOMP SPEAR
SPECK: CROST KAIES SNECK SPECK
SPEED: CROST MAILE PENED SPEED
SPELL: CROST MAILE SKEEF POWND SPELL
SPELT: CROST ALEPH SPELT
SPEND: CROST MAILE PENED SPEND
SPENT: CROST ALEPH SPENT
SPERM: CROST SERAI PUKEY SPERM
SPICE: CROST KAIES SLICE SPICE
SPICY: CROST KAIES SPICY
SPIED: CROST MAILE PWNED SPIED
SPIEL: CROST MAILE POUFS SPIEL
SPIKE: CROST MAILE POWND SPIKE
SPIKY: CROST MAILE SPUNK SPIKS SPIKY
SPILL: CROST MAILE PHYLA SPILL
SPILT: CROST ALEPH SPLIT SPILT
SPINE: CROST MAILE POWND SPINE
SPINY: CROST MAILE SPUNK SPINS SPINY
SPIRE: CROST SERAI PLIED SPIRE
SPITE: CROST TEATS HIPLY SPITE
SPLAT: CROST ALEPH SPALT SPLAT
SPLIT: CROST ALEPH SPLIT
SPOIL: CROST PLANS SPOOL SPOIL
SPOKE: CROST PLANS SPOOK SPOKE
SPOOF: CROST PLANS SPOOK SPOOF
SPOOK: CROST PLANS SPOOK
SPOOL: CROST PLANS SPOOL
SPOON: CROST PLANS SNOEP SPOON
SPORE: CROST SPERM SPORE
SPORT: CROST PEKAN SPORT
SPOUT: CROST WHUMP SPOUT
SPRAY: CROST SERAI HUNKY SPRAY
SPREE: CROST SERAI HYPED SPREE
SPRIG: CROST SERAI PILIS SPRIG
SPUNK: CROST MAILE DUNKS SKUNK SPUNK
SPURN: CROST SERAI LUPUS SPURN
SPURT: CROST SPIAL SPURT
SQUAD: CROST MAILE SPUNK WODGE SQUAD
SQUAT: CROST ALEPH SAUNT SQUAT
SQUIB: CROST MAILE DUNKS SQUIB
STACK: CROST HAUTE STACK
STAFF: CROST TEATS FLING STAFF
STAGE: CROST TEATS GLAND STAGE
STAID: CROST TEATS FLING STAID
STAIN: CROST TEATS FLING STAIN
STAIR: CROST TERAI STAIR
STAKE: CROST TEATS GLAND STAVE STAKE
STALE: CROST TEATS GLAND STALE
STALK: CROST TEATS FLING STALL STALK
STALL: CROST TEATS FLING STALL
STAMP: CROST TEATS FLING STAMP
STAND: CROST TEATS FLING STANK STAND
STANK: CROST TEATS FLING STANK
STARE: CROST TERAI ASTER STARE
STARK: CROST TERAI KNUTS STARK
START: CROST SPIAL MAWKS START
STASH: CROST TAMIN STASH
STATE: CROST TEATS STATE
STAVE: CROST TEATS GLAND STAVE
STEAD: CROST TEATS ULNAD STEAD
STEAK: CROST TEATS ULNAD STEAM STEAK
STEAL: CROST TEATS ULNAD STEAL
STEAM: CROST TEATS ULNAD STEAM
STEED: CROST TEATS ELIDE STEED
STEEL: CROST TEATS ELIDE STEEL
STEEP: CROST TEATS ELIDE KEMPS STEEP
STEER: CROST TERAI SEGUE STEER
STEIN: CROST TEATS ELIDE STEIN
STERN: CROST TERAI SEGUE STERN
STICK: CROST HAUTE STICK
STIFF: CROST TEATS FILMY STIFF
STILL: CROST TEATS FILMY STILL
STILT: CROST ALEPH STILT
STING: CROST TEATS FILMY SHTIK STING
STINK: CROST TEATS FILMY SHTIK STINK
STINT: CROST ALEPH STUNT STINT
STOCK: CROST STOIC STOCK
STOIC: CROST STOIC
STOKE: CROST PELTS KAONS STOKE
STOLE: CROST PELTS STOLE
STOMP: CROST PELTS HUMOR STOMP
STONE: CROST PELTS KAONS STONE
STONY: CROST PELTS DANNY STONY
STOOD: CROST PELTS DANNY STOOD
STOOL: CROST PELTS STOLN STOOL
STOOP: CROST PELTS HUMOR STOOP
STORE: CROST YUKES STORE
STORK: CROST YUKES STORK
STORM: CROST YUKES STORM
STORY: CROST YUKES STORY
STOUT: CROST WHUMP STOUT
STOVE: CROST PELTS KAONS STOVE
STRAP: CROST TERAI PAWKY STRAP
STRAW: CROST TERAI PAWKY STRAW
STRAY: CROST TERAI PAWKY STRAY
STRIP: CROST TERAI SMOGS STRIP
STRUT: CROST SPIAL STRUT
STUCK: CROST HAUTE STUCK
STUDY: CROST TEATS FILMY STUDY
STUFF: CROST TEATS FILMY STUFF
STUMP: CROST TEATS FILMY STUMP
STUNG: CROST TEATS FILMY STUNG
STUNK: CROST TEATS FILMY STUNG STUNK
STUNT: CROST ALEPH STUNT
STYLE: CROST TEATS ELIDE STYLE
SUAVE: CROST MAILE SPUNK SUAVE
SUGAR: CROST SERAI SYMAR SUGAR
SUING: CROST MAILE SPUNK SUING
SUITE: CROST TEATS HIPLY NUKED SUITE
SULKY: CROST MAILE SKUGS SULKY
SULLY: CROST MAILE WHUPS SULLY
SUMAC: CROST KAIES DUPLY SUMAC
SUNNY: CROST MAILE DUNKS SUNNY
SUPER: CROST SERAI PUKEY SUPER
SURER: CROST SERAI HYPED SURER
SURGE: CROST SERAI HYPED SURGE
SURLY: CROST SERAI GULFY SURLY
SUSHI: CROST MAILE DUNKS SUSHI
SWAMI: CROST MAILE SWABS SWAMI
SWAMP: CROST MAILE AMAHS SWAMY SWAMP
SWARM: CROST SERAI HUNKS DWALM SWARM
SWASH: CROST MAILE SUNKS SWASH
SWATH: CROST TEATS SWATH
SWEAR: CROST SERAI WHOMP SWEAR
SWEAT: CROST ALEPH SWEAT
SWEEP: CROST MAILE PENED SWEEP
SWEET: CROST ALEPH UNWIT SWEET
SWELL: CROST MAILE SKEEF POWND SWELL
SWEPT: CROST ALEPH STEPT SWEPT
SWIFT: CROST ALEPH STUNT SWIFT
SWILL: CROST MAILE PHYLA SKILL SWILL
SWINE: CROST MAILE POWND SWINE
SWING: CROST MAILE SPUNK SHINY SWING
SWIRL: CROST SERAI HULKS SWIRL
SWISH: CROST MAILE SKEWS SWISH
SWOON: CROST PLANS KNOWE SWOUN SWOON
SWOOP: CROST PLANS SPOOK SWOOP
SWORD: CROST SPERM SWORN SWORD
SWORE: CROST SPERM MONTH SWORE
SWORN: CROST SPERM SWORN
SWUNG: CROST MAILE DUNKS SWUNG
SYNOD: CROST NALED SOUND SYNOD
SYRUP: CROST SERAI GULFY SYRUP
TABBY: CROST TATIE KALAM BONGO TABBY
TABLE: CROST TATIE TAUBE TABLE
TABOO: CROST LATEN TAIKO TABOO
TACIT: CROST HALID TACIT
TACKY: CROST TATIE TALCY TACKY
TAFFY: CROST TATIE KALAM BONGO TAFFY
TAINT: CROST ALIEN TOPHE TAINT
TAKEN: CROST TATIE PADMA TAKEN
TAKER: CROST TATIE DWALM VIBEX TAPER TAKER
TALLY: CROST TATIE KALAM TALLY
TALON: CROST LATEN TALON
TAMER: CROST TATIE DWALM TAMER
TANGO: CROST LATEN TYPTO TANGO
TANGY: CROST TATIE KALAM BONGO TANGY
TAPER: CROST TATIE DWALM VIBEX TAPER
TAPIR: CROST TATIE TAPIR
TARDY: CROST TATIE TAYRA TARDY
TAROT: CROST TERRA TAROT
TASTE: CROST TEATS TASTE
TASTY: CROST TEATS TASTY
TATTY: CROST TATIE TATTY
TAUNT: CROST ALIEN THUDS TAUNT
TAWNY: CROST TATIE KALAM BONGO TAWNY
TEACH: CROST TATIE THECA TEACH
TEARY: CROST TATIE TERRA TEARY
TEASE: CROST TAMIN TEASE
TEDDY: CROST TATIE NEWED TEDDY
TEETH: CROST TATIE TEETH
TEMPO: CROST LATEN WEIGH TEMPO
TENET: CROST ALIEN GUMBO DENET TENET
TENOR: CROST TATER TENOR
TENSE: CROST TAMIN TENSE
TENTH: CROST TATIE TEETH TENTH
TEPEE: CROST TATIE PUNNY TEPEE
TEPID: CROST TATIE TEPID
TERRA: CROST TATIE TERRA
TERSE: CROST TERSE
TESTY: CROST TEATS TESTE TESTY
THANK: CROST TATIE KHAYA THANK
THEFT: CROST ALIEN DUETT THEFT
THEIR: CROST TATIE THEIR
THEME: CROST TATIE PUNNY THEME
THERE: CROST TATIE TERFE THERE
THESE: CROST TAMIN THESP THESE
THETA: CROST TATIE THETA
THICK: CROST TATIE THICK
THIEF: CROST TATIE LIMAN THIEF
THIGH: CROST TATIE LAWNY THIGH
THING: CROST TATIE LAWNY THING
THINK: CROST TATIE LAWNY THING THINK
THIRD: CROST TATIE TWIRL THIRD
THONG: CROST PHYLA DHOTI THONG
THORN: CROST HOONS THORN
THOSE: CROST STOSS THOSE
THREE: CROST TATIE TERFE THREE
THREW: CROST TATIE TWYER THREW
THROB: CROST TATER THROB
THROW: CROST TATER THROB THROW
THRUM: CROST TATIE TURFY THRUM
THUMB: CROST TATIE THUMB
THUMP: CROST TATIE THUMB THUMP
THYME: CROST TATIE PUNNY THYME
TIARA: CROST TATIE TIARA
TIBIA: CROST TATIE TWAIN TIBIA
TIDAL: CROST TATIE HULES TIDAL
TIGER: CROST TATIE DIMLY TIGER
TIGHT: CROST ALIEN BIFID TRUMP TIGHT
TILDE: CROST TATIE THINE TILDE
TIMER: CROST TATIE DIMLY TIMER
TIMID: CROST TATIE NUKED TIMID
TIPSY: CROST TAMIN TULSI TIPSY
TITAN: CROST TATIE TITAN
TITHE: CROST TATIE TITHE
TITLE: CROST TATIE TITHE TITLE
TOAST: CROST HADJI OBELI TOAST
TODAY: CROST LATEN TOKAY TODAY
TODDY: CROST LATEN TUMPY WODGE TODDY
TOKEN: CROST LATEN TOKEN
TONAL: CROST LATEN TONAL
TONGA: CROST LATEN TONKA TONGA
TONIC: CROST POTIN TONIC
TOOTH: CROST PHYLA TOOTH
TOPAZ: CROST LATEN TOKAY TOPAZ
TOPIC: CROST POTIN TOPIC
TORCH: CROST ROTCH TORCH
TORSO: CROST SKEIN TORSO
TORUS: CROST TORTA SURER TORUS
TOTAL: CROST LATEN TOTAL
TOTEM: CROST LATEN DUMPY TOTEM
TOUCH: CROST POTIN TOCKY TOUCH
TOUGH: CROST LATEN TUMPY TOUGH
TOWEL: CROST LATEN TOLED TOWEL
TOWER: CROST TATER PUNKY TOWER
TOXIC: CROST POTIN TOXIC
TOXIN: CROST LATEN TIGON TOXIN
TRACE: CROST AXILE TRACE
TRACK: CROST AXILE TRACK
TRACT: CROST TUBED TRACT
TRADE: CROST PIETA TRAVE TRADE
TRAIL: CROST PIETA SLANG TRAIL
TRAIN: CROST PIETA SLANG TRAIN
TRAIT: CROST APING TRAIT
TRAMP: CROST PIETA TRAMP
TRASH: CROST HULES TRASH
TRAWL: CROST PIETA TALKY TRAWL
TREAD: CROST PIETA TREAD
TREAT: CROST APING KRAFT TREAT
TREND: CROST PIETA TREED TREND
TRIAD: CROST PIETA SLANG TRIAD
TRIAL: CROST PIETA SLANG TRIAL
TRIBE: CROST PIETA NUKED TRIBE
TRICE: CROST AXILE TRICE
TRICK: CROST AXILE TRICK
TRIED: CROST PIETA NUKED TRIED
TRIPE: CROST PIETA TRIPE
TRITE: CROST PIETA TRUMP TRITE
TROLL: CROST TAPEN DROOL TROLL
TROOP: CROST TAPEN TROOP
TROPE: CROST TAPEN TROPE
TROUT: CROST TANGI TROUT
TROVE: CROST TAPEN NUKED TROVE
TRUCE: CROST AXILE TRUCE
TRUCK: CROST AXILE TRUCK
TRUER: CROST PIETA TRYER TRUER
TRULY: CROST PIETA TRULL TRULY
TRUMP: CROST PIETA TRUMP
TRUNK: CROST PIETA TRULL TRUNK
TRUSS: CROST HULES TRUSS
TRUST: CROST TAWIE TRUST
TRUTH: CROST PIETA TRUTH
TRYST: CROST TAWIE TRUST TRYST
TUBAL: CROST TATIE KHAYA TUBAL
TUBER: CROST TATIE TWYER TUBER
TULIP: CROST TATIE NUKED TULIP
TULLE: CROST TATIE PUNNY FLICK TULLE
TUMOR: CROST TATER TUMOR
TUNIC: CROST TATIE TYPIC TUNIC
TURBO: CROST TATER THROB TURBO
TUTOR: CROST TATER TUTOR
TWANG: CROST TATIE KHAYA TWANG
TWEAK: CROST TATIE PIETA TWEAK
TWEED: CROST TATIE NEWED TWEED
TWEET: CROST ALIEN MEWED TWEET
TWICE: CROST TATIE TWICE
TWINE: CROST TATIE THINE TWINE
TWIRL: CROST TATIE TWIRL
TWIST: CROST WEIGH TWIST
TWIXT: CROST ALIEN WHIFT TWIXT
TYING: CROST TATIE LAWNY TYING
UDDER: CROST RARED ENDUE UDDER
ULCER: CROST AIRER PUCER ULCER
ULTRA: CROST TATIE ANTRA ULTRA
UMBRA: CROST RARED LINUM UMBRA
UNCLE: CROST LIANE UNCLE
UNCUT: CROST HALID EJECT UNCUT
UNDER: CROST RARED ENDUE UNDER
UNDID: CROST LIANE CUPID BAUKS UNDID
UNDUE: CROST LIANE DEGUM UNDUE
UNFED: CROST LIANE WEEDY BUCKO UNFED
UNFIT: CROST ALIEN UNWIT UNFIT
UNIFY: CROST LIANE CUPID UNIFY
UNION: CROST LADEN PIGMY INURN UNION
UNITE: CROST TATIE BUHLS UNITE
UNITY: CROST TATIE FILMY UNITY
UNLIT: CROST ALIEN UNLIT
UNMET: CROST ALIEN GUMBO UNMET
UNSET: CROST ALEPH UNSET
UNTIE: CROST TATIE UNTIE
UNTIL: CROST TATIE INTIL UNTIL
UNWED: CROST LIANE WEEDY UNWED
UNZIP: CROST LIANE CUPID UNZIP
UPPER: CROST RARED PLING UPPER
UPSET: CROST ALEPH UPSET
URBAN: CROST ABIDE WONKY URBAN
URINE: CROST ABIDE GUIMP URINE
USAGE: CROST MAILE SPUNK USAGE
USHER: CROST SERAI RULED USHER
USING: CROST MAILE SPUNK USING
USUAL: CROST MAILE PUNGS USUAL
USURP: CROST SERAI BUNDY USURP
UTILE: CROST TATIE BUHLS UTILE
UTTER: CROST TATIE UTTER
VAGUE: CROST LIANE GUMBO VAGUE
VALET: CROST ALIEN VALET
VALID: CROST LIANE HALAL KALIF VALID
VALOR: CROST RARED VINYL VALOR
VALUE: CROST LIANE BADLY VALUE
VALVE: CROST LIANE BADLY VALUE VALVE
VAPID: CROST LIANE PADMA VAPID
VAPOR: CROST RARED VINYL VAPOR
VAULT: CROST ALIEN FAUGH VAULT
VAUNT: CROST ALIEN THUDS GALVO VAUNT
VEGAN: CROST LIANE MANED VEGAN
VENOM: CROST LADEN PENNI GENOM VENOM
VENUE: CROST LIANE DEGUM VENUE
VERGE: CROST RARED LINGY TRUMP VERGE
VERSE: CROST HERMA PERSE VERSE
VERSO: CROST DEGUM VERSO
VERVE: CROST RARED LINGY KEMPS VERVE
VICAR: CROST AIRER VICAR
VIDEO: CROST LADEN PROMO VIDEO
VIGIL: CROST LIANE GHYLL VIGIL
VIGOR: CROST RARED MINGY VIGOR
VILLA: CROST LIANE PULIK ZILLA VILLA
VINYL: CROST LIANE NIHIL VINYL
VIOLA: CROST ELAND VIOLA
VIPER: CROST RARED PLING WIPER VIPER
VIRAL: CROST RARED PILUM VIRAL
VIRUS: CROST SERAI BULKY VIRUS
VISIT: CROST ALEPH STUNT VISIT
VISOR: CROST DARES ROSHI VISOR
VISTA: CROST TEATS SPINA VISTA
VITAL: CROST TATIE DITAL VITAL
VIVID: CROST LIANE PYGMY KIBBI VIVID
VIXEN: CROST LIANE PWNED VIXEN
VOCAL: CROST LANCH VOCAL
VODKA: CROST LADEN SIDHA VODKA
VOGUE: CROST LADEN BEIGE VOGUE
VOICE: CROST LANCH OBELI VOICE
VOILA: CROST LADEN GLIAL VOILA
VOMIT: CROST GIBEL NOOPS VOMIT
VOTER: CROST TATER FONDU VOTER
VOUCH: CROST LANCH PYGMY VOUCH
VOWEL: CROST LADEN VUGHY VOXEL VOWEL
VYING: CROST LIANE DANNY HYING VYING
WACKY: CROST LIANE MUCKY WACKY
WAFER: CROST RARED GLYPH WAKFS WAFER
WAGER: CROST RARED GLYPH JEWEL WAGER
WAGON: CROST LADEN GENIP WAGON
WAIST: CROST WEIGH WAIST
WAIVE: CROST LIANE ADMIX BAIZE WAIVE
WALTZ: CROST TATIE BYLAW WALTZ
WARTY: CROST TATIE AWAYS WARTY
WASTE: CROST TEATS UPBOW WASTE
WATCH: CROST TATIE PLONG WEMBS WATCH
WATER: CROST TATIE LEMED WHELP WATER
WAVER: CROST RARED GLYPH WAKFS WAXER WAVER
WAXEN: CROST LIANE MANED WHELK WAXEN
WEARY: CROST RARED BELAY WEARY
WEAVE: CROST LIANE WEDGY WEAVE
WEDGE: CROST LIANE DUMPY HOKKU WEDGE
WEEDY: CROST LIANE DUMKY HEEDY WEEDY
WEIGH: CROST LIANE MEWED WEIGH
WEIRD: CROST RARED WEIRD
WELCH: CROST LIANE BEEFS WELCH
WELSH: CROST MAILE FLESH WELSH
WENCH: CROST LIANE HOWDY WENCH
WHACK: CROST LIANE HOKKU WHACK
WHALE: CROST LIANE DEBUG WHELM WHALE
WHARF: CROST RARED LINUM APGAR WHARF
WHEAT: CROST ALIEN PEAGE WHEAT
WHEEL: CROST LIANE DEBEL EXPEL WHEEL
WHELP: CROST LIANE DEBEL PROMO WHELP
WHERE: CROST RARED VENUE FIERE WHERE
WHICH: CROST LIANE YUCCH WHICH
WHIFF: CROST LIANE MUMPS WHIFF
WHILE: CROST LIANE DULLY WHILE
WHINE: CROST LIANE DWAUM WHINE
WHINY: CROST LIANE DANNY WHINY
WHIRL: CROST RARED KNURL WHIRL
WHISK: CROST MAILE SKEWS WHISK
WHITE: CROST TATIE BUHLS WHITE
WHOLE: CROST ELAND LOOEY WHOLE
WHOOP: CROST ELAND BUMPH WHOOP
WHOSE: CROST WHELK WHOSE
WIDEN: CROST LIANE PWNED WIDEN
WIDER: CROST RARED ENDUE CHAWS WIDER
WIDOW: CROST LADEN VODDY WIDOW
WIDTH: CROST TATIE FILMY NINTH WIDTH
WIELD: CROST LIANE GYBED FIELD WIELD
WIGHT: CROST ALIEN BIFID TRUMP HOKKU WIGHT
WILLY: CROST LIANE GHYLL BAWDS WILLY
WIMPY: CROST LIANE PYGMY JIMPY WIMPY
WINCE: CROST LIANE WHELM WINCE
WINCH: CROST LIANE HAFIZ GETUP WINCH
WINDY: CROST LIANE KINDY WINDY
WISER: CROST SERAI LIMEN SPUDS RISER WISER
WISPY: CROST MAILE DUNKS WISPY
WITCH: CROST TATIE WODGE WITCH
WITTY: CROST TATIE NUKED WITTY
WOKEN: CROST LADEN MAWKS WOKEN
WOMAN: CROST LADEN BOGEY WOMAN
WOMEN: CROST LADEN MAWKS WOMEN
WOODY: CROST ELAND DUMBO WHEFT WOODY
WOOER: CROST HEARD WOOER
WOOLY: CROST ELAND OBOLI WHELM WOOLY
WOOZY: CROST ELAND BUMPH GOWFS WOOZY
WORDY: CROST RARED MOLDY WORDY
WORLD: CROST RARED WORLD
WORRY: CROST RARED SULFO WORRY
WORSE: CROST DEGUM WORSE
WORST: CROST RAHUI WORST
WORTH: CROST TATER FORBY WORTH
WOULD: CROST LADEN GOYIM WOULD
WOUND: CROST LADEN GUNKY WHOMP WOUND
WOVEN: CROST LADEN MAWKS WOXEN WOVEN
WRACK: CROST ABIDE FRANC WRACK
WRATH: CROST PIETA WRATH
WREAK: CROST ABIDE FREAK WREAK
WRECK: CROST ABIDE WRECK
WREST: CROST TAWIE WREST
WRING: CROST ABIDE FLUMP IRING WRING
WRIST: CROST TAWIE WRIST
WRITE: CROST PIETA TRUMP WRITE
WRONG: CROST PIEND KRONA WRONG
WROTE: CROST TAPEN WROTE
WRUNG: CROST ABIDE GRUMP WRUNG
WRYLY: CROST ABIDE GRUMP WRYLY
YACHT: CROST HALID YACHT
YEARN: CROST RARED BELAY YEARN
YEAST: CROST WEIGH BLADY YEAST
YIELD: CROST LIANE GYBED YIELD
YOUNG: CROST LADEN GUIMP YOUNG
YOUTH: CROST LATEN TUMPY YOUTH
ZEBRA: CROST RARED BELAY ZEBRA
ZESTY: CROST TEATS TYIYN TOPAZ ZESTY
ZONAL: CROST LADEN NOPAL MONAL ZONAL
Success: 2315
Fail: 0
Avg guess: 3.956
