ABACK: CROST LANCE KIACK QUACK ABACK
ABASE: CROST SALSE AMUSE ANISE ABASE
ABATE: CROST TATIE ALATE AGATE ABATE
ABBEY: CROST LIANE WAMED ABBEY
ABBOT: CROST BIGOT ABBOT
ABHOR: CROST MOREL RAYON ABHOR
ABIDE: CROST LIANE MAVIE AZIDE ABIDE
ABLED: CROST LIANE ABLED
ABODE: CROST DOOLE EPODE ANODE ABODE
ABORT: CROST APORT AMORT ABORT
ABOUT: CROST AFOOT AMOWT ADOPT ABOUT
ABOVE: CROST DOOLE GNOME EVOKE ABOVE
ABUSE: CROST SALSE AMUSE ABUSE
ABYSS: CROST SALSE AMISS ABYSS
ACORN: CROST ACORN
ACRID: CROST RACED ACRID
ACTOR: CROST ROTCH ACTOR
ACUTE: CROST TACHE ACUTE
ADAGE: CROST LIANE AGAVE APAGE ADAGE
ADAPT: CROST LEANT AWAIT AMAUT ABAFT ADAPT
ADEPT: CROST LEANT WHEAT ADEPT
ADMIN: CROST LIANE MANIA ADMIN
ADMIT: CROST LEANT GAMUT ADMIT
ADOBE: CROST DOOLE EPODE ADOBE
ADOPT: CROST AFOOT AMOWT ADOPT
ADORE: CROST ADORE
ADORN: CROST ADORE ADORN
ADULT: CROST LEANT HAULT ADULT
AFFIX: CROST LIANE ZAMIA APHID AFFIX
AFIRE: CROST RARED LEARY AFIRE
AFOOT: CROST AFOOT
AFOUL: CROST DOOLE ALONG ABOIL AFOUL
AFTER: CROST TERAI RATEL APTER AFTER
AGAIN: CROST LIANE AGAIN
AGAPE: CROST LIANE AGAVE AGAPE
AGATE: CROST TATIE ALATE AGATE
AGENT: CROST LEANT AMENT AHENT ANENT AGENT
AGILE: CROST LIANE ALIKE AGILE
AGING: CROST LIANE AXING APING AKING AGING
AGLOW: CROST LODEN GALOP AGLOW
AGONY: CROST DOOLE ANOMY AGONY
AGORA: CROST ADORE AWORK AGORA
AGREE: CROST RARED AUREI AGREE
AHEAD: CROST LIANE WAMED JEHAD AHEAD
AIDER: CROST RARED AIDER
AISLE: CROST LANES PEALS AISLE
ALARM: CROST RARED UNARM ALARM
ALBUM: CROST LIANE PALAY ALGUM ALBUM
ALERT: CROST RELIT ALERT
ALGAE: CROST LIANE GABLE ALGAE
ALIBI: CROST LIANE ALGID ALIYA ALIBI
ALIEN: CROST LIANE ALIEN
ALIGN: CROST LIANE ANILS ALIGN
ALIKE: CROST LIANE ALIKE
ALIVE: CROST LIANE ALIKE ALIVE
ALLAY: CROST LIANE PALAY ALLAY
ALLEY: CROST LIANE ABLED ALLEY
ALLOT: CROST BIGOT DEPOT ALLOT
ALLOW: CROST LODEN GALOP ALLOW
ALLOY: CROST LODEN GALOP ALLOW ALLOY
ALOFT: CROST AFOOT ALOFT
ALONE: CROST DOOLE GLOBE ALOWE ALONE
ALONG: CROST DOOLE ALONG
ALOOF: CROST DOOLE PLOOK BLOOM ALOOF
ALOUD: CROST DOOLE BLOND ALOUD
ALPHA: CROST LIANE PALAY ALPHA
ALTAR: CROST TERAI RATAL ALTAR
ALTER: CROST TERAI RATEL ALTER
AMASS: CROST SALSE AMISS AMASS
AMAZE: CROST LIANE AGAVE AMAZE
AMBER: CROST RARED ANGER AMBER
AMBLE: CROST LIANE GABLE AMBLE
AMEND: CROST LIANE HENNA AMEND
AMISS: CROST SALSE AMISS
AMITY: CROST TATIE AGITA AMITY
AMONG: CROST DOOLE ANOMY AMONG
AMPLE: CROST LIANE GABLE APPLE AMPLE
AMPLY: CROST LIANE PALAY APPLY AMPLY
AMUSE: CROST SALSE AMUSE
ANGEL: CROST LIANE VENAL ANGEL
ANGER: CROST RARED ANGER
ANGLE: CROST LIANE ANELE ANKLE ANGLE
ANGRY: CROST RARED UNARM ANGRY
ANGST: CROST GEIST AGAST ANGST
ANIME: CROST LIANE NAIVE ANIME
ANKLE: CROST LIANE ANELE ANKLE
ANNEX: CROST LIANE MANED ANNEX
ANNOY: CROST LODEN MANGO ANNOY
ANNUL: CROST LIANE UNLAY ANNUL
ANODE: CROST DOOLE EPODE ANODE
ANTIC: CROST TACHE ATTIC ANTIC
ANVIL: CROST LIANE ANILS ANVIL
AORTA: CROST TOTER PORTY FORTH AORTA
APART: CROST RELIT TURNT APART
APHID: CROST LIANE ZAMIA APHID
APING: CROST LIANE AXING APING
APNEA: CROST LIANE MANED ANNEX APNEA
APPLE: CROST LIANE GABLE APPLE
APPLY: CROST LIANE PALAY APPLY
APRON: CROST MOREL BURRO PIROG APRON
APTLY: CROST TATIE UNTAX APTLY
ARBOR: CROST PREON ARMOR ARBOR
ARDOR: CROST PREON ARMOR ARBOR ARDOR
ARENA: CROST BREAD FRENA ARENA
ARGUE: CROST BREAD GRAME ARGUE
ARISE: CROST PRASE ARISE
ARMOR: CROST PREON ARMOR
AROMA: CROST DRONE GROOM AROMA
AROSE: CROST PROSE EROSE AROSE
ARRAY: CROST BREAD ARGAL ARRAY
ARROW: CROST PREON ARMOR ARROZ ARROW
ARSON: CROST ARSON
ARTSY: CROST TRASH ARTSY
ASCOT: CROST ESCOT ASCOT
ASHEN: CROST LANES ASHEN
ASIDE: CROST LANES SEPAD ASIDE
ASKEW: CROST LANES ASKED ASKEW
ASSAY: CROST LANES SHAMA ASSAY
ASSET: CROST SALET ASHET ASSET
ATOLL: CROST ZLOTE ATOLL
ATONE: CROST ZLOTE ATONE
ATTIC: CROST TACHE ATTIC
AUDIO: CROST LODEN AUDIO
AUDIT: CROST LEANT GAMUT AUDIT
AUGUR: CROST RARED UNARM AUGUR
AUNTY: CROST TATIE ANATA AUNTY
AVAIL: CROST LIANE FLAIL QUAIL AVAIL
AVERT: CROST RELIT EVERT AVERT
AVIAN: CROST LIANE MANIA AVIAN
AVOID: CROST DOOLE PYOID AXOID AVOID
AWAIT: CROST LEANT AWAIT
AWAKE: CROST LIANE AGAVE AMAZE AWAKE
AWARD: CROST RARED LIARD AWARD
AWARE: CROST RARED LEARY WHARE AWARE
AWASH: CROST SALSE AGISM AWASH
AWFUL: CROST LIANE PALAY ALGUM AWFUL
AWOKE: CROST DOOLE GNOME EVOKE AWOKE
AXIAL: CROST LIANE ALGID AXIAL
AXIOM: CROST LODEN GAMBO MIAOW AXIOM
AXION: CROST LODEN ANION AVION AXION
AZURE: CROST RARED LEARY AFIRE AZURE
BACON: CROST LOCIE BACON
BADGE: CROST LIANE MADGE GADGE BADGE
BADLY: CROST LIANE PALAY MADLY BADLY
BAGEL: CROST LIANE ABLED BABEL BAGEL
BAGGY: CROST LIANE GAMBA BAGGY
BAKER: CROST RARED LAGER VAPER FAKER WAKER
BALER: CROST RARED LAGER PALER WALER BALER
BALMY: CROST LIANE PALAY BALLY BALDY BALMY
BANAL: CROST LIANE UNLAY FANAL BANAL
BANJO: CROST LODEN MANGO BANJO
BARGE: CROST RARED GARBE BARGE
BARON: CROST MOREL BURRO BARON
BASAL: CROST LANES SALAL VASAL BASAL
BASIC: CROST SAICE BASIC
BASIL: CROST LANES SALAL BASIL
BASIN: CROST LANES BASAN BASIN
BASIS: CROST LANES MAIKS GADIS BASIS
BASTE: CROST TEATS PASTE HASTE WASTE BASTE
BATCH: CROST TACHE BATCH
BATHE: CROST TATIE LATHE BATHE
BATON: CROST TONEY PUTON BATON
BATTY: CROST TATIE FATTY PATTY BATTY
BAWDY: CROST LIANE GAMBA BADDY BAWDY
BAYOU: CROST LODEN GAMBO BAYOU
BEACH: CROST LANCE BEACH
BEADY: CROST LIANE BEADY
BEARD: CROST RARED HEARD YEARD BEARD
BEAST: CROST GEIST FEAST YEAST LEAST BEAST
BEECH: CROST LANCE CLECK BEECH
BEEFY: CROST LIANE DEGUM BEZEL BEEFY
BEFIT: CROST LEANT DEBIT BEFIT
BEGAN: CROST LIANE MANED VEGAN BEGAN
BEGAT: CROST LEANT BEPAT BEGAT
BEGET: CROST LEANT DEBIT BEWET BEGET
BEGIN: CROST LIANE GENIP BEGIN
BEGUN: CROST LIANE NEEDY BEGUN
BEING: CROST LIANE MEINY BEING
BELCH: CROST LANCE BLECH BELCH
BELIE: CROST LIANE ELIDE BELIE
BELLE: CROST LIANE GLEBE BELLE
BELLY: CROST LIANE DEBEL BELLY
BELOW: CROST LODEN OLLIE BELOW
BENCH: CROST LANCE WENCH HENCH BENCH
BERET: CROST RELIT PEART BERET
BERRY: CROST RARED KURRE FERRY BERRY
BERTH: CROST TERAI BERTH
BESET: CROST SALET UNSET BESET
BETEL: CROST TATIE BUTLE BETEL
BEVEL: CROST LIANE DEBEL BEZEL BEVEL
BEZEL: CROST LIANE DEBEL BEZEL
BIBLE: CROST LIANE MILLE BIBLE
BICEP: CROST LANCE DICEY BICEP
BIDDY: CROST LIANE MIDGY WIDDY BIDDY
BIGOT: CROST BIGOT
BILGE: CROST LIANE MILLE BILGE
BILLY: CROST LIANE GILLY DILLY WILLY BILLY
BINGE: CROST LIANE WINGE DINGE GINGE MINGE
BINGO: CROST LODEN MANGO JINGO PINGO BINGO
BIOME: CROST DOOLE GNOME EXOME BIOME
BIRCH: CROST RACED LURCH BIRCH
BIRTH: CROST TERAI YIRTH GIRTH FIRTH MIRTH
BISON: CROST NOLES BISON
BITTY: CROST TATIE DITTY WITTY NITTY BITTY
BLACK: CROST LANCE FLACK PLACK ALACK BLACK
BLADE: CROST LIANE GLADE BLADE
BLAME: CROST LIANE GLADE FLAME BLAME
BLAND: CROST LIANE KLANG BLAND
BLANK: CROST LIANE KLANG BLANK
BLARE: CROST RARED LEARY GLARE FLARE BLARE
BLAST: CROST GEIST HADST BLAST
BLAZE: CROST LIANE GLADE FLAME BLAZE
BLEAK: CROST LIANE ABLED GLEBA BLEAK
BLEAT: CROST LEANT ABLET BLEAT
BLEED: CROST LIANE DEBEL BLEED
BLEEP: CROST LIANE DEBEL BLEEP
BLEND: CROST LIANE BLEND
BLESS: CROST SALSE BLESS
BLIMP: CROST LIANE PUGIL FLIMP BLIMP
BLIND: CROST LIANE BLING BLINY BLIND
BLINK: CROST LIANE BLING BLINY BLIND BLINI
BLISS: CROST SALSE BLISS
BLITZ: CROST TATIE MILTY BLITZ
BLOAT: CROST AFOOT GLOAT PLOAT BLOAT
BLOCK: CROST PHOCA BLOCK
BLOKE: CROST DOOLE GLOBE BLOKE
BLOND: CROST DOOLE BLOND
BLOOD: CROST DOOLE FLOOD BLOOD
BLOOM: CROST DOOLE PLOOK BLOOM
BLOWN: CROST DOOLE ALONG FLOWN BLOWN
BLUER: CROST RARED LIVER FLYER GLUER BLUER
BLUFF: CROST LIANE GULPY FLUFF BLUFF
BLUNT: CROST LEANT FLINT BLUNT
BLURB: CROST RARED KNURL BLURB
BLURT: CROST RELIT BLART BLURT
BLUSH: CROST SALSE FLISK PLUSH BLUSH
BOARD: CROST MOREL BOARD
BOAST: CROST JOIST HOAST TOAST LOAST BOAST
BOBBY: CROST LODEN GOMPA BOUSY BOBBY
BONEY: CROST LODEN HONEY BONEY
BONGO: CROST LODEN GONIA PONGY BONGO
BONUS: CROST NOLES DONGS MONKS YONIS BONUS
BOOBY: CROST DOOLE GOOBY BOOBY
BOOST: CROST GHOST YTOST BOOST
BOOTH: CROST ZLOTE BOOTH
BOOTY: CROST ZLOTE BOOTH BOOTY
BOOZE: CROST DOOLE MOOVE BOOZE
BOOZY: CROST DOOLE GOOBY BOOAY BOOKY BOOMY
BORAX: CROST MOREL BORNA BORAX
BORNE: CROST MOREL GORED RORIE FORZE BORNE
BOSOM: CROST NOLES SOPHY DOSAI BOSOM
BOSSY: CROST SOUSE MOSSY BOSSY
BOTCH: CROST TONIC GOTCH HOTCH BOTCH
BOUGH: CROST LODEN GOMPA BOGGY BOUGH
BOULE: CROST LODEN FOGLE BOULE
BOUND: CROST LODEN DOWNA HOUND FOUND MOUND
BOWEL: CROST LODEN HOLEY VOXEL BOWEL
BOXER: CROST MOREL ROWED HONER FOYER JOKER
BRACE: CROST BRACE
BRAID: CROST BREAD BRAID
BRAIN: CROST BREAD BRAIN
BRAKE: CROST BREAD BRANE BRAVE BRAZE BRAKE
BRAND: CROST BREAD BRAID BRAND
BRASH: CROST PRASE BRASH
BRASS: CROST PRASE BRASH BRASS
BRAVE: CROST BREAD BRANE BRAVE
BRAVO: CROST PREON ORIBI BRAVO
BRAWL: CROST BREAD BRAIN BRAXY BRAZA BRAWL
BRAWN: CROST BREAD BRAIN BRAWN
BREAD: CROST BREAD
BREAK: CROST BREAD BREAK
BREED: CROST BREAD BREED
BRIAR: CROST BREAD BRAAI BRIAR
BRIBE: CROST BREAD BRIZE BRINE BRIBE
BRICK: CROST BRACE BRICK
BRIDE: CROST BREAD BRIDE
BRIEF: CROST BREAD BRIZE BRIER BRIEF
BRINE: CROST BREAD BRIZE BRINE
BRING: CROST BREAD BRINK BRING
BRINK: CROST BREAD BRINK
BRINY: CROST BREAD BRINK BRING BRINY
BRISK: CROST PRASE BRUSK BRISK
BROAD: CROST DRONE BROAD
BROIL: CROST DRONE GROOM PROWL BROIL
BROKE: CROST DRONE PROKE BROKE
BROOD: CROST DRONE BROAD BROOD
BROOK: CROST DRONE GROOM BROOL BROOK
BROOM: CROST DRONE GROOM VROOM BROOM
BROTH: CROST TROPE BROTH
BROWN: CROST DRONE GROWN FROWN BROWN
BRUNT: CROST PRATT BRUIT BRUNT
BRUSH: CROST PRASE BRUSK BRUSH
BRUTE: CROST IRATE BRUTE
BUDDY: CROST LIANE PYGMY BUFFY BUBBY BUDDY
BUDGE: CROST LIANE DEEVE MUDGE PUDGE FUDGE
BUGGY: CROST LIANE PYGMY VUGHY FUGGY BUGGY
BUGLE: CROST LIANE GLEBE BUGLE
BUILD: CROST LIANE PUGIL BUILD
BUILT: CROST LEANT GUILT QUILT BUILT
BULGE: CROST LIANE GLEBE BUGLE BULGE
BULKY: CROST LIANE GULPY BULKY
BULLY: CROST LIANE GULPY BULKY BULLY
BUNCH: CROST LANCE PINCH DUNCH HUNCH BUNCH
BUNNY: CROST LIANE FLUNG POUND BUNNY
BURLY: CROST RARED LURGI HURLY MURLY BURLY
BURNT: CROST RELIT TURNT BURNT
BURST: CROST EARST WURST HURST BURST
BUSED: CROST LANES SPEED BUSED
BUSHY: CROST LANES HUSKY GUSHY PUSHY BUSHY
BUTCH: CROST TACHE DITCH HUTCH KUTCH MUTCH
BUTTE: CROST TATIE BUTTE
BUXOM: CROST LODEN GAMBO BUXOM
BUYER: CROST RARED LIVER HEWER UMBER BUYER
BYLAW: CROST LIANE PALAY BYLAW
CABAL: CROST CAPLE CALIX CANAL CABAL
CABBY: CROST CAPLE CANDY CABBY
CABIN: CROST CAPLE CANDY CAMAN CABIN
CABLE: CROST CAPLE CABLE
CACAO: CROST CONEY CHACO CACAO
CACHE: CROST CAPLE CADIE CACHE
CACTI: CROST CUTIE CACTI
CADDY: CROST CAPLE CANDY CADDY
CADET: CROST CLAPT CADET
CAGEY: CROST CAPLE CAGED CAGEY
CAIRN: CROST CARER CAPRI CAIRN
CAMEL: CROST CAPLE CAMEL
CAMEO: CROST CONEY CAMEO
CANAL: CROST CAPLE CALIX CANAL
CANDY: CROST CAPLE CANDY
CANNY: CROST CAPLE CANDY CANNY
CANOE: CROST CONEY CANOE
CANON: CROST CONEY CANON
CAPER: CROST CARER CABER CAVER CAPER
CAPUT: CROST CLAPT CAPUT
CARAT: CROST CARET CARAT
CARGO: CROST CORBE CAROL CARGO
CAROL: CROST CORBE CAROL
CARRY: CROST CARER CARRY
CARVE: CROST CARER CARLE CARVE
CASTE: CROST CESTA CASTE
CATCH: CROST CUTIE CATCH
CATER: CROST CARTA CATER
CATTY: CROST CUTIE CATCH CATTY
CAULK: CROST CAPLE CAULK
CAUSE: CROST CHASE CAESE CAUSE
CAVIL: CROST CAPLE CALIX CAVIL
CEASE: CROST CHASE CEASE
CEDAR: CROST CARER CEDAR
CELLO: CROST CONEY CELLO
CHAFE: CROST CAPLE CHAVE CHACE CHAFE
CHAFF: CROST CAPLE CHANK CHAYA CHAFF
CHAIN: CROST CAPLE CHANK CHAIN
CHAIR: CROST CARER CIMAR CHAIR
CHALK: CROST CAPLE CHALK
CHAMP: CROST CAPLE CHAMP
CHANT: CROST CLAPT CHAFT CHANT
CHAOS: CROST COLES CAPOS CHAOS
CHARD: CROST CARER CARDY CHARD
CHARM: CROST CARER CARDY CHARA CHARM
CHART: CROST CARET CLART CHART
CHASE: CROST CHASE
CHASM: CROST CHASE CHASM
CHEAP: CROST CAPLE CHEAP
CHEAT: CROST CLAPT CADET CHEAT
CHECK: CROST CAPLE CUBED CHEWY CHECK
CHEEK: CROST CAPLE CUBED CIMEX CHEEK
CHEER: CROST CARER CYDER CUBER CHEER
CHESS: CROST CHASE CHESS
CHEST: CROST CLAST CHEST
CHICK: CROST CAPLE CINCH CHICK
CHIDE: CROST CAPLE CHIVE CHIME CHINE CHIDE
CHIEF: CROST CAPLE CUBED CIMEX CHIEF
CHILD: CROST CAPLE CELLI CHILD
CHILI: CROST CAPLE CELLI CHILI
CHILL: CROST CAPLE CELLI CHILL
CHIME: CROST CAPLE CHIVE CHIME
CHINA: CROST CAPLE CHANK CHINA
CHIRP: CROST CARER CRUMP CHIRP
CHOCK: CROST CHOOK CHOWK CHOCK
CHOIR: CROST CHORE CHOIR
CHOKE: CROST CHOOK CHOKE
CHORD: CROST CHORE CHORD
CHORE: CROST CHORE
CHOSE: CROST CLOSE CHOSE
CHUCK: CROST CAPLE CINCH CHUCK
CHUMP: CROST CAPLE CHIMP CHUMP
CHUNK: CROST CAPLE CINCH CHYND CHUNK
CHURN: CROST CARER CRUMP CHURN
CHUTE: CROST CUTIE CHUTE
CIDER: CROST CARER CYDER CIDER
CIGAR: CROST CARER CIMAR CIGAR
CINCH: CROST CAPLE CINCH
CIRCA: CROST CARER CURIA CIRCA
CIVIC: CROST CAPLE CINCH CIVIC
CIVIL: CROST CAPLE CLUNK CYLIX CIVIL
CLACK: CROST CAPLE CLACK
CLAIM: CROST CAPLE CLACK CLAVI CLAIM
CLAMP: CROST CAPLE CULPA CLAMP
CLANG: CROST CAPLE CLACK CLAVI CLANG
CLANK: CROST CAPLE CLACK CLANK
CLASH: CROST CHASE CLASH
CLASP: CROST CHASE CLASS CLASP
CLASS: CROST CHASE CLASS
CLEAN: CROST CAPLE CLEAN
CLEAR: CROST CARER CEDAR CLEAR
CLEAT: CROST CLAPT CLEAT
CLEFT: CROST CLAPT CLEFT
CLERK: CROST CARER CLERK
CLICK: CROST CAPLE CLUNK CLICK
CLIFF: CROST CAPLE CLUNK CLIFF
CLIMB: CROST CAPLE CLUNK CLIFF CLIMB
CLING: CROST CAPLE CLUNK CLING
CLINK: CROST CAPLE CLUNK CLINK
CLOAK: CROST CHOOK CLOCK CLONK CLOAK
CLOCK: CROST CHOOK CLOCK
CLONE: CROST CHOOK CROME CLOZE CLOYE CLOVE
CLOSE: CROST CLOSE
CLOTH: CROST CHOTA CLOTH
CLOUD: CROST CHOOK CROME CROWD CLOUD
CLOUT: CROST CLOUT
CLOVE: CROST CHOOK CROME CLOZE CLOYE CLOVE
CLOWN: CROST CHOOK CROME CROWD CLOWN
CLUCK: CROST CAPLE CLUNK CLUCK
CLUED: CROST CAPLE CLUED
CLUMP: CROST CAPLE CLUMP
CLUNG: CROST CAPLE CLUNK CLUNG
COACH: CROST CONEY COCOA COACH
COAST: CROST COAST
COBRA: CROST CORBE COARB COBRA
COCOA: CROST CONEY COCOA
COLON: CROST CONEY COLIN COLON
COLOR: CROST CORBE COURD COLOR
COMET: CROST COMPT COMET
COMFY: CROST CONEY COALY COMBY COMMY COMFY
COMIC: CROST CONEY COCOA COMIC
COMMA: CROST CONEY COCOA COLZA COBIA COMMA
CONCH: CROST CONEY CONGO CONCH
CONDO: CROST CONEY CONGO CONDO
CONIC: CROST CONEY CONGO CONCH CONIC
COPSE: CROST COPSE
CORAL: CROST CORBE CORNI CORAM CORAL
CORER: CROST CORBE CORED COREY CORER
CORNY: CROST CORBE CORNI CORNU CORNO CORNY
COUCH: CROST CONEY COCOA COMIC COUCH
COUGH: CROST CONEY COCOA COMBI COUGH
COULD: CROST CONEY COCOA COMBI COUGH COULD
COUNT: CROST COMPT COVET COACT COUNT
COUPE: CROST CONEY COGUE COUDE COUPE
COURT: CROST COURT
COVEN: CROST CONEY COHEN COVEN
COVER: CROST CORBE COMER COWER COPER COVER
COVET: CROST COMPT COVET
COVEY: CROST CONEY COLEY COVEY
COWER: CROST CORBE COMER COWER
COYLY: CROST CONEY COALY COLLY COYLY
CRACK: CROST CRAPE CRAIC CRACK
CRAFT: CROST CREPT CRUFT CRAFT
CRAMP: CROST CRAPE CRAMP
CRANE: CROST CRAPE CRAZE CRAVE CRAKE CRANE
CRANK: CROST CRAPE CRAIC CRAAL CRAZY CRANK
CRASH: CROST CRUSE CRASH
CRASS: CROST CRUSE CRASH CRASS
CRATE: CROST CRITH CRATE
CRAVE: CROST CRAPE CRAZE CRAVE
CRAWL: CROST CRAPE CRAIC CRAAL CRAWL
CRAZE: CROST CRAPE CRAZE
CRAZY: CROST CRAPE CRAIC CRAAL CRAZY
CREAK: CROST CRAPE CREAM CREAK
CREAM: CROST CRAPE CREAM
CREDO: CROST CRUOR CREDO
CREED: CROST CRAPE CREEL CREEK CREED
CREEK: CROST CRAPE CREEL CREEK
CREEP: CROST CRAPE CREEP
CREME: CROST CRAPE CREME
CREPE: CROST CRAPE CRIPE CREPE
CREPT: CROST CREPT
CRESS: CROST CRUSE CRESS
CREST: CROST CRUST CREST
CRICK: CROST CRAPE CRUCK CRICK
CRIED: CROST CRAPE CREEL CRIED
CRIER: CROST CRAPE CREEL CRIED CRIER
CRIME: CROST CRAPE CREME CRIME
CRIMP: CROST CRAPE CRIMP
CRISP: CROST CRUSE CRASH CRISP
CROAK: CROST CRONK CROOK CROAK
CROCK: CROST CRONK CROOK CROAK CROCK
CRONE: CROST CRONK CRONY CRONE
CRONY: CROST CRONK CRONY
CROOK: CROST CRONK CROOK
CROSS: CROST CROSS
CROUP: CROST CRONK CROME CROUP
CROWD: CROST CRONK CROME CROUP CROCI CROWD
CROWN: CROST CRONK CROWN
CRUDE: CROST CRAPE CREME CRUDE
CRUEL: CROST CRAPE CREEL CRUEL
CRUMB: CROST CRAPE CRUCK CRUMB
CRUMP: CROST CRAPE CRIMP CRUMP
CRUSH: CROST CRUSE CRUSH
CRUST: CROST CRUST
CRYPT: CROST CREPT CRYPT
CUBIC: CROST CAPLE CINCH CUBIC
CUMIN: CROST CAPLE CINCH CUING CUMIN
CURIO: CROST CORBE CAROL CURIO
CURLY: CROST CARER CURLY
CURRY: CROST CARER CURRY
CURSE: CROST CURSI CURSE
CURVE: CROST CARER CERCI CURVE
CURVY: CROST CARER CURLY CURDY CURNY CURVY
CUTIE: CROST CUTIE
CYBER: CROST CARER CYDER CYBER
CYCLE: CROST CAPLE CYCLE
CYNIC: CROST CAPLE CINCH CYNIC
DADDY: CROST LIANE GAMBA PAWED DAFFY DADDY
DAILY: CROST LIANE ALGID DAILY
DAIRY: CROST RARED NADIR DAIRY
DAISY: CROST SALSE PAISA DAISY
DALLY: CROST LIANE PALAY BALLY WALLY GALLY
DANCE: CROST LANCE PANCE NANCE DANCE
DANDY: CROST LIANE MANGA HANKY BANDY DANDY
DATUM: CROST TATIE FATAL DATUM
DAUNT: CROST LEANT DAUNT
DEALT: CROST LEANT DEALT
DEATH: CROST TATIE MEATY DEATH
DEBAR: CROST RARED DENAR DEWAR DEBAR
DEBIT: CROST LEANT DEBIT
DEBUG: CROST LIANE DEGUM DEBUG
DEBUT: CROST LEANT DEBIT DEBUT
DECAL: CROST LANCE DECAL
DECAY: CROST LANCE DECAY
DECOR: CROST RECCO DECOR
DECOY: CROST LOCIE GECKO DECOY
DECRY: CROST RACED DECRY
DEFER: CROST RARED EIDER DEFER
DEIGN: CROST LIANE GENIP FEIGN DEIGN
DEITY: CROST TATIE MEITH DEITY
DELAY: CROST LIANE ABLED DELAY
DELTA: CROST TATIE MEATY LEPTA DELTA
DELVE: CROST LIANE GLEBE MEDLE DELVE
DEMON: CROST LODEN DEMON
DEMUR: CROST RARED DEBUR DEMUR
DENIM: CROST LIANE GENIP VENIN DENIM
DENSE: CROST SALSE MENSE DENSE
DEPOT: CROST BIGOT DEPOT
DEPTH: CROST TATIE LEFTY DEPTH
DERBY: CROST RARED NERDY DERBY
DETER: CROST TERAI METRE DETER
DETOX: CROST TONEY METOL DETOX
DEUCE: CROST LANCE DEUCE
DEVIL: CROST LIANE KELIM VEXIL DEVIL
DIARY: CROST RARED HYDRA DIARY
DICEY: CROST LANCE DICEY
DIGIT: CROST LEANT DIXIT DIGIT
DILLY: CROST LIANE GILLY DILLY
DIMLY: CROST LIANE GILLY DIMLY
DINER: CROST RARED EIDER DIVER DINER
DINGO: CROST LODEN DINGO
DINGY: CROST LIANE KINDY DINGY
DIODE: CROST DOOLE DIODE
DIRGE: CROST RARED NERDY DIRGE
DIRTY: CROST TERAI YIRTH DIRTY
DISCO: CROST SOCLE DISCO
DITCH: CROST TACHE DITCH
DITTO: CROST TONEY TATOU DITTO
DITTY: CROST TATIE DITTY
DIVER: CROST RARED EIDER DIVER
DIZZY: CROST LIANE MIDGY DIZZY
DODGE: CROST LODEN BODED DODGE
DODGY: CROST LODEN PODIA DODGY
DOGMA: CROST LODEN DOGGY DOGMA
DOING: CROST LODEN DOWNA DOING
DOLLY: CROST LODEN DOLMA DOLLY
DONOR: CROST MOREL BOARD RONDO DONOR
DONUT: CROST BIGOT MOUNT DONUT
DOPEY: CROST LODEN DOPEY
DOUBT: CROST BIGOT OBJET DOUBT
DOUGH: CROST LODEN DOGGY DOUGH
DOWDY: CROST LODEN DOGGY DOBBY DOWDY
DOWEL: CROST LODEN POLED DOWEL
DOWNY: CROST LODEN DOWNA DOWNY
DOWRY: CROST MOREL BOARD DOWRY
DOZEN: CROST LODEN DOYEN DOVEN DOZEN
DRAFT: CROST PRATT KRAFT GRAFT DRAFT
DRAIN: CROST BREAD DRAIN
DRAKE: CROST BREAD DRAKE
DRAMA: CROST BREAD DRAIN DRAMA
DRANK: CROST BREAD DRAIN DRANK
DRAPE: CROST BREAD DRAKE DRAVE DRAPE
DRAWL: CROST BREAD DRAIN DRAMA DRAFF DRAWL
DRAWN: CROST BREAD DRAIN DRAWN
DREAD: CROST BREAD DREAD
DREAM: CROST BREAD DREAM
DRESS: CROST PRASE FRESH DRESS
DRIED: CROST BREAD PRIED WRIED DRIED
DRIER: CROST BREAD PRIDE DRIER
DRIFT: CROST PRATT BRUIT DRIFT
DRILL: CROST BREAD DRILY DRILL
DRINK: CROST BREAD DRILY DRINK
DRIVE: CROST BREAD PRIDE DRIVE
DROIT: CROST GROUT DROIT
DROLL: CROST DRONE DROOL DROLL
DRONE: CROST DRONE
DROOL: CROST DRONE DROOL
DROOP: CROST DRONE DROOL DROOG DROOK DROOP
DROSS: CROST PROSE GROSS DROSS
DROVE: CROST DRONE DROVE
DROWN: CROST DRONE DROWN
DRUID: CROST BREAD GRIND DRUID
DRUNK: CROST BREAD DRILY DRUNK
DRYER: CROST BREAD PRIDE DRYER
DRYLY: CROST BREAD DRILY DRYLY
DUCHY: CROST LANCE DUCHY
DULLY: CROST LIANE GULPY BULKY HULLY FULLY
DUMMY: CROST LIANE PYGMY MUMMY DUMMY
DUMPY: CROST LIANE PYGMY HUMPY BUMPY DUMPY
DUNCE: CROST LANCE PUNCE BUNCE DUNCE
DUSKY: CROST LANES HUSKY BUSKY DUSKY
DUSTY: CROST TEATS MISTY DUSTY
DUTCH: CROST TACHE DITCH DUTCH
DUVET: CROST LEANT BIDET DUVET
DWARF: CROST RARED HYDRA DWARF
DWELL: CROST LIANE DEBEL DWELL
DWELT: CROST LEANT GULET KLETT DWELT
DYING: CROST LIANE HINNY DYING
EAGER: CROST RARED LAGER YAGER JAGER GAGER
EAGLE: CROST LIANE GABLE PAGLE EAGLE
EARLY: CROST RARED GARBE EARLY
EARTH: CROST TERAI EARTH
EASEL: CROST LANES SALEP EASEL
EATEN: CROST TATIE LATED PATEN EATEN
EATER: CROST TERAI RATEL MATER DATER PATER
EBONY: CROST DOOLE PEONY EBONY
ECLAT: CROST LACET ECLAT
EDICT: CROST LACET EDICT
EDIFY: CROST LIANE BEDIM IVIED EDIFY
EERIE: CROST RARED VIRGE EYRIE EERIE
EGRET: CROST RELIT EVERT EGRET
EIGHT: CROST LEANT BIDET EIGHT
EJECT: CROST LACET EDICT EJECT
EKING: CROST LIANE MEINY EXING EKING
ELATE: CROST TATIE ALATE ELATE
ELBOW: CROST LODEN OLLIE FLEXO ELBOW
ELDER: CROST RARED EIDER ENDER ELDER
ELECT: CROST LACET ELECT
ELEGY: CROST LIANE DEBEL ELEGY
ELFIN: CROST LIANE ELDIN ELFIN
ELIDE: CROST LIANE ELIDE
ELITE: CROST TATIE ELITE
ELOPE: CROST DOOLE GLOBE ALOWE PLOYE ELOPE
ELUDE: CROST LIANE GLEBE ELPEE ELUDE
EMAIL: CROST LIANE EMAIL
EMBED: CROST LIANE DEGUM EMBED
EMBER: CROST RARED LIVER HEWER EMBER
EMCEE: CROST LANCE BECKE EMCEE
EMPTY: CROST TATIE LEFTY EMPTY
ENACT: CROST LACET ENACT
ENDOW: CROST LODEN ENDOW
ENEMA: CROST LIANE MANED ENEMA
ENEMY: CROST LIANE NEEDY ENEMY
ENJOY: CROST LODEN VENOM ENJOY
ENNUI: CROST LIANE GENIP INNED ENNUI
ENSUE: CROST LANES SPINE ENSUE
ENTER: CROST TERAI MUTER ENTER
ENTRY: CROST TERAI MUTER ENTRY
ENVOY: CROST LODEN VENOM ENVOY
EPOCH: CROST PHOCA EPOCH
EPOXY: CROST DOOLE PEONY EPOXY
EQUAL: CROST LIANE ABLED FLEAM EQUAL
EQUIP: CROST LIANE BEDIM EQUIP
ERASE: CROST PRASE ERASE
ERECT: CROST BRACT ERUCT ERECT
ERODE: CROST DRONE ERODE
ERROR: CROST PREON ERROR
ERUPT: CROST PRATT GRIPT ERUPT
ESSAY: CROST LANES SEPAD ESSAY
ESTER: CROST TARES STEER ESTER
ETHER: CROST TERAI MUTER ETHER
ETHIC: CROST TACHE LETCH ETHIC
ETHOS: CROST TOLTS JATOS ETHOS
ETUDE: CROST TATIE WEFTE ETHNE ETUDE
EVADE: CROST LIANE AGAVE EVADE
EVENT: CROST LEANT IDENT EVENT
EVERY: CROST RARED EMERY EVERY
EVICT: CROST LACET EDICT EVICT
EVOKE: CROST DOOLE GNOME EVOKE
EXACT: CROST LACET ENACT EXACT
EXALT: CROST LEANT EXALT
EXCEL: CROST LANCE YCLED EXCEL
EXERT: CROST RELIT EVERT EXERT
EXILE: CROST LIANE ELIDE EXILE
EXIST: CROST GEIST EXIST
EXPEL: CROST LIANE DEBEL EXPEL
EXTOL: CROST TONEY METOL EXTOL
EXTRA: CROST TERAI RATEL EXTRA
EXULT: CROST LEANT GULET EXULT
EYING: CROST LIANE MEINY EYING
FABLE: CROST LIANE GABLE HABLE FABLE
FACET: CROST LACET FACET
FAINT: CROST LEANT DAUNT FAINT
FAIRY: CROST RARED BAKRA FAIRY
FAITH: CROST TATIE HABIT FAITH
FALSE: CROST SALSE FALSE
FANCY: CROST LANCE NANCY FANCY
FANNY: CROST LIANE NANNA FANNY
FARCE: CROST RACED FARCE
FATAL: CROST TATIE FATAL
FATTY: CROST TATIE FATTY
FAULT: CROST LEANT HAULT VAULT GAULT FAULT
FAUNA: CROST LIANE NANNA FAUNA
FAVOR: CROST MOREL RAYON VAPOR FAVOR
FEAST: CROST GEIST FEAST
FECAL: CROST LANCE DECAL FECAL
FEIGN: CROST LIANE GENIP FEIGN
FELLA: CROST LIANE ABLED PELMA FELLA
FELON: CROST LODEN FELON
FEMME: CROST LIANE DEEVE FEMME
FEMUR: CROST RARED EMERY LEMUR FEMUR
FENCE: CROST LANCE PUNCE YINCE FENCE
FERAL: CROST RARED FERIA FERAL
FERRY: CROST RARED KURRE FERRY
FETAL: CROST TATIE PETAL METAL FETAL
FETCH: CROST TACHE LETCH KETCH FETCH
FETID: CROST TATIE METIF FETID
FETUS: CROST TEATS HETES YETIS FETUS
FEVER: CROST RARED LIVER FEVER
FEWER: CROST RARED LIVER HEWER NEWER FEWER
FIBER: CROST RARED LIVER BINER JIBER FIBER
FIBRE: CROST RARED EMERY ALURE FIBRE
FICUS: CROST SAICE MICKS FICUS
FIELD: CROST LIANE BILED FIELD
FIEND: CROST LIANE FIEND
FIERY: CROST RARED EMERY FIERY
FIFTH: CROST TATIE MILTY DINTS FIFTH
FIFTY: CROST TATIE MILTY NIFTY FIFTY
FIGHT: CROST LEANT DIXIT PITOT HIGHT MIGHT
FILER: CROST RARED LIVER PILER FILER
FILET: CROST LEANT GULET FILET
FILLY: CROST LIANE GILLY DILLY WILLY BILLY
FILMY: CROST LIANE GILLY MILKY FILMY
FILTH: CROST TATIE MILTY FILTH
FINAL: CROST LIANE NIVAL FINAL
FINCH: CROST LANCE PINCH GINCH FINCH
FINER: CROST RARED LIVER BINER MINER NINER
FIRST: CROST EARST WURST FIRST
FISHY: CROST LANES HUSKY DISHY FISHY
FIXER: CROST RARED LIVER BINER PIKER MIXER
FIZZY: CROST LIANE MIDGY FIZZY
FJORD: CROST ADORE HOORD FJORD
FLACK: CROST LANCE FLACK
FLAIL: CROST LIANE FLAIL
FLAIR: CROST RARED UNARM FLAIR
FLAKE: CROST LIANE GLADE FLAME FLAKE
FLAKY: CROST LIANE FLAMY FLAKY
FLAME: CROST LIANE GLADE FLAME
FLANK: CROST LIANE KLANG BLANK PLANK FLANK
FLARE: CROST RARED LEARY GLARE FLARE
FLASH: CROST SALSE FLASH
FLASK: CROST SALSE FLASH FLASK
FLECK: CROST LANCE BLECH FLECK
FLEET: CROST LEANT GULET FLEET
FLESH: CROST SALSE FLESH
FLICK: CROST LANCE FLICK
FLIER: CROST RARED LIVER FLIER
FLING: CROST LIANE BLING FLING
FLINT: CROST LEANT FLINT
FLIRT: CROST RELIT LIART FLIRT
FLOAT: CROST AFOOT FLOAT
FLOCK: CROST PHOCA BLOCK FLOCK
FLOOD: CROST DOOLE FLOOD
FLOOR: CROST ADORE PROOF FLOOR
FLORA: CROST ADORE FLORA
FLOSS: CROST SKOSH GLOSS FLOSS
FLOUR: CROST ADORE PROOF FLOUR
FLOUT: CROST AFOOT FLOUT
FLOWN: CROST DOOLE ALONG FLOWN
FLUFF: CROST LIANE GULPY FLUFF
FLUID: CROST LIANE PUGIL BLUID FLUID
FLUKE: CROST LIANE GLEBE PLUME FLUKE
FLUME: CROST LIANE GLEBE PLUME FLUME
FLUNG: CROST LIANE FLUNG
FLUNK: CROST LIANE FLUNG FLUNK
FLUSH: CROST SALSE FLISK FLUSH
FLUTE: CROST TATIE WEFTE FLUTE
FLYER: CROST RARED LIVER FLYER
FOAMY: CROST LODEN GOMPA KOKAM FOAMY
FOCAL: CROST LOCIE FOCAL
FOCUS: CROST SOCLE HOCKS DOCUS FOCUS
FOGGY: CROST LODEN GOMPA BOGGY FOGGY
FOIST: CROST JOIST ZOIST FOIST
FOLIO: CROST LODEN POLLY FOLIO
FOLLY: CROST LODEN POLLY FOLLY
FORAY: CROST MOREL BORNA HORAH FORAY
FORCE: CROST RECCO FORCE
FORGE: CROST MOREL GORED FORGE
FORGO: CROST MOREL BORNA WORDY ZORRO FORGO
FORTE: CROST TOTER ROUTE FORTE
FORTH: CROST TOTER PORTY FORTH
FORTY: CROST TOTER PORTY DORTY BORTY FORTY
FORUM: CROST MOREL JORAM FORUM
FOUND: CROST LODEN DOWNA HOUND FOUND
FOYER: CROST MOREL ROWED HONER FOYER
FRAIL: CROST BREAD GRAIP FRAIM FRAIL
FRAME: CROST BREAD GRAME FRAME
FRANK: CROST BREAD GRAIP FRANK
FRAUD: CROST BREAD FRAUD
FREAK: CROST BREAD AREAL WREAK FREAK
FREED: CROST BREAD FREMD FREED
FREER: CROST BREAD GREEK PREEN FREER
FRESH: CROST PRASE FRESH
FRIAR: CROST BREAD ARGAL FRIAR
FRIED: CROST BREAD PRIED WRIED DRIED FRIED
FRILL: CROST BREAD GRIMY PRINK FRIZZ FRILL
FRISK: CROST PRASE BRUSK FRISK
FRITZ: CROST IRATE FRITZ
FROCK: CROST BROCK FROCK
FROND: CROST DRONE BROND FROND
FRONT: CROST GROUT DROIT WROOT FRONT
FROST: CROST FROST
FROTH: CROST TROPE BROTH FROTH
FROWN: CROST DRONE GROWN FROWN
FROZE: CROST DRONE PROKE FRORE FROZE
FRUIT: CROST PRATT BRUIT FRUIT
FUDGE: CROST LIANE DEEVE MUDGE PUDGE FUDGE
FUGUE: CROST LIANE DEEVE UPBYE FUGUE
FULLY: CROST LIANE GULPY BULKY HULLY FULLY
FUNGI: CROST LIANE UNHIP FUNDI FUNGI
FUNKY: CROST LIANE BUNDH FUNGO FUNKY
FUNNY: CROST LIANE FLUNG FUNNY
FUROR: CROST MOREL BURRO FUROR
FURRY: CROST RARED FIRRY FURRY
FUSSY: CROST SALSE PUSSY FUSSY
FUZZY: CROST LIANE PYGMY BUFFY FUDDY FUZZY
GAFFE: CROST LIANE MADGE GAUJE GAFFE
GAILY: CROST LIANE ALGID GAILY
GAMER: CROST RARED LAGER GAMER
GAMMA: CROST LIANE GAMBA GAMMA
GAMUT: CROST LEANT GAMUT
GASSY: CROST SALSE BASSY MASSY GASSY
GAUDY: CROST LIANE GAMBA GAUDY
GAUGE: CROST LIANE MADGE GAUGE
GAUNT: CROST LEANT DAUNT HAUNT JAUNT GAUNT
GAUZE: CROST LIANE MADGE GAUJE GAUZE
GAVEL: CROST LIANE ABLED FAVEL GAVEL
GAWKY: CROST LIANE GAMBA GAUDY GAPPY GAWKY
GAYER: CROST RARED LAGER GAMER GAZER GAPER
GAYLY: CROST LIANE PALAY MADLY GAYLY
GAZER: CROST RARED LAGER GAMER GAZER
GECKO: CROST LOCIE GECKO
GEEKY: CROST LIANE DEGUM HEWGH GEEKY
GEESE: CROST SALSE MENSE PEISE GEESE
GENIE: CROST LIANE NUDIE GYNIE GENIE
GENRE: CROST RARED EMERY GENRE
GHOST: CROST GHOST
GHOUL: CROST DOOLE ALONG GHOUL
GIANT: CROST LEANT GIANT
GIDDY: CROST LIANE MIDGY GIDDY
GIPSY: CROST SALSE PHISH GIPSY
GIRLY: CROST RARED LURGI GIRLY
GIRTH: CROST TERAI YIRTH GIRTH
GIVEN: CROST LIANE VINED GIVEN
GIVER: CROST RARED LIVER GIVER
GLADE: CROST LIANE GLADE
GLAND: CROST LIANE KLANG GLAND
GLARE: CROST RARED LEARY GLARE
GLASS: CROST SALSE GLASS
GLAZE: CROST LIANE GLADE GLAZE
GLEAM: CROST LIANE ABLED FLEAM GLEAM
GLEAN: CROST LIANE VENAL GLEAN
GLIDE: CROST LIANE ELIDE GLIDE
GLINT: CROST LEANT FLINT GLINT
GLOAT: CROST AFOOT GLOAT
GLOBE: CROST DOOLE GLOBE
GLOOM: CROST DOOLE PLOOK BLOOM GLOOM
GLORY: CROST ADORE GOORY GLORY
GLOSS: CROST SKOSH GLOSS
GLOVE: CROST DOOLE GLOBE GLOZE GLOVE
GLYPH: CROST LIANE GULPY GLYPH
GNASH: CROST SALSE AGISM GNASH
GNOME: CROST DOOLE GNOME
GODLY: CROST LODEN PODAL GODLY
GOING: CROST LODEN GONIA GOING
GOLEM: CROST LODEN HOLEY GOLEM
GOLLY: CROST LODEN POLLY FOLLY HOLLY WOLLY
GONAD: CROST LODEN DOWNA NOMAD GONAD
GONER: CROST MOREL ROWED HONER ZONER BONER
GOODY: CROST DOOLE MOODY WOODY GOODY
GOOEY: CROST DOOLE ZOOEY HOOEY GOOEY
GOOFY: CROST DOOLE GOOBY GOOKY GOOFY
GOOSE: CROST SKOSH GLOSS GOOSY GOOSE
GORGE: CROST MOREL GORED GORGE
GOUGE: CROST LODEN BOGIE GOUGE
GOURD: CROST MOREL BOARD GOURD
GRACE: CROST BRACE GRACE
GRADE: CROST BREAD DRAKE IRADE GRADE
GRAFT: CROST PRATT KRAFT GRAFT
GRAIL: CROST BREAD GRAIP GRAIL
GRAIN: CROST BREAD GRAIP GRAIL GRAIN
GRAND: CROST BREAD FRAUD GRAND
GRANT: CROST PRATT KRAFT DRANT GRANT
GRAPE: CROST BREAD GRAME GRAPE
GRAPH: CROST BREAD GRAIP GRAPH
GRASP: CROST PRASE GRASP
GRASS: CROST PRASE BRASH GRASS
GRATE: CROST IRATE GRATE
GRAVE: CROST BREAD GRAME GRAPE GRAVE
GRAVY: CROST BREAD GRAIP GRANA GRAFF GRAVY
GRAZE: CROST BREAD GRAME GRAPE GRAVE GRAZE
GREAT: CROST PRATT ARRET GREAT
GREED: CROST BREAD FREMD GREED
GREEN: CROST BREAD GREEK GREEN
GREET: CROST PRATT BRUIT DRENT FREET GREET
GRIEF: CROST BREAD GRIPE GRIEF
GRILL: CROST BREAD GRIMY GRIFF GRILL
GRIME: CROST BREAD GRIPE GRIKE GRIME
GRIMY: CROST BREAD GRIMY
GRIND: CROST BREAD GRIND
GRIPE: CROST BREAD GRIPE
GROAN: CROST DRONE GROWN GROIN GROAN
GROIN: CROST DRONE GROWN GROIN
GROOM: CROST DRONE GROOM
GROPE: CROST DRONE PROKE GROPE
GROSS: CROST PROSE GROSS
GROUP: CROST DRONE GROOM GROUF GROUP
GROUT: CROST GROUT
GROVE: CROST DRONE PROKE FRORE BROME GROVE
GROWL: CROST DRONE GROOM GROUF GROVY GROWL
GROWN: CROST DRONE GROWN
GRUEL: CROST BREAD GRIPE GRUEL
GRUFF: CROST BREAD GRIMY GRUFF
GRUNT: CROST PRATT BRUIT GRUNT
GUARD: CROST RARED LIARD AWARD GUARD
GUAVA: CROST LIANE KHAYA GUAVA
GUESS: CROST SALSE GUESS
GUEST: CROST GEIST GUEST
GUIDE: CROST LIANE GUIDE
GUILD: CROST LIANE PUGIL GUILD
GUILE: CROST LIANE ELIDE WHILE GUILE
GUILT: CROST LEANT GUILT
GUISE: CROST SALSE MENSE GUYSE GUISE
GULCH: CROST LANCE FLICK MULCH GULCH
GULLY: CROST LIANE GULPY GULLY
GUMBO: CROST LODEN GAMBO GUMBO
GUMMY: CROST LIANE PYGMY GUMMY
GUPPY: CROST LIANE PYGMY GUPPY
GUSTO: CROST TOLTS PESTO VISTO BASTO GUSTO
GUSTY: CROST TEATS MISTY DUSTY LUSTY GUSTY
GYPSY: CROST SALSE PHISH GYPSY
HABIT: CROST LEANT GAMUT DAVIT HABIT
HAIRY: CROST RARED BAKRA FAIRY HAIRY
HALVE: CROST LIANE GABLE VALUE HALVE
HANDY: CROST LIANE MANGA HANKY HANDY
HAPPY: CROST LIANE GAMBA PAWED HAPPY
HARDY: CROST RARED PARDY HARDY
HAREM: CROST RARED PAREN LAREE HAREM
HARPY: CROST RARED MARKA BARNY HARPY
HARRY: CROST RARED MARRY HARRY
HARSH: CROST RAISE MARSH HARSH
HASTE: CROST TEATS PASTE HASTE
HASTY: CROST TEATS VISTA PASTY NASTY HASTY
HATCH: CROST TACHE BATCH GATCH NATCH MATCH
HATER: CROST TERAI RATEL MATER DATER PATER
HAUNT: CROST LEANT DAUNT HAUNT
HAUTE: CROST TATIE VAUTE HAUTE
HAVEN: CROST LIANE MANED WAKEN PAVEN HAVEN
HAVOC: CROST LOCIE BUNCO HAVOC
HAZEL: CROST LIANE ABLED FAVEL HAZEL
HEADY: CROST LIANE BEADY HEADY
HEARD: CROST RARED HEARD
HEART: CROST RELIT PEART HEART
HEATH: CROST TATIE MEATY DEATH NEATH BEATH
HEAVE: CROST LIANE AGAVE DEAVE HEAVE
HEAVY: CROST LIANE BEADY HEAVY
HEDGE: CROST LIANE DEEVE KEDGE WEDGE HEDGE
HEFTY: CROST TATIE LEFTY HEFTY
HEIST: CROST GEIST HEIST
HELIX: CROST LIANE KELIM FELID HELIX
HELLO: CROST LODEN OLLIE JELLO HELLO
HENCE: CROST LANCE PUNCE YINCE FENCE HENCE
HERON: CROST MOREL PEROG HERON
HILLY: CROST LIANE GILLY DILLY WILLY BILLY
HINGE: CROST LIANE WINGE DINGE GINGE MINGE
HIPPO: CROST LODEN GAMBO HIPPO
HIPPY: CROST LIANE MIDGY FIZZY PITHY HIPPY
HITCH: CROST TACHE DITCH MITCH HITCH
HOARD: CROST MOREL BOARD HOARD
HOBBY: CROST LODEN GOMPA BOUSY HOBBY
HOIST: CROST JOIST ZOIST FOIST MOIST HOIST
HOLLY: CROST LODEN POLLY FOLLY HOLLY
HOMER: CROST MOREL HOMER
HONEY: CROST LODEN HONEY
HONOR: CROST MOREL BOARD ROUGH HONOR
HORDE: CROST MOREL GORED HORDE
HORNY: CROST MOREL BORNA PORNY HORNY
HORSE: CROST GORSE MORSE WORSE DORSE HORSE
HOTEL: CROST TONEY MOTED BOTEL HOTEL
HOTLY: CROST TONEY BOTHY HOTTY HOTLY
HOUND: CROST LODEN DOWNA HOUND
HOUSE: CROST SOUSE DOUSE MOUSE LOUSE HOUSE
HOVEL: CROST LODEN HOLEY HOVEL
HOVER: CROST MOREL ROWED HONER HOVER
HOWDY: CROST LODEN DOGGY HOWDY
HUMAN: CROST LIANE MANGA UNDAM HUMAN
HUMID: CROST LIANE PUMIE HUMID
HUMOR: CROST MOREL RUMBO HUMOR
HUMPH: CROST LIANE PYGMY HUMPH
HUMUS: CROST LANES SIMPS BUMFS MUMUS HUMUS
HUNCH: CROST LANCE PINCH DUNCH HUNCH
HUNKY: CROST LIANE BUNDH HUNKY
HURRY: CROST RARED FIRRY MURRY BURRY LURRY
HUSKY: CROST LANES HUSKY
HUSSY: CROST SALSE PUSSY FUSSY MUSSY GUSSY
HUTCH: CROST TACHE DITCH HUTCH
HYDRO: CROST MOREL RAYON HYDRO
HYENA: CROST LIANE HENNA HYENA
HYMEN: CROST LIANE NEEDY HYMEN
HYPER: CROST RARED LIVER HEWER HUGER HYPER
ICILY: CROST LANCE XYLIC ICILY
ICING: CROST LANCE MUCIN ICING
IDEAL: CROST LIANE IDEAL
IDIOM: CROST LODEN IMIDO IDIOM
IDIOT: CROST BIGOT IMPOT IDIOT
IDLER: CROST RARED EIDER IDLER
IDYLL: CROST LIANE PUGIL IDYLL
IGLOO: CROST LODEN GALOP IGLOO
ILIAC: CROST LANCE DUCAL ILIAC
IMAGE: CROST LIANE IMAGE
IMBUE: CROST LIANE GUIDE UMPIE IMBUE
IMPEL: CROST LIANE KELIM IMPEL
IMPLY: CROST LIANE PUGIL FLIMP IMPLY
INANE: CROST LIANE INANE
INBOX: CROST LODEN MANGO UNBOX INBOX
INCUR: CROST RACED INCUR
INDEX: CROST LIANE GENIP INDEW INDEX
INEPT: CROST LEANT UNKET INEPT
INERT: CROST RELIT PIERT INERT
INFER: CROST RARED LIVER FINER INFER
INGOT: CROST BIGOT INGOT
INLAY: CROST LIANE ANILS INLAY
INLET: CROST LEANT ENLIT INLET
INNER: CROST RARED LIVER FINER INNER
INPUT: CROST LEANT INWIT INPUT
INTER: CROST TERAI INTER
INTRO: CROST TOTER NITRO INTRO
IONIC: CROST LOCIE MONIC IONIC
IRATE: CROST IRATE
IRONY: CROST DRONE PRONG KRONA IRONY
ISLET: CROST SALET ISLET
ISSUE: CROST LANES SPIDE ISSUE
ITCHY: CROST TACHE ITCHY
IVORY: CROST ADORE GOORY FLORY IVORY
JAUNT: CROST LEANT DAUNT HAUNT JAUNT
JAZZY: CROST LIANE GAMBA PAWED FAFFY JAZZY
JELLY: CROST LIANE DEBEL GELLY FELLY JELLY
JERKY: CROST RARED VIRGE KEREL PERKY JERKY
JETTY: CROST TATIE NETTY JETTY
JEWEL: CROST LIANE DEBEL KEVEL GEMEL JEWEL
JIFFY: CROST LIANE MIDGY FIZZY BIFFY JIFFY
JOINT: CROST BIGOT POINT NOINT JOINT
JOIST: CROST JOIST
JOKER: CROST MOREL ROWED HONER FOYER JOKER
JOLLY: CROST LODEN POLLY FOLLY HOLLY WOLLY
JOUST: CROST JOIST JOUST
JUDGE: CROST LIANE DEEVE MUDGE PUDGE FUDGE
JUICE: CROST LANCE DEUCE JUICE
JUICY: CROST LANCE YUCCH JUICY
JUMBO: CROST LODEN GAMBO BIMBO JUMBO
JUMPY: CROST LIANE PYGMY HUMPY BUMPY DUMPY
JUNTA: CROST TATIE ANATA JUNTA
JUNTO: CROST TONEY PUNTO JUNTO
JUROR: CROST MOREL BURRO FUROR JUROR
KAPPA: CROST LIANE GAMBA YAKKA KAPPA
KARMA: CROST RARED MARKA KARMA
KAYAK: CROST LIANE GAMBA DAWAH QAJAQ KAYAK
KEBAB: CROST LIANE WAMED EPHAH KEBAB
KHAKI: CROST LIANE KHAZI KHAKI
KINKY: CROST LIANE KINDY KINKY
KIOSK: CROST SKOSH KNOSP KIOSK
KITTY: CROST TATIE DITTY WITTY NITTY BITTY
KNACK: CROST LANCE KNACK
KNAVE: CROST LIANE KNAWE KNAVE
KNEAD: CROST LIANE MANED KNEAD
KNEED: CROST LIANE NEEDY KNEED
KNEEL: CROST LIANE NEWEL KNEEL
KNELT: CROST LEANT ENLIT KNELT
KNIFE: CROST LIANE NUDIE KNIVE KNIFE
KNOCK: CROST PHOCA BLOCK KNOCK
KNOLL: CROST DOOLE AIOLI KNOLL
KNOWN: CROST DOOLE ANOMY KNOWN
KOALA: CROST LODEN POLLY KOALA
KRILL: CROST BREAD GRIMY PRINK KRILL
LABEL: CROST LIANE LAZED LAPEL LABEL
LABOR: CROST MOREL VALOR LABOR
LADEN: CROST LIANE LEMAN LADEN
LADLE: CROST LIANE LADLE
LAGER: CROST RARED LAGER
LANCE: CROST LANCE
LANKY: CROST LIANE LAGAN LANKY
LAPEL: CROST LIANE LAZED LAPEL
LAPSE: CROST SALSE LAPSE
LARGE: CROST RARED GARBE PARGE MARGE LARGE
LARVA: CROST RARED MARKA VARIA LARVA
LASSO: CROST SOUSE LASSO
LATCH: CROST TACHE BATCH GATCH NATCH MATCH
LATER: CROST TERAI RATEL LATER
LATHE: CROST TATIE LATHE
LATTE: CROST TATIE LATTE
LAUGH: CROST LIANE LALDY LAUGH
LAYER: CROST RARED LAGER LAVER LAKER LAXER
LEACH: CROST LANCE LEACH
LEAFY: CROST LIANE LEAKY LEAFY
LEAKY: CROST LIANE LEAKY
LEANT: CROST LEANT
LEAPT: CROST LEANT LEAPT
LEARN: CROST RARED LEARY LEARN
LEASE: CROST SALSE LYASE LEASE
LEASH: CROST SALSE LEASH
LEAST: CROST GEIST FEAST YEAST LEAST
LEAVE: CROST LIANE LEAVE
LEDGE: CROST LIANE LIEGE LEDGE
LEECH: CROST LANCE LEUCH LEECH
LEERY: CROST RARED EMERY BEERY LEERY
LEFTY: CROST TATIE LEFTY
LEGAL: CROST LIANE LAZED LEMMA LEGAL
LEGGY: CROST LIANE LEDGY LEGGY
LEMON: CROST LODEN LEMON
LEMUR: CROST RARED EMERY LEMUR
LEPER: CROST RARED LIVER LEGER LEPER
LEVEL: CROST LIANE LEDGY LEMEL LEVEL
LEVER: CROST RARED LIVER LEVER
LIBEL: CROST LIANE LIMED LIBEL
LIEGE: CROST LIANE LIEVE LIEGE
LIGHT: CROST LEANT LIMIT LIGHT
LIKEN: CROST LIANE LIMEN LIVEN LINEN LIKEN
LILAC: CROST LANCE LILAC
LIMBO: CROST LODEN LIMBO
LIMIT: CROST LEANT LIMIT
LINEN: CROST LIANE LIMEN LIVEN LINEN
LINER: CROST RARED LIVER LIBER LIKER LINER
LINGO: CROST LODEN LINGO
LIPID: CROST LIANE LIPID
LITHE: CROST TATIE KITHE LITHE
LIVER: CROST RARED LIVER
LIVID: CROST LIANE LIPID LIVID
LLAMA: CROST LIANE LLAMA
LOAMY: CROST LODEN LOYAL LOAMY
LOATH: CROST TONEY LOTTO LOATH
LOBBY: CROST LODEN LOYAL LOPPY LOBBY
LOCAL: CROST LOCIE LOCUM LOCAL
LOCUS: CROST SOCLE LOCKS LOCUS
LODGE: CROST LODEN LODGE
LOFTY: CROST TONEY BOTHY GOUTY LOFTY
LOGIC: CROST LOCIE LOGIC
LOGIN: CROST LODEN LOGON LOGIN
LOOPY: CROST DOOLE LOOPY
LOOSE: CROST SKOSH GLOSS LOOSE
LORRY: CROST MOREL LORRY
LOSER: CROST DORES SOLER LOSER
LOUSE: CROST SOUSE DOUSE MOUSE LOUSE
LOUSY: CROST SOUSE BOUSY LOUSY
LOVER: CROST MOREL POLER LOVER
LOWER: CROST MOREL POLER LOVER LOWER
LOWLY: CROST LODEN LOYAL LOLLY LOWLY
LOYAL: CROST LODEN LOYAL
LUCID: CROST LANCE LICHI LUCID
LUCKY: CROST LANCE LICHI LUCKY
LUMEN: CROST LIANE LUMEN
LUMPY: CROST LIANE LYMPH LUMPY
LUNAR: CROST RARED UNARM LUNAR
LUNCH: CROST LANCE LINCH LUNCH
LUNGE: CROST LIANE LUNGE
LUPUS: CROST LANES LISPS LUPUS
LURCH: CROST RACED LURCH
LURID: CROST RARED MURID LURID
LUSTY: CROST TEATS MISTY DUSTY LUSTY
LYING: CROST LIANE LYING
LYMPH: CROST LIANE LYMPH
LYNCH: CROST LANCE LINCH LUNCH LYNCH
LYRIC: CROST RACED LURCH LYRIC
MACAW: CROST LANCE KACHA MACAW
MACHO: CROST LOCIE BACON WACKO MACHO
MACRO: CROST RECCO MUCRO MICRO MACRO
MADAM: CROST LIANE GAMBA HAKAM MADAM
MADLY: CROST LIANE PALAY MADLY
MAFIA: CROST LIANE ZAMIA MAFIA
MAGIC: CROST LANCE KACHA MAGIC
MAGMA: CROST LIANE GAMBA MAGMA
MAIZE: CROST LIANE MAVIE MAIZE
MAJOR: CROST MOREL MAJOR
MAKER: CROST RARED LAGER VAPER FAKER WAKER
MAMBO: CROST LODEN GAMBO MAMBO
MAMMA: CROST LIANE GAMBA HAMZA MAMMA
MAMMY: CROST LIANE GAMBA DAMPY JAMMY MAMMY
MANGA: CROST LIANE MANGA
MANGE: CROST LIANE NUGAE MANGE
MANGO: CROST LODEN MANGO
MANGY: CROST LIANE MANGA MANGY
MANIA: CROST LIANE MANIA
MANIC: CROST LANCE MANIC
MANLY: CROST LIANE UNLAY WANLY MANLY
MANOR: CROST MOREL MAJOR MAYOR MANOR
MAPLE: CROST LIANE GABLE PADLE MAPLE
MARCH: CROST RACED BARIC MARCH
MARRY: CROST RARED MARRY
MARSH: CROST RAISE MARSH
MASON: CROST NOLES BISON HYSON MASON
MASSE: CROST SALSE BASSE PASSE MASSE
MATCH: CROST TACHE BATCH GATCH NATCH MATCH
MATEY: CROST TATIE LATED PATEN MATEY
MAUVE: CROST LIANE MADGE MAYBE MAMEE MAUVE
MAXIM: CROST LIANE ZAMIA MADID MAXIM
MAYBE: CROST LIANE MADGE MAYBE
MAYOR: CROST MOREL MAJOR MAYOR
MEALY: CROST LIANE YEALM MEALY
MEANT: CROST LEANT MEANT
MEATY: CROST TATIE MEATY
MECCA: CROST LANCE BEACH MECCA
MEDAL: CROST LIANE ABLED MEDAL
MEDIA: CROST LIANE ADIEU MEDIA
MEDIC: CROST LANCE DICEY MEDIC
MELEE: CROST LIANE GLEBE MEDLE MELEE
MELON: CROST LODEN FELON MELON
MERCY: CROST RACED PERCH MERCY
MERGE: CROST RARED VIRGE GURGE MERGE
MERIT: CROST RELIT MERIT
MERRY: CROST RARED KURRE FERRY BERRY MERRY
METAL: CROST TATIE PETAL METAL
METER: CROST TERAI METRE METER
METRO: CROST TOTER RETRO METRO
MICRO: CROST RECCO MUCRO MICRO
MIDGE: CROST LIANE KIDGE FIDGE MIDGE
MIDST: CROST GEIST MIDST
MIGHT: CROST LEANT DIXIT PITOT HIGHT MIGHT
MILKY: CROST LIANE GILLY MILKY
MIMIC: CROST LANCE DUCHY MIMIC
MINCE: CROST LANCE PUNCE YINCE WINCE MINCE
MINER: CROST RARED LIVER BINER MINER
MINIM: CROST LIANE KINDY MINIM
MINOR: CROST MOREL MAJOR MINOR
MINTY: CROST TATIE MILTY MINTY
MINUS: CROST LANES KINDS SINGS MINIS MINUS
MIRTH: CROST TERAI YIRTH GIRTH FIRTH MIRTH
MISER: CROST SERAI RILES WISER MISER
MISSY: CROST SALSE PUSSY MISSY
MOCHA: CROST LOCIE COCOA MOCHA
MODAL: CROST LODEN PODAL MODAL
MODEL: CROST LODEN YODEL MODEL
MODEM: CROST LODEN MODEM
MOGUL: CROST LODEN POLLY MOGUL
MOIST: CROST JOIST ZOIST FOIST MOIST
MOLAR: CROST MOREL MOLAR
MOLDY: CROST LODEN DOLMA MOLDY
MONEY: CROST LODEN HONEY BONEY MONEY
MONTH: CROST TONEY MONTH
MOODY: CROST DOOLE MOODY
MOOSE: CROST SKOSH GLOSS MOOSE
MORAL: CROST MOREL MORAL
MORON: CROST MOREL MORRA MORON
MORPH: CROST MOREL MORRA MORON MORPH
MOSSY: CROST SOUSE MOSSY
MOTEL: CROST TONEY MOTED MOTEL
MOTIF: CROST TONEY LOTTO MOTIF
MOTOR: CROST TOTER ROTOR MOTOR
MOTTO: CROST TONEY LOTTO POTTO MOTTO
MOULT: CROST BIGOT MOUNT MOULT
MOUND: CROST LODEN DOWNA HOUND FOUND MOUND
MOUNT: CROST BIGOT MOUNT
MOURN: CROST MOREL MOWRA MOURN
MOUSE: CROST SOUSE DOUSE MOUSE
MOUTH: CROST TONEY LOTTO FOUTH MOUTH
MOVER: CROST MOREL MODER MONER MOPER MOWER
MOVIE: CROST LODEN BOGIE MOXIE MOVIE
MOWER: CROST MOREL MODER MONER MOPER MOWER
MUCKY: CROST LANCE DUCHY GUCKY MUCKY
MUCUS: CROST SAICE MUCKS MUCUS
MUDDY: CROST LIANE PYGMY MUDDY
MULCH: CROST LANCE FLICK MULCH
MUMMY: CROST LIANE PYGMY MUMMY
MUNCH: CROST LANCE PINCH DUNCH HUNCH BUNCH
MURAL: CROST RARED MURAL
MURKY: CROST RARED LURGI PURPY FURZY MURKY
MUSHY: CROST LANES HUSKY GUSHY PUSHY BUSHY
MUSIC: CROST SAICE MICKS MUSIC
MUSKY: CROST LANES HUSKY BUSKY DUSKY MUSKY
MUSTY: CROST TEATS MISTY MUSTY
MYRRH: CROST RARED FIRRY MYRRH
NADIR: CROST RARED NADIR
NAIVE: CROST LIANE NAIVE
NANNY: CROST LIANE NANNA NANNY
NASAL: CROST LANES NASAL
NASTY: CROST TEATS VISTA PASTY NASTY
NATAL: CROST TATIE FATAL KATAL NATAL
NAVAL: CROST LIANE UNLAY FANAL NAHAL NAVAL
NAVEL: CROST LIANE VENAL NAVEL
NEEDY: CROST LIANE NEEDY
NEIGH: CROST LIANE GENIP FEIGN NEIGH
NERDY: CROST RARED NERDY
NERVE: CROST RARED VIRGE NERVE
NEVER: CROST RARED LIVER FEVER BEVER NEVER
NEWER: CROST RARED LIVER HEWER NEWER
NEWLY: CROST LIANE NEWEL NEWLY
NICER: CROST RACED PUCER NICER
NICHE: CROST LANCE NICHE
NIECE: CROST LANCE NIECE
NIGHT: CROST LEANT INWIT NIGHT
NINJA: CROST LIANE NIKAU NINJA
NINNY: CROST LIANE PIING HINNY NINNY
NINTH: CROST TATIE MILTY DINTS NINTH
NOBLE: CROST LODEN NOBLE
NOBLY: CROST LODEN MONAL NOBLY
NOISE: CROST SOUSE POISE HOISE NOISE
NOISY: CROST SOUSE MOPSY NOISY
NOMAD: CROST LODEN DOWNA NOMAD
NOOSE: CROST SKOSH GLOSS MOOSE BOOSE NOOSE
NORTH: CROST TOTER PORTY FORTH NORTH
NOSEY: CROST NOLES NOSED NOSEY
NOTCH: CROST TONIC NOTCH
NOVEL: CROST LODEN NOVEL
NUDGE: CROST LIANE MUNGE NUDGE
NURSE: CROST RAISE PURSE BURSE NURSE
NUTTY: CROST TATIE NUTTY
NYLON: CROST LODEN PYLON NYLON
NYMPH: CROST LIANE BUNDH NYMPH
OAKEN: CROST LODEN OAKEN
OBESE: CROST SOUSE OBESE
OCCUR: CROST RECCO OCCUR
OCEAN: CROST LOCIE OCEAN
OCTAL: CROST TONIC OCTYL OCTAL
OCTET: CROST DICOT OCTET
ODDER: CROST MOREL ROKED ODDER
ODDLY: CROST LODEN ALDOL ODDLY
OFFAL: CROST LODEN GALOP OFFAL
OFFER: CROST MOREL ROKED OWNER OFFER
OFTEN: CROST TONEY OFTEN
OLDEN: CROST LODEN OLDEN
OLDER: CROST MOREL OWLER OLDER
OLIVE: CROST LODEN OLLIE OLIVE
OMBRE: CROST MOREL OMBRE
OMEGA: CROST LODEN PEKOE OMEGA
ONION: CROST LODEN ANION ONION
ONSET: CROST BESOT ONSET
OPERA: CROST MOREL REDON OPERA
OPINE: CROST LODEN VENOM OPINE
OPIUM: CROST LODEN GAMBO OPIUM
OPTIC: CROST TONIC OPTIC
ORBIT: CROST ARGOT ORBIT
ORDER: CROST PREON ORDER
ORGAN: CROST PREON ORGAN
OTHER: CROST TOTER OTHER
OTTER: CROST TOTER OTTER
OUGHT: CROST BIGOT OUGHT
OUNCE: CROST LOCIE OUNCE
OUTDO: CROST TONEY TATOU OUTDO
OUTER: CROST TOTER OUTER
OUTGO: CROST TONEY TATOU OUTDO OUTGO
OVARY: CROST MOREL RAYON OVARY
OVATE: CROST TONEY METOL AWETO OVATE
OVERT: CROST BOART OVERT
OVINE: CROST LODEN VENOM OVINE
OVOID: CROST DOOLE AGOOD OVOID
OWING: CROST LODEN MANGO OWING
OWNER: CROST MOREL ROKED OWNER
OXIDE: CROST LODEN DEMOI EJIDO OXIDE
OZONE: CROST DOOLE OHONE OZONE
PADDY: CROST LIANE GAMBA PAWED PADDY
PAGAN: CROST LIANE MANGA PAGAN
PAINT: CROST LEANT DAUNT FAINT TAINT PAINT
PALER: CROST RARED LAGER PALER
PALSY: CROST SALSE BALSA PALSY
PANEL: CROST LIANE VENAL PANEL
PANIC: CROST LANCE MANIC PANIC
PANSY: CROST SALSE PAISA PANSY
PAPAL: CROST LIANE PALAY PAPAL
PAPER: CROST RARED LAGER VAPER JAPER PAPER
PARER: CROST RARED FARER YARER PARER
PARKA: CROST RARED MARKA PARKA
PARRY: CROST RARED MARRY HARRY PARRY
PARSE: CROST RAISE PARSE
PARTY: CROST TERAI YURTA PARTY
PASTA: CROST TEATS VISTA PASTA
PASTE: CROST TEATS PASTE
PASTY: CROST TEATS VISTA PASTY
PATCH: CROST TACHE BATCH GATCH NATCH MATCH
PATIO: CROST TONEY TATOU MATZO PATIO
PATSY: CROST TAISH PATSY
PATTY: CROST TATIE FATTY PATTY
PAUSE: CROST SALSE HAUSE PAUSE
PAYEE: CROST LIANE MADGE PAYEE
PAYER: CROST RARED LAGER VAPER PAWER PAYER
PEACE: CROST LANCE AMICE PEACE
PEACH: CROST LANCE BEACH PEACH
PEARL: CROST RARED LEARY PEARL
PECAN: CROST LANCE PECAN
PEDAL: CROST LIANE ABLED MEDAL DEDAL PEDAL
PENAL: CROST LIANE VENAL GENAL PENAL
PENCE: CROST LANCE PUNCE PENCE
PENNE: CROST LIANE PENNE
PENNY: CROST LIANE PHENE PENNY
PERCH: CROST RACED PERCH
PERIL: CROST RARED VIRGE FERMI PERIL
PERKY: CROST RARED VIRGE KEREL PERKY
PESKY: CROST LANES SPIDE PESKY
PESTO: CROST TOLTS PESTO
PETAL: CROST TATIE PETAL
PETTY: CROST TATIE NETTY JETTY PETTY
PHASE: CROST SALSE AMUSE FEASE PHASE
PHONE: CROST DOOLE GNOME AXONE PHONE
PHONY: CROST DOOLE ANOMY PHONY
PHOTO: CROST ZLOTE BOOTH PHOTO
PIANO: CROST LODEN MANGO PIANO
PICKY: CROST LANCE DUCHY KICKY MICKY WICKY
PIECE: CROST LANCE DEUCE PIECE
PIETY: CROST TATIE MEITH PIETY
PIGGY: CROST LIANE MIDGY BIGGY PIGGY
PILOT: CROST BIGOT PILOT
PINCH: CROST LANCE PINCH
PINEY: CROST LIANE VINED WINEY PINEY
PINKY: CROST LIANE KINDY ZINKY PINKY
PINTO: CROST TONEY PUNTO PANTO PINTO
PIPER: CROST RARED LIVER BINER PIKER PIPER
PIQUE: CROST LIANE KIDGE PIXIE PIQUE
PITCH: CROST TACHE DITCH MITCH HITCH BITCH
PITHY: CROST TATIE WITHY PITHY
PIVOT: CROST BIGOT PILOT PINOT PIVOT
PIXEL: CROST LIANE BILED ZIZEL GIMEL PIXEL
PIXIE: CROST LIANE KIDGE PIXIE
PIZZA: CROST LIANE BIVIA KIPPA PIZZA
PLACE: CROST LANCE GLACE PLACE
PLAID: CROST LIANE FLAIL GLAIK PLAID
PLAIN: CROST LIANE PLAIN
PLAIT: CROST LEANT BLATT PLAIT
PLANE: CROST LIANE ALANE PLANE
PLANK: CROST LIANE KLANG BLANK PLANK
PLANT: CROST LEANT PLANT
PLATE: CROST TATIE ALATE ELATE BLATE PLATE
PLAZA: CROST LIANE FLAMY PLAZA
PLEAD: CROST LIANE ABLED PLEAD
PLEAT: CROST LEANT ABLET PLEAT
PLIED: CROST LIANE KELIM FLEXI PLIED
PLIER: CROST RARED LIVER FLIER PLIER
PLUCK: CROST LANCE FLICK PLUCK
PLUMB: CROST LIANE GULPY FLUMP PLUMB
PLUME: CROST LIANE GLEBE PLUME
PLUMP: CROST LIANE GULPY FLUMP PLUMP
PLUNK: CROST LIANE FLUNG PLUNK
PLUSH: CROST SALSE FLISK PLUSH
POESY: CROST SOUSE POESY
POINT: CROST BIGOT POINT
POISE: CROST SOUSE POISE
POKER: CROST MOREL ROWED HONER FOYER JOKER
POLAR: CROST MOREL LOBAR POLAR
POLKA: CROST LODEN POLLY POLKA
POLYP: CROST LODEN POLLY POLYP
POOCH: CROST PHOCA POOCH
POPPY: CROST LODEN GOMPA HOPPY POPPY
PORCH: CROST RECCO PORCH
POSER: CROST DORES SOLER NOSER HOSER POSER
POSIT: CROST BESOT POSIT
POSSE: CROST SOUSE POSSE
POUCH: CROST LOCIE GOUCH VOUCH POUCH
POUND: CROST LODEN DOWNA HOUND FOUND MOUND
POUTY: CROST TONEY BOTHY GOUTY POUTY
POWER: CROST MOREL ROWED VOWER BOWER POWER
PRANK: CROST BREAD GRAIP PRANK
PRAWN: CROST BREAD GRAIP PRANK PRAWN
PREEN: CROST BREAD GREEK PREEN
PRESS: CROST PRASE PRESS
PRICE: CROST BRACE GRICE DRICE PRICE
PRICK: CROST BRACE WRICK PRICK
PRIDE: CROST BREAD PRIDE
PRIED: CROST BREAD PRIED
PRIME: CROST BREAD GRIPE PRIME
PRIMO: CROST PREON PRIMO
PRINT: CROST PRATT PRINT
PRIOR: CROST PREON PRIOR
PRISM: CROST PRASE PRISS PRISM
PRIVY: CROST BREAD GRIMY PRIVY
PRIZE: CROST BREAD GRIPE PRIME PRIZE
PROBE: CROST DRONE PROKE PROLE PRORE PROBE
PRONE: CROST DRONE GRONE PRONE
PRONG: CROST DRONE PRONG
PROOF: CROST DRONE GROOM BROOL PROOF
PROSE: CROST PROSE
PROUD: CROST DRONE BROAD PROUD
PROVE: CROST DRONE PROKE PROLE PRORE PROBE
PROWL: CROST DRONE GROOM PROWL
PROXY: CROST DRONE GROOM PROWL PROXY
PRUDE: CROST BREAD PRIDE PRUDE
PRUNE: CROST BREAD GRIPE PRUNE
PSALM: CROST LANES SPAIL PSALM
PUBIC: CROST LANCE DUCHY PUBIC
PUDGY: CROST LIANE PYGMY PUDGY
PUFFY: CROST LIANE PYGMY PUPPY PUFFY
PULPY: CROST LIANE GULPY PULPY
PULSE: CROST SALSE PULSE
PUNCH: CROST LANCE PINCH PUNCH
PUPAL: CROST LIANE PALAY PUPAL
PUPIL: CROST LIANE PUGIL PUPIL
PUPPY: CROST LIANE PYGMY PUPPY
PUREE: CROST RARED LUREX PUREE
PURER: CROST RARED FIRER PURER
PURGE: CROST RARED VIRGE GURGE PURGE
PURSE: CROST RAISE PURSE
PUSHY: CROST LANES HUSKY GUSHY PUSHY
PUTTY: CROST TATIE NUTTY JUTTY VUTTY BUTTY
PYGMY: CROST LIANE PYGMY
QUACK: CROST LANCE KIACK QUACK
QUAIL: CROST LIANE FLAIL QUAIL
QUAKE: CROST LIANE AGAVE FEAZE QUAKE
QUALM: CROST LIANE FLAMY DWALM QUALM
QUARK: CROST RARED UNARM QUARK
QUART: CROST RELIT TURNT QUART
QUASH: CROST SALSE AGISM QUASH
QUASI: CROST SALSE AGISM QUASI
QUEEN: CROST LIANE NEEDY WHEEN QUEEN
QUEER: CROST RARED LIVER HEWER EMBER QUEER
QUELL: CROST LIANE DEBEL QUELL
QUERY: CROST RARED EMERY FIERY QUERY
QUEST: CROST GEIST EWEST BLEST QUEST
QUEUE: CROST LIANE DEEVE QUEME QUEUE
QUICK: CROST LANCE YUCCH QUICK
QUIET: CROST LEANT BIDET QUIET
QUILL: CROST LIANE PUGIL QUILL
QUILT: CROST LEANT GUILT QUILT
QUIRK: CROST RARED KNURL QUIRK
QUITE: CROST TATIE ELITE UNITE QUITE
QUOTA: CROST ZLOTE BOOTH DIOTA QUOTA
QUOTE: CROST ZLOTE EMOTE QUOTE
QUOTH: CROST ZLOTE BOOTH QUOTH
RABBI: CROST RARED RANGY RAJAH RABBI
RABID: CROST RARED RANID RAPID RABID
RACER: CROST RACED RACER
RADAR: CROST RARED RADAR
RADII: CROST RARED RADIX RADII
RADIO: CROST MOREL RAYON RAUPO RADIO
RAINY: CROST RARED RANGY RAINY
RAISE: CROST RAISE
RAJAH: CROST RARED RANGY RAJAH
RALLY: CROST RARED RANGY RALLY
RALPH: CROST RARED RANGY RAJAH RALPH
RAMEN: CROST RARED RAVEN RAMEN
RANCH: CROST RACED RANCH
RANDY: CROST RARED RADIX RANDY
RANGE: CROST RARED RAINE RANKE RANGE
RAPID: CROST RARED RANID RAPID
RARER: CROST RARED RARER
RASPY: CROST SERAI GAURS RASPY
RATIO: CROST TOTER NITRO RATIO
RATTY: CROST TERAI RATHA RATTY
RAVEN: CROST RARED RAVEN
RAYON: CROST MOREL RAYON
RAZOR: CROST MOREL RAYON RAZOR
REACH: CROST RACED REACH
REACT: CROST RECIT REACT
READY: CROST RARED REDAN READY
REALM: CROST RARED RENAL REALM
REARM: CROST RARED REGAR REARM
REBAR: CROST RARED REGAR REBAR
REBEL: CROST RARED REPEL REFEL REVEL REBEL
REBUS: CROST SERAI REDES RESUS REBUS
REBUT: CROST RELIT REVET REBUT
RECAP: CROST RACED RECAL RECAP
RECUR: CROST RACED RUCHE RECUR
RECUT: CROST RECIT RECUT
REEDY: CROST RARED RUDIE REEDY
REFER: CROST RARED RIFER REFER
REFIT: CROST RELIT REBIT REFIT
REGAL: CROST RARED RENAL REGAL
REHAB: CROST RARED RENAL REMAP REHAB
REIGN: CROST RARED RELIE REINK REIGN
RELAX: CROST RARED RENAL RELAX
RELAY: CROST RARED RENAL RELAX RELAY
RELIC: CROST RACED RELIC
REMIT: CROST RELIT REBIT REFIT REMIT
RENAL: CROST RARED RENAL
RENEW: CROST RARED REPEL REMEN RENEW
REPAY: CROST RARED RENAL REMAP REPAY
REPEL: CROST RARED REPEL
REPLY: CROST RARED RELIE REFLY REPLY
RERUN: CROST RARED RERUN
RESET: CROST SPRAT RESIT RESET
RESIN: CROST SERAI KEIRS RESID RESIN
RETCH: CROST RECTI RETCH
RETRO: CROST TOTER RETRO
RETRY: CROST TERAI METRE RETRY
REUSE: CROST RAISE RUSSE REUSE
REVEL: CROST RARED REPEL REFEL REVEL
REVUE: CROST RARED RELIE REVUE
RHINO: CROST MOREL RAYON RHINO
RHYME: CROST RARED RELIE RHYNE RHYME
RIDER: CROST RARED RIDER
RIDGE: CROST RARED RUDIE RIDGE
RIFLE: CROST RARED RELIE RIFLE
RIGHT: CROST RELIT RIANT RIGHT
RIGID: CROST RARED RIGID
RIGOR: CROST MOREL RAYON RIGOR
RINSE: CROST RAISE RINSE
RIPEN: CROST RARED REPEL RIPEN
RIPER: CROST RARED RIFER RIMER RIVER RIPER
RISEN: CROST SERAI RILES RISER RISEN
RISER: CROST SERAI RILES RISER
RISKY: CROST SERAI RUINS RISKY
RIVAL: CROST RARED RIMAE RIVAL
RIVER: CROST RARED RIFER RIMER RIVER
RIVET: CROST RELIT RIVET
ROACH: CROST RECCO ROACH
ROAST: CROST ROIST ROYST ROUST ROAST
ROBIN: CROST MOREL BOARD ROBIN
ROBOT: CROST BOART ROBOT
ROCKY: CROST RECCO RACON ROCKY
RODEO: CROST MOREL ROWED RODEO
ROGER: CROST MOREL ROWED ROVEN ROPER ROGER
ROGUE: CROST MOREL ROUEN ROGUE
ROOMY: CROST ADORE PROOF ROOKY ROOMY
ROOST: CROST ROOST
ROTOR: CROST TOTER ROTOR
ROUGE: CROST MOREL ROUEN ROUGE
ROUGH: CROST MOREL BOARD ROUGH
ROUND: CROST MOREL BOARD ROWND ROUND
ROUSE: CROST GORSE ROUSE
ROUTE: CROST TOTER ROUTE
ROVER: CROST MOREL ROWED ROVEN ROVER
ROWDY: CROST MOREL BOARD RONDO ROWDY
ROWER: CROST MOREL ROWED ROWEN ROWER
ROYAL: CROST MOREL ROYAL
RUDDY: CROST RARED RINDY RUDDY
RUDER: CROST RARED RIDER RUDER
RUGBY: CROST RARED RUBIN RUGBY
RULER: CROST RARED RIFER RYPER RULER
RUMBA: CROST RARED RIMAE RUMBA
RUMOR: CROST MOREL RUMBO RUMOR
RUPEE: CROST RARED REPEL RUPEE
RURAL: CROST RARED RURAL
RUSTY: CROST TARES STIRP RUSTY
SADLY: CROST LANES SALAL SADLY
SAFER: CROST SERAI SAWER SABER SANER SAGER
SAINT: CROST SALET SAINT
SALAD: CROST LANES SALAL SALAD
SALLY: CROST LANES SALAL SALLY
SALON: CROST NOLES SALON
SALSA: CROST SALSE SALSA
SALTY: CROST TEATS VISTA SALTY
SALVE: CROST LANES SALVE
SALVO: CROST NOLES SALOP SALVO
SANDY: CROST LANES SANGA SANDY
SANER: CROST SERAI SAWER SABER SANER
SAPPY: CROST LANES PASHA SAPPY
SASSY: CROST SALSE SANSA SASSY
SATIN: CROST TEATS SATIN
SATYR: CROST TARES SATYR
SAUCE: CROST SAICE SAUCE
SAUCY: CROST SAICE SAUCY
SAUNA: CROST LANES BASAN SAUNA
SAUTE: CROST TEATS PASTE SAUTE
SAVOR: CROST DORES ASPRO SAVOR
SAVOY: CROST NOLES SPADO SAVOY
SAVVY: CROST LANES PASHA SAGUM SAVVY
SCALD: CROST SAICE SCALP SCALY SCALA SCALL
SCALE: CROST SAICE SCAPE SCALE
SCALP: CROST SAICE SCALP
SCALY: CROST SAICE SCALP SCALY
SCAMP: CROST SAICE SCALP SCAMP
SCANT: CROST SCEAT SCANT
SCARE: CROST ACRES SCARE
SCARF: CROST ACRES SCARF
SCARY: CROST ACRES SCARF SCARP SCARY
SCENE: CROST SAICE SYCEE SCENE
SCENT: CROST SCEAT SCENT
SCION: CROST SOCLE SCUDO SCION
SCOFF: CROST SCOWP SCOUG SCODY SCOFF
SCOLD: CROST SCOWP SCOUG SCODY SCOLD
SCONE: CROST SCOWP SCOUG SCODY SCOFF SCONE
SCOOP: CROST SCOWP SCOUP SCOOP
SCOPE: CROST SCOWP SCOPA SCOPE
SCORE: CROST SCORE
SCORN: CROST SCORE SCORN
SCOUR: CROST SCORE SCOUR
SCOUT: CROST SCOUT
SCOWL: CROST SCOWP SCOWS SCOWL
SCRAM: CROST ACRES SCRAM
SCRAP: CROST ACRES SCRAM SCRAG SCRAW SCRAN
SCREE: CROST ACRES SCREW SCREE
SCREW: CROST ACRES SCREW
SCRUB: CROST ACRES SCRIM SCRUB
SCRUM: CROST ACRES SCRIM SCRUM
SCUBA: CROST SAICE SCALP SCUBA
SEDAN: CROST LANES SNEAK SEDAN
SEEDY: CROST LANES SPIDE SEEDY
SEGUE: CROST LANES SPIDE SMEKE SEGUE
SEIZE: CROST LANES SPIDE SHIVE SEIZE
SEMEN: CROST LANES SEWEN SEYEN SEVEN SEMEN
SENSE: CROST SALSE SEISE SENSE
SEPIA: CROST LANES SEPAD SEPIA
SERIF: CROST SERAI SERIF
SERUM: CROST SERAI SERRE SERKS SERUM
SERVE: CROST SERAI SERRE SERVE
SETUP: CROST TEATS SETUP
SEVEN: CROST LANES SEWEN SEYEN SEVEN
SEVER: CROST SERAI SEFER SEDER SEXER SEWER
SEWER: CROST SERAI SEFER SEDER SEXER SEWER
SHACK: CROST SAICE SMACK SHACK
SHADE: CROST LANES SEPAD SHADE
SHADY: CROST LANES SHAMA SHADY
SHAFT: CROST SALET SHAKT SHAFT
SHAKE: CROST LANES SEPAD SHEVA SHAME SHAKE
SHAKY: CROST LANES SHAMA SHADY SHAKY
SHALE: CROST LANES PEALS SWALE SHALE
SHALL: CROST LANES SPAIL SHAWL SHAUL SHALL
SHALT: CROST SALET SMALT SHALT
SHAME: CROST LANES SEPAD SHEVA SHAME
SHANK: CROST LANES SWANK SKANK SPANK SHANK
SHAPE: CROST LANES SEPAD SPAKE SHAPE
SHARD: CROST SERAI SHARP SHARD
SHARE: CROST SERAI SAWER SNARE SPARE SHARE
SHARK: CROST SERAI SHARP SHARD SHARN SHARK
SHARP: CROST SERAI SHARP
SHAVE: CROST LANES SEPAD SHEVA SHAVE
SHAWL: CROST LANES SPAIL SHAWL
SHEAR: CROST SERAI SPEAR SMEAR SWEAR SHEAR
SHEEN: CROST LANES SEWEN SKEEN SHEEN
SHEEP: CROST LANES SPEED SWEEP SHEEP
SHEER: CROST SERAI SKYRE SUPER SWEER SLEER
SHEET: CROST SALET SWEET SKEET SHEET
SHEIK: CROST LANES SPIDE SMEIK SHEIK
SHELF: CROST LANES SPEIL SKELF SHELF
SHELL: CROST LANES SPEIL SKELL SHELL
SHIED: CROST LANES SPEED SKIED SHIED
SHIFT: CROST SALET SHUNT SHIFT
SHINE: CROST LANES SPINE SHINE
SHINY: CROST LANES SPUNK SWING SHINY
SHIRE: CROST SERAI SIKER SWIRE SPIRE SHIRE
SHIRK: CROST SERAI SKIRR SMIRK SHIRK
SHIRT: CROST SPRAT SNIRT SKIRT SHIRT
SHOAL: CROST POOLS SLOID SHOAL
SHOCK: CROST SCOWP SMOCK SHOCK
SHONE: CROST POOLS SNOKE SHONE
SHOOK: CROST POOLS SHOON SHOOK
SHOOT: CROST STOPT SMOOT SHOOT
SHORE: CROST SHORN SHORE
SHORN: CROST SHORN
SHORT: CROST SNORT SPORT SHORT
SHOUT: CROST STOPT SMOOT SHOUT
SHOVE: CROST POOLS SNOKE SHOVE
SHOWN: CROST POOLS SNOKE SWOUN SHOWN
SHOWY: CROST POOLS SNOKE SHOWY
SHREW: CROST SERAI SPRUE SHREW
SHRUB: CROST SERAI SURGY SHRUB
SHRUG: CROST SERAI SURGY SPRUG SHRUG
SHUCK: CROST SAICE SYNCH SHUCK
SHUNT: CROST SALET SHUNT
SHUSH: CROST SALSE SHISH SHUSH
SHYLY: CROST LANES SILLY SHYLY
SIEGE: CROST LANES SPIDE SIEGE
SIEVE: CROST LANES SPIDE SIEGE SIEVE
SIGHT: CROST SALET SHUNT SIGHT
SIGMA: CROST LANES SHAMA SUMMA SIGMA
SILKY: CROST LANES SILLY SILKY
SILLY: CROST LANES SILLY
SINCE: CROST SAICE SINCE
SINEW: CROST LANES SYNED SINEW
SINGE: CROST LANES SENVY SINGE
SIREN: CROST SERAI SIRES SIRED SIREE SIREN
SISSY: CROST SALSE SHISH SISSY
SIXTH: CROST TEATS MISTY SIXTH
SIXTY: CROST TEATS MISTY SILTY SIXTY
SKATE: CROST TEATS SPATE SKATE
SKIER: CROST SERAI SIKER SKIER
SKIFF: CROST LANES HUSKY SKIMP SKIFF
SKILL: CROST LANES SILLY SPILL SHILL SKILL
SKIMP: CROST LANES HUSKY SKIMP
SKIRT: CROST SPRAT SNIRT SKIRT
SKULK: CROST LANES SILLY SKULK
SKULL: CROST LANES SILLY SKULL
SKUNK: CROST LANES SPUNK SKUNK
SLACK: CROST SAICE SMACK SHACK SLACK
SLAIN: CROST LANES SLANK SLAIN
SLANG: CROST LANES SLANK SLANG
SLANT: CROST SALET SMALT SLANT
SLASH: CROST SALSE SLASH
SLATE: CROST TEATS SPATE SKATE SLATE
SLAVE: CROST LANES PEALS SLAKE SLAVE
SLEEK: CROST LANES SPEEL SLEEK
SLEEP: CROST LANES SPEEL SLEEP
SLEET: CROST SALET SLEET
SLEPT: CROST SALET SLEPT
SLICE: CROST SAICE SLICE
SLICK: CROST SAICE SPICK SLICK
SLIDE: CROST LANES SPEIL SMILE SLIDE
SLIME: CROST LANES SPEIL SMILE SLIME
SLIMY: CROST LANES SILLY SLIMY
SLING: CROST LANES SLUNG SLING
SLINK: CROST LANES SLUNG SLINK
SLOOP: CROST POOLS SLOOP
SLOPE: CROST POOLS SLOPY SLOPE
SLOSH: CROST SKOSH SPOSH SLOSH
SLOTH: CROST POOTS SHOTE SLOTH
SLUMP: CROST LANES SILLY SLUBB SLUMP
SLUNG: CROST LANES SLUNG
SLUNK: CROST LANES SLUNG SLUNK
SLURP: CROST SERAI SPURS SLURP
SLUSH: CROST SALSE SLISH SLUSH
SLYLY: CROST LANES SILLY SLYLY
SMACK: CROST SAICE SMACK
SMALL: CROST LANES SPAIL SHAWL SMALL
SMART: CROST SPRAT SWART SLART START SKART
SMASH: CROST SALSE SWASH SNASH SHASH SMASH
SMEAR: CROST SERAI SPEAR SMEAR
SMELL: CROST LANES SPEIL SKELL SHELL SMELL
SMELT: CROST SALET SLEPT SMELT
SMILE: CROST LANES SPEIL SMILE
SMIRK: CROST SERAI SKIRR SMIRK
SMITE: CROST TEATS SUITE SHITE SKITE SPITE
SMITH: CROST TEATS MISTY SMITH
SMOCK: CROST SCOWP SMOCK
SMOKE: CROST POOLS SNOKE SMOKE
SMOKY: CROST POOLS SNOKE SMOKY
SMOTE: CROST POOTS SHOTE SMOTE
SNACK: CROST SAICE SMACK SHACK SLACK SNACK
SNAIL: CROST LANES SLANK SNAIL
SNAKE: CROST LANES SNEAK SNAKE
SNAKY: CROST LANES SWANK SNAKY
SNARE: CROST SERAI SAWER SNARE
SNARL: CROST SERAI SHARP SNARF SNARL
SNEAK: CROST LANES SNEAK
SNEER: CROST SERAI SKYRE SUPER SWEER SLEER
SNIDE: CROST LANES SPINE SNIDE
SNIFF: CROST LANES SPUNK SNIFF
SNIPE: CROST LANES SPINE SNIPE
SNOOP: CROST POOLS SPOON SNOOP
SNORE: CROST SHORN SNORE
SNORT: CROST SNORT
SNOUT: CROST STOPT SMOOT SHOUT SNOUT
SNOWY: CROST POOLS SNOKE SNOWY
SNUCK: CROST SAICE SYNCH SNUCK
SNUFF: CROST LANES SPUNK SNUFF
SOAPY: CROST NOLES SOPHY SOUPY SOAPY
SOBER: CROST DORES SOLER SOBER
SOGGY: CROST NOLES SOPHY SOGGY
SOLAR: CROST DORES SONAR SOWAR SOLAR
SOLID: CROST NOLES SOLID
SOLVE: CROST NOLES SOLDE SOLVE
SONAR: CROST DORES SONAR
SONIC: CROST SOCLE SODIC SONIC
SOOTH: CROST POOTS SOOTY SOOTE SOOTH
SOOTY: CROST POOTS SOOTY
SORRY: CROST DORES SORRA SORRY
SOUND: CROST NOLES SOUND
SOUTH: CROST TOLTS SOFTA SOWTH SOUTH
SOWER: CROST DORES SOLER SOBER SOWER
SPACE: CROST SAICE SPACE
SPADE: CROST LANES SEPAD SPADE
SPANK: CROST LANES SWANK SKANK SPANK
SPARE: CROST SERAI SAWER SNARE SPARE
SPARK: CROST SERAI SHARP SPARD SPARK
SPASM: CROST SALSE SWASH SPASM
SPAWN: CROST LANES SWANK SHAWN SPAWN
SPEAK: CROST LANES SEPAD SPEAK
SPEAR: CROST SERAI SPEAR
SPECK: CROST SAICE SPECK
SPEED: CROST LANES SPEED
SPELL: CROST LANES SPEIL SPELL
SPELT: CROST SALET SLEPT SPELT
SPEND: CROST LANES SPINE SPEND
SPENT: CROST SALET STEPT SPENT
SPERM: CROST SERAI SKYRE SWERF SHERD SPERM
SPICE: CROST SAICE SLICE SPICE
SPICY: CROST SAICE SPICK SPICS SPICY
SPIED: CROST LANES SPEED SPUED SPIED
SPIEL: CROST LANES SPEEL SPIEL
SPIKE: CROST LANES SPIDE SPIKE
SPIKY: CROST LANES HUSKY SPIKY
SPILL: CROST LANES SILLY SPILL
SPILT: CROST SALET SPILT
SPINE: CROST LANES SPINE
SPINY: CROST LANES SPUNK SPINY
SPIRE: CROST SERAI SIKER SWIRE SPIRE
SPITE: CROST TEATS SUITE SHITE SKITE SPITE
SPLAT: CROST SALET SPLAT
SPLIT: CROST SALET SPLIT
SPOIL: CROST POOLS SLOPY SPOIL
SPOKE: CROST POOLS SPODE SPOKE
SPOOF: CROST POOLS SPOON SPOOF
SPOOK: CROST POOLS SPOON SPOOF SPOOK
SPOOL: CROST POOLS SLOOP SPOOL
SPOON: CROST POOLS SPOON
SPORE: CROST SHORN SMORE SPORE
SPORT: CROST SNORT SPORT
SPOUT: CROST STOPT SPOOT SPOUT
SPRAY: CROST SERAI SURAH SPRAD SPRAY
SPREE: CROST SERAI SPRUE SPREE
SPRIG: CROST SERAI SIRIH SPRIG
SPUNK: CROST LANES SPUNK
SPURN: CROST SERAI SPURS SPURN
SPURT: CROST SPRAT SPIRT SPURT
SQUAD: CROST LANES SHAMA SWARD SQUAD
SQUAT: CROST SALET SHAKT SQUAT
SQUIB: CROST LANES HUSKY BAUDS SQUIB
STACK: CROST TACES SCUTA STACK
STAFF: CROST TEATS STANG STALL STAPH STAID
STAGE: CROST TEATS STAVE STALE STAKE STADE
STAID: CROST TEATS STANG STALL STAPH STAID
STAIN: CROST TEATS STANG STAIN
STAIR: CROST TARES STARR STAIR
STAKE: CROST TEATS STAVE STALE STAKE
STALE: CROST TEATS STAVE STALE
STALK: CROST TEATS STANG STALL STALK
STALL: CROST TEATS STANG STALL
STAMP: CROST TEATS STANG STALL STAPH STAMP
STAND: CROST TEATS STANG STANK STAND
STANK: CROST TEATS STANG STANK
STARE: CROST TARES STEAR STARE
STARK: CROST TARES STARR STARN STARK
START: CROST SPRAT SWART SLART START
STASH: CROST TAISH STASH
STATE: CROST TEATS STATE
STAVE: CROST TEATS STAVE
STEAD: CROST TEATS STEAM STEAK STEAN STEAL
STEAK: CROST TEATS STEAM STEAK
STEAL: CROST TEATS STEAM STEAK STEAN STEAL
STEAM: CROST TEATS STEAM
STEED: CROST TEATS STELE STEEP STEED
STEEL: CROST TEATS STELE STEEL
STEEP: CROST TEATS STELE STEEP
STEER: CROST TARES STEER
STEIN: CROST TEATS STELE STEND STEIN
STERN: CROST TARES TIERS STERN
STICK: CROST TACES STUCK STICK
STIFF: CROST TEATS STIMY STILB STINK STIFF
STILL: CROST TEATS STIMY STILB STILL
STILT: CROST SALET SPILT STILT
STING: CROST TEATS STIMY STILB STINK STING
STINK: CROST TEATS STIMY STILB STINK
STINT: CROST SALET SHUNT STINT
STOCK: CROST STOIC STOCK
STOIC: CROST STOIC
STOKE: CROST POOTS STONE STOLE STOKE
STOLE: CROST POOTS STONE STOLE
STOMP: CROST POOTS STOPE STOMP
STONE: CROST POOTS STONE
STONY: CROST POOTS STONE STONG STONN STONY
STOOD: CROST POOTS STOOD
STOOL: CROST POOTS STOOD STOOK STOOL
STOOP: CROST POOTS STOOP
STORE: CROST STORY STORE
STORK: CROST STORY STORE STORM STORK
STORM: CROST STORY STORE STORM
STORY: CROST STORY
STOUT: CROST STOPT STOUT
STOVE: CROST POOTS STONE STOLE STOKE STOVE
STRAP: CROST TARES STRAW STRAK STRAD STRAP
STRAW: CROST TARES STRAW
STRAY: CROST TARES STRAW STRAK STRAD STRAP
STRIP: CROST TARES STRUM STRIG STRIP
STRUT: CROST SPRAT STRUT
STUCK: CROST TACES STUCK
STUDY: CROST TEATS STIMY STUDY
STUFF: CROST TEATS STIMY STUNK STULL STUFF
STUMP: CROST TEATS STIMY STUMP
STUNG: CROST TEATS STIMY STUNK STUNG
STUNK: CROST TEATS STIMY STUNK
STUNT: CROST SALET SHUNT STUNT
STYLE: CROST TEATS STELE STILE STYLE
SUAVE: CROST LANES SEPAD SHEVA SUAVE
SUGAR: CROST SERAI SYMAR SUGAR
SUING: CROST LANES SPUNK SUING
SUITE: CROST TEATS SUITE
SULKY: CROST LANES SILLY SULKY
SULLY: CROST LANES SILLY SULLY
SUMAC: CROST SAICE SCALP SUMAC
SUNNY: CROST LANES SINKY SUNNY
SUPER: CROST SERAI SKYRE SUPER
SURER: CROST SERAI SPRUE SURES SURER
SURGE: CROST SERAI SPRUE SURGE
SURLY: CROST SERAI SURGY SURFY SURLY
SUSHI: CROST LANES HUSKY WUSHU SUSHI
SWAMI: CROST LANES SHAMA SWAMI
SWAMP: CROST LANES SHAMA SWAMI SWAMP
SWARM: CROST SERAI SHARP SNARF SMARM SWARM
SWASH: CROST SALSE SWASH
SWATH: CROST TEATS SNATH SWATH
SWEAR: CROST SERAI SPEAR SMEAR SWEAR
SWEAT: CROST SALET SWEAT
SWEEP: CROST LANES SPEED SWEEP
SWEET: CROST SALET SWEET
SWELL: CROST LANES SPEIL SKELL SHELL SMELL
SWEPT: CROST SALET STEPT SWEPT
SWIFT: CROST SALET SHUNT SWIFT
SWILL: CROST LANES SILLY SPILL SHILL SKILL
SWINE: CROST LANES SPINE SHINE SWINE
SWING: CROST LANES SPUNK SWING
SWIRL: CROST SERAI SKIRR SHIRS SPIRY SWIRL
SWISH: CROST SALSE SHISH SWISH
SWOON: CROST POOLS SHOON SWOON
SWOOP: CROST POOLS SPOON SWOOP
SWORD: CROST SHORN SMORE SPORK SWORD
SWORE: CROST SHORN SMORE SPORE SWORE
SWORN: CROST SHORN SWORN
SWUNG: CROST LANES SPUNK SWUNG
SYNOD: CROST NOLES BISON SYNOD
SYRUP: CROST SERAI SURGY SYRUP
TABBY: CROST TATIE TALAK TANGY TABBY
TABLE: CROST TATIE TAUBE TABLE
TABOO: CROST TONEY TABOO
TACIT: CROST LACET YACHT TACIT
TACKY: CROST TACHE TACAN TACKY
TAFFY: CROST TATIE TALAK TANGY TABBY TAFFY
TAINT: CROST LEANT DAUNT FAINT TAINT
TAKEN: CROST TATIE TAPED TAKEN
TAKER: CROST TERAI TAMER TAXER TAPER TAKER
TALLY: CROST TATIE TALAK TALLY
TALON: CROST TONEY TAUON TAXON TALON
TAMER: CROST TERAI TAMER
TANGO: CROST TONEY TANTO TANGO
TANGY: CROST TATIE TALAK TANGY
TAPER: CROST TERAI TAMER TAXER TAPER
TAPIR: CROST TERAI TAPIR
TARDY: CROST TERAI TARTY TARDY
TAROT: CROST BOART TAROT
TASTE: CROST TEATS TASTE
TASTY: CROST TEATS TASTY
TATTY: CROST TATIE TATTY
TAUNT: CROST LEANT DAUNT HAUNT JAUNT GAUNT
TAWNY: CROST TATIE TALAK TANGY TAWNY
TEACH: CROST TACHE TEACH
TEARY: CROST TERAI TETRA TEARY
TEASE: CROST TAISH TEASE
TEDDY: CROST TATIE TEEND TEDDY
TEETH: CROST TATIE TENTY TEETH
TEMPO: CROST TONEY TEMPO
TENET: CROST LEANT GENET BENET TENET
TENOR: CROST TOTER TENOR
TENSE: CROST TAISH TEMSE TENSE
TENTH: CROST TATIE TENTY TENTH
TEPEE: CROST TATIE TENUE TEPEE
TEPID: CROST TATIE TEPID
TERRA: CROST TERAI TERGA TERRA
TERSE: CROST TERSE
TESTY: CROST TEATS TESTY
THANK: CROST TATIE THUYA THANK
THEFT: CROST LEANT BIDET WHEFT THEFT
THEIR: CROST TERAI TIGER THEIR
THEME: CROST TATIE TENUE THEBE THEME
THERE: CROST TERAI TWYER THERE
THESE: CROST TAISH THESP THESE
THETA: CROST TATIE THETA
THICK: CROST TACHE THICK
THIEF: CROST TATIE TINED THIEF
THIGH: CROST TATIE THING THIGH
THING: CROST TATIE THING
THINK: CROST TATIE THING THINK
THIRD: CROST TERAI THIRL THIRD
THONG: CROST ZLOTE STOMP THONG
THORN: CROST POORT THORN
THOSE: CROST STOSS THOSE
THREE: CROST TERAI THREW THREE
THREW: CROST TERAI THREW
THROB: CROST TOTER THROB
THROW: CROST TOTER THROB THROW
THRUM: CROST TERAI THRUM
THUMB: CROST TATIE THUMB
THUMP: CROST TATIE THUMB THUMP
THYME: CROST TATIE TENUE THYME
TIARA: CROST TERAI TAPIR TIARA
TIBIA: CROST TATIE THAIM TIBIA
TIDAL: CROST TATIE TIDAL
TIGER: CROST TERAI TIGER
TIGHT: CROST LEANT DIXIT PITOT TIGHT
TILDE: CROST TATIE TWINE TILDE
TIMER: CROST TERAI TIGER TIMER
TIMID: CROST TATIE TUPIK TIYIN TIMID
TIPSY: CROST TAISH TIPSY
TITAN: CROST TATIE TITAN
TITHE: CROST TATIE TITLE TITHE
TITLE: CROST TATIE TITLE
TOAST: CROST JOIST HOAST TOAST
TODAY: CROST TONEY TOADY TODAY
TODDY: CROST TONEY TOADY TODDY
TOKEN: CROST TONEY TOKEN
TONAL: CROST TONEY TONKA TONAL
TONGA: CROST TONEY TONKA TONGA
TONIC: CROST TONIC
TOOTH: CROST ZLOTE BOOTH TOOTH
TOPAZ: CROST TONEY TOPHI TOPAZ
TOPIC: CROST TONIC TOXIC TOPIC
TORCH: CROST ROTCH TORCH
TORSO: CROST TORSE TORSK TORSI TORSO
TORUS: CROST SORTA TORRS TORUS
TOTAL: CROST TONEY TOPHI TOTAL
TOTEM: CROST TONEY TOPED TOWEL TOTEM
TOUCH: CROST TONIC TOCKY TOUCH
TOUGH: CROST TONEY TOPHI TOUGH
TOWEL: CROST TONEY TOPED TOWEL
TOWER: CROST TOTER TOWER
TOXIC: CROST TONIC TOXIC
TOXIN: CROST TONEY TOLAN TOXIN
TRACE: CROST TRACE
TRACK: CROST TRACE TRACK
TRACT: CROST BRACT FRACT TRACT
TRADE: CROST IRATE TRADE
TRAIL: CROST IRATE TRAIL
TRAIN: CROST IRATE TRAIL TRAIK TRAIN
TRAIT: CROST PRATT TRANT TRAIT
TRAMP: CROST IRATE TRANQ TRAWL TRAYF TRAMP
TRASH: CROST TRASH
TRAWL: CROST IRATE TRANQ TRAWL
TREAD: CROST IRATE TREMA TREAD
TREAT: CROST PRATT TREAT
TREND: CROST IRATE TREND
TRIAD: CROST IRATE TRIAD
TRIAL: CROST IRATE TRIAD TRIAL
TRIBE: CROST IRATE TRIDE TRIBE
TRICE: CROST TRACE TRICE
TRICK: CROST TRACE TRICK
TRIED: CROST IRATE TRIER TRIED
TRIPE: CROST IRATE TRIDE TRIBE TRIKE TRINE
TRITE: CROST IRATE URITE TRITE
TROLL: CROST TROPE TROAK TROOZ TROTH TROLL
TROOP: CROST TROPE TROOP
TROPE: CROST TROPE
TROUT: CROST GROUT TROUT
TROVE: CROST TROPE TROKE TRODE TRONE TROVE
TRUCE: CROST TRACE TRICE TRUCE
TRUCK: CROST TRACE TRICK TRUCK
TRUER: CROST IRATE TREND TRUER
TRULY: CROST IRATE TRULL TRULY
TRUMP: CROST IRATE TRULL TRUMP
TRUNK: CROST IRATE TRULL TRUMP TRUNK
TRUSS: CROST TRASH TRUSS
TRUST: CROST TREST TRYST TRIST TRUST
TRUTH: CROST IRATE TRUTH
TRYST: CROST TREST TRYST
TUBAL: CROST TATIE THUYA TUBAL
TUBER: CROST TERAI TWYER TUBER
TULIP: CROST TATIE TUPIK TULIP
TULLE: CROST TATIE TENUE TUPLE TULLE
TUMOR: CROST TOTER TABOR TUMOR
TUNIC: CROST TACHE TYPIC TUNIC
TURBO: CROST TOTER THROB TURBO
TUTOR: CROST TOTER TUTOR
TWANG: CROST TATIE THUYA TWANG
TWEAK: CROST TATIE TESLA TWEAK
TWEED: CROST TATIE TEEND THEED TWEED
TWEET: CROST LEANT BIDET EMMET TWEET
TWICE: CROST TACHE TWICE
TWINE: CROST TATIE TWINE
TWIRL: CROST TERAI THIRL TWIRL
TWIST: CROST GEIST WAIST TWIST
TWIXT: CROST LEANT DIXIT TWIXT
TYING: CROST TATIE THING TYING
UDDER: CROST RARED EIDER NUDER UDDER
ULCER: CROST RACED PUCER ULCER
ULTRA: CROST TERAI RATHA ULTRA
UMBRA: CROST RARED UNARM UMBRA
UNCLE: CROST LANCE INCLE UNCLE
UNCUT: CROST LACET DICHT UNCUT
UNDER: CROST RARED EIDER NUDER UNDER
UNDID: CROST LIANE UNHIP UNBID UNKID UNDID
UNDUE: CROST LIANE MUNGE UNDUE
UNFED: CROST LIANE NEEDY UNWED UNFED
UNFIT: CROST LEANT INWIT UNFIT
UNIFY: CROST LIANE UNHIP UNIFY
UNION: CROST LODEN ANION ONION UNION
UNITE: CROST TATIE ELITE UNITE
UNITY: CROST TATIE MILTY UNITY
UNLIT: CROST LEANT UNLIT
UNMET: CROST LEANT UNKET UNMET
UNSET: CROST SALET UNSET
UNTIE: CROST TATIE UNTIE
UNTIL: CROST TATIE UNTIN UNTIL
UNWED: CROST LIANE NEEDY UNWED
UNZIP: CROST LIANE UNHIP UNZIP
UPPER: CROST RARED LIVER HEWER UMBER UPPER
UPSET: CROST SALET UNSET UPSET
URBAN: CROST BREAD URBAN
URINE: CROST BREAD GRIPE URINE
USAGE: CROST LANES SEPAD YSAME USAGE
USHER: CROST SERAI RUDES USHER
USING: CROST LANES SPUNK USING
USUAL: CROST LANES SPAIL USUAL
USURP: CROST SERAI RYNDS USURP
UTILE: CROST TATIE ELITE UTILE
UTTER: CROST TERAI MUTER UTTER
VAGUE: CROST LIANE MADGE GAUJE VAGUE
VALET: CROST LEANT ABLET VALET
VALID: CROST LIANE ALGID HALID VALID
VALOR: CROST MOREL VALOR
VALUE: CROST LIANE GABLE VALUE
VALVE: CROST LIANE GABLE VALUE VALVE
VAPID: CROST LIANE ZAMIA QAPIK VAPID
VAPOR: CROST MOREL RAYON VAPOR
VAULT: CROST LEANT HAULT VAULT
VAUNT: CROST LEANT DAUNT HAUNT JAUNT GAUNT
VEGAN: CROST LIANE MANED VEGAN
VENOM: CROST LODEN VENOM
VENUE: CROST LIANE MUNGE VENUE
VERGE: CROST RARED VIRGE VERGE
VERSE: CROST RAISE PURSE VERSE
VERSO: CROST GORSE VERSO
VERVE: CROST RARED VIRGE VERVE
VICAR: CROST RACED PICRA VICAR
VIDEO: CROST LODEN VIDEO
VIGIL: CROST LIANE GILLY VIGIL
VIGOR: CROST MOREL RAYON VIGOR
VILLA: CROST LIANE PILAW VILLA
VINYL: CROST LIANE NIHIL VINYL
VIOLA: CROST DOOLE AIOLI VIOLA
VIPER: CROST RARED LIVER VINER VIPER
VIRAL: CROST RARED MURAL PYRAL VIRAL
VIRUS: CROST SERAI DIRKS VIRLS VIRUS
VISIT: CROST SALET MUSIT VISIT
VISOR: CROST DORES ASPRO VISOR
VISTA: CROST TEATS VISTA
VITAL: CROST TATIE VITAL
VIVID: CROST LIANE MIDGY BIFID VIVID
VIXEN: CROST LIANE VINED VIMEN VIXEN
VOCAL: CROST LOCIE FOCAL VOCAL
VODKA: CROST LODEN PODIA VODKA
VOGUE: CROST LODEN BOGIE VOGUE
VOICE: CROST LOCIE VOICE
VOILA: CROST LODEN POLLY KOALA BOXLA VOILA
VOMIT: CROST BIGOT POINT VOMIT
VOTER: CROST TOTER DOTER NOTER VOTER
VOUCH: CROST LOCIE GOUCH VOUCH
VOWEL: CROST LODEN HOLEY VOXEL VOWEL
VYING: CROST LIANE HINNY DYING VYING
WACKY: CROST LANCE KACHA JACKY WACKY
WAFER: CROST RARED LAGER VAPER FAKER WAFER
WAGER: CROST RARED LAGER YAGER JAGER GAGER
WAGON: CROST LODEN ANION GAZON WAGON
WAIST: CROST GEIST WAIST
WAIVE: CROST LIANE MAVIE WAIVE
WALTZ: CROST TATIE WANTY WALTZ
WARTY: CROST TERAI YURTA PARTY WARTY
WASTE: CROST TEATS PASTE HASTE WASTE
WATCH: CROST TACHE BATCH GATCH NATCH MATCH
WATER: CROST TERAI RATEL MATER DATER PATER
WAVER: CROST RARED LAGER VAPER FAVER WAVER
WAXEN: CROST LIANE MANED WAKEN WAXEN
WEARY: CROST RARED LEARY WEARY
WEAVE: CROST LIANE AGAVE DEAVE HEAVE WEAVE
WEDGE: CROST LIANE DEEVE KEDGE WEDGE
WEEDY: CROST LIANE DEGUM HEWED WEEDY
WEIGH: CROST LIANE BEDIM HEIGH WEIGH
WEIRD: CROST RARED WEIRD
WELCH: CROST LANCE BLECH WELCH
WELSH: CROST SALSE WELSH
WENCH: CROST LANCE WENCH
WHACK: CROST LANCE KIACK QUACK ABACK WHACK
WHALE: CROST LIANE GLADE AVALE QUALE WHALE
WHARF: CROST RARED UNARM ALARY WHARF
WHEAT: CROST LEANT WHEAT
WHEEL: CROST LIANE DEBEL EXPEL WHEEL
WHELP: CROST LIANE DEBEL KELEP WHELP
WHERE: CROST RARED EMERY FIERE WHERE
WHICH: CROST LANCE YUCCH WHICH
WHIFF: CROST LIANE PUMIE WHIFF
WHILE: CROST LIANE ELIDE WHILE
WHINE: CROST LIANE GWINE WHINE
WHINY: CROST LIANE HINNY WHINY
WHIRL: CROST RARED KNURL WHIRL
WHISK: CROST SALSE PHISH WHISK
WHITE: CROST TATIE ELITE UNITE WHITE
WHOLE: CROST DOOLE AZOLE WHOLE
WHOOP: CROST DOOLE PHONO WHOOP
WHOSE: CROST SKOSH WHOSE
WIDEN: CROST LIANE VINED DIZEN WIDEN
WIDER: CROST RARED EIDER HIDER WIDER
WIDOW: CROST LODEN AUDIO WIDOW
WIDTH: CROST TATIE MILTY DINTS WIDTH
WIELD: CROST LIANE BILED FIELD YIELD WIELD
WIGHT: CROST LEANT DIXIT PITOT HIGHT MIGHT
WILLY: CROST LIANE GILLY DILLY WILLY
WIMPY: CROST LIANE MIDGY WIMPY
WINCE: CROST LANCE PUNCE YINCE WINCE
WINCH: CROST LANCE PINCH GINCH FINCH WINCH
WINDY: CROST LIANE KINDY WINDY
WISER: CROST SERAI RILES WISER
WISPY: CROST LANES HUSKY WISPY
WITCH: CROST TACHE DITCH MITCH HITCH BITCH
WITTY: CROST TATIE DITTY WITTY
WOKEN: CROST LODEN HOVEN WOXEN WOMEN WOKEN
WOMAN: CROST LODEN GOWAN WOMAN
WOMEN: CROST LODEN HOVEN WOXEN WOMEN
WOODY: CROST DOOLE MOODY WOODY
WOOER: CROST ADORE REOIL WOOER
WOOLY: CROST DOOLE MOOLY WOOLY
WOOZY: CROST DOOLE GOOBY WOOPY WOOZY
WORDY: CROST MOREL BORNA WORDY
WORLD: CROST MOREL LORRY WORLD
WORRY: CROST MOREL BORNA WORDY WORRY
WORSE: CROST GORSE MORSE WORSE
WORST: CROST ROIST HORST WORST
WORTH: CROST TOTER PORTY FORTH NORTH WORTH
WOULD: CROST LODEN DOLMA WOULD
WOUND: CROST LODEN DOWNA WOUND
WOVEN: CROST LODEN HOVEN WOVEN
WRACK: CROST BRACE DRACK WRACK
WRATH: CROST IRATE PRATY WRATH
WREAK: CROST BREAD AREAL WREAK
WRECK: CROST BRACE DRECK WRECK
WREST: CROST TREST WREST
WRING: CROST BREAD GRIMY WRING
WRIST: CROST TREST WRIST
WRITE: CROST IRATE URITE TRITE WRITE
WRONG: CROST DRONE PRONG WRONG
WROTE: CROST TROPE WROTE
WRUNG: CROST BREAD GRIMY WRUNG
WRYLY: CROST BREAD GRIMY WRYLY
YACHT: CROST LACET YACHT
YEARN: CROST RARED LEARY YEARN
YEAST: CROST GEIST FEAST YEAST
YIELD: CROST LIANE BILED FIELD YIELD
YOUNG: CROST LODEN GONIA YOUNG
YOUTH: CROST TONEY YOUTH
ZEBRA: CROST RARED LEARY HEJRA ZEBRA
ZESTY: CROST TEATS SEITY ZESTY
ZONAL: CROST LODEN MONAL ZONAL
Success: 2248
Fail: 67
Avg guess: 4.105
