ABACK: TALCS REACH KIACK QUACK ABACK
ABASE: TALCS SPAER MEASE ABASE
ABATE: TALCS IRATE ABATE
ABBEY: TALCS ARENA AZIDE ABBEY
ABBOT: TALCS IRATE ADBOT ABBOT
ABHOR: TALCS ARENA AMOUR ABHOR
ABIDE: TALCS ARENA AZIDE AMIDE ABIDE
ABLED: TALCS POLAR BULLA ABLED
ABODE: TALCS ARENA AZIDE APODE ABODE
ABORT: TALCS IRATE MORAT ABORT
ABOUT: TALCS IRATE ADBOT ABOUT
ABOVE: TALCS ARENA AZIDE AMOVE ABOVE
ABUSE: TALCS SPAER ISNAE ABUSE
ABYSS: TALCS SEARS ASPIS ABYSS
ACORN: TALCS CRENA ACORN
ACRID: TALCS CRENA ACARI ACRID
ACTOR: TALCS CRATE ACTOR
ACUTE: TALCS CRATE ACUTE
ADAGE: TALCS ARENA AGAZE APAGE ADAGE
ADAPT: TALCS IRATE UNAPT ADAPT
ADEPT: TALCS IRATE BEPAT ADEPT
ADMIN: TALCS ARENA ANOMY ADMIN
ADMIT: TALCS IRATE AMBIT ADMIT
ADOBE: TALCS ARENA AZIDE ADOBE
ADOPT: TALCS IRATE ADBOT ADOPT
ADORE: TALCS ARENA AIRED ADORE
ADORN: TALCS ARENA AGRIN AZURN ADORN
ADULT: TALCS PLEAT ATILT ADULT
AFFIX: TALCS ARENA AUDIO AFFIX
AFIRE: TALCS ARENA AIRED AFIRE
AFOOT: TALCS IRATE ADBOT AFOOT
AFOUL: TALCS ALANE ARMIL AFOUL
AFTER: TALCS IRATE APERT AFTER
AGAIN: TALCS ARENA ADMAN AGAIN
AGAPE: TALCS ARENA AGAZE AGAPE
AGATE: TALCS IRATE ABATE AGATE
AGENT: TALCS IRATE BEPAT AMENT ANENT AHENT
AGILE: TALCS ALANE AGILE
AGING: TALCS ARENA AGONY AGING
AGLOW: TALCS POLAR ALLOW AGLOW
AGONY: TALCS ARENA AGONY
AGORA: TALCS ARENA AFARA AGORA
AGREE: TALCS ARENA AIRED AGREE
AHEAD: TALCS ARENA AHEAP AHEAD
AIDER: TALCS ARENA AIRED AIDER
AISLE: TALCS SHALE AISLE
ALARM: TALCS ALANE ALARM
ALBUM: TALCS ALANE ALOUD ALBUM
ALERT: TALCS PLEAT ALERT
ALGAE: TALCS ALANE ALGAE
ALIBI: TALCS ALANE ALOUD ALKYL ALIBI
ALIEN: TALCS ALANE ALIEN
ALIGN: TALCS ALANE ALOIN ALIGN
ALIKE: TALCS ALANE ALIVE ALIKE
ALIVE: TALCS ALANE ALIVE
ALLAY: TALCS POLAR UNLAY DELAY ALLAY
ALLEY: TALCS POLAR BULLA ALLYL ALLEY
ALLOT: TALCS AGLET ALLOT
ALLOW: TALCS POLAR ALLOW
ALLOY: TALCS POLAR ALLOW ALLOD ALLOY
ALOFT: TALCS PLEAT BLART ALOFT
ALONE: TALCS ALANE ALINE ALONE
ALONG: TALCS ALANE ALONG
ALOOF: TALCS ALANE ALOUD ALOOF
ALOUD: TALCS ALANE ALOUD
ALPHA: TALCS ALANE ALLAY ALPHA
ALTAR: TALCS PLEAT ALTAR
ALTER: TALCS PLEAT ELATE ALTER
AMASS: TALCS SEARS QUASS KVASS AMASS
AMAZE: TALCS ARENA AGAZE AMAZE
AMBER: TALCS ARENA AIRED AUGER AMBER
AMBLE: TALCS ALANE AGILE AMOLE AMPLE AMBLE
AMEND: TALCS ARENA AKENE AMEND
AMISS: TALCS SEARS ASPIS AMISS
AMITY: TALCS IRATE PITTA AMITY
AMONG: TALCS ARENA AGONY AMONG
AMPLE: TALCS ALANE AGILE AMOLE AMPLE
AMPLY: TALCS ALANE ARMIL AMPLY
AMUSE: TALCS SPAER ISNAE ABUSE AMUSE
ANGEL: TALCS ALANE ANGEL
ANGER: TALCS ARENA ANGER
ANGLE: TALCS ALANE ANILE ANKLE ANOLE ANELE
ANGRY: TALCS ARENA AGRIN ANGRY
ANGST: TALCS STARE AGIST ANGST
ANIME: TALCS ARENA ANODE ANIME
ANKLE: TALCS ALANE ANILE ANKLE
ANNEX: TALCS ARENA ANODE ANNEX
ANNOY: TALCS ARENA ANOMY ANNOY
ANNUL: TALCS ALANE ANNUL
ANODE: TALCS ARENA ANODE
ANTIC: TALCS CRATE ANTIC
ANVIL: TALCS ALANE ANNUL ANVIL
AORTA: TALCS IRATE KURTA AORTA
APART: TALCS IRATE OTARY QUART APART
APHID: TALCS ARENA AUDIO APHID
APING: TALCS ARENA AGONY APING
APNEA: TALCS ARENA APNEA
APPLE: TALCS ALANE AGILE AMOLE APPLE
APPLY: TALCS ALANE ARMIL AHOLD APPLY
APRON: TALCS ARENA AGRIN APRON
APTLY: TALCS PLEAT APTLY
ARBOR: TALCS ARENA ARDOR ARBOR
ARDOR: TALCS ARENA ARDOR
ARENA: TALCS ARENA
ARGUE: TALCS ARENA ARMED ARUHE ARGUE
ARISE: TALCS SPAER RESAW AROSE ARISE
ARMOR: TALCS ARENA ARDOR ARBOR ARMOR
AROMA: TALCS ARENA AROBA AROHA AROMA
AROSE: TALCS SPAER RESAW AROSE
ARRAY: TALCS ARENA ARRAY
ARROW: TALCS ARENA ARDOR ARROW
ARSON: TALCS SPAER ROOSA ARSON
ARTSY: TALCS STARE ARTSY
ASCOT: TALCS SCART ASCOT
ASHEN: TALCS SPAER ASHED ASHEN
ASIDE: TALCS SPAER ISNAE ASIDE
ASKEW: TALCS SPAER ASHED ASSEZ ASKEW
ASSAY: TALCS SPAER MISSA ASSAY
ASSET: TALCS STARE VESTA ASSET
ATOLL: TALCS PLEAT LOATH ATOLL
ATONE: TALCS IRATE ANTAE ATONE
ATTIC: TALCS CRATE ANTIC ATTIC
AUDIO: TALCS ARENA AUDIO
AUDIT: TALCS IRATE AMBIT AUDIT
AUGUR: TALCS ARENA AMOUR AUGUR
AUNTY: TALCS IRATE OUTTA AUNTY
AVAIL: TALCS ALANE AFALD AVAIL
AVERT: TALCS IRATE APERT AVERT
AVIAN: TALCS ARENA ADMAN AVIAN
AVOID: TALCS ARENA AUDIO AVOID
AWAIT: TALCS IRATE GIANT AWAIT
AWAKE: TALCS ARENA AGAZE AWAKE
AWARD: TALCS ARENA ABRAY AWARD
AWARE: TALCS ARENA AURAE AWARE
AWASH: TALCS SPAER AWASH
AWFUL: TALCS ALANE ARMIL AFOUL AWFUL
AWOKE: TALCS ARENA AZIDE AMOVE AWOKE
AXIAL: TALCS ALANE ARGAL AXIAL
AXIOM: TALCS ARENA AUDIO AXIOM
AXION: TALCS ARENA ANOMY AXION
AZURE: TALCS ARENA AIRED ABORE AZURE
BACON: TALCS CARED MACHO BACON
BADGE: TALCS RAMEN BADGE
BADLY: TALCS LAYER MADLY BADLY
BAGEL: TALCS LAYER GAVEL BAGEL
BAGGY: TALCS RAMEN KADAI GABBY BAGGY
BAKER: TALCS RAMEN PARED GAYER FAKER OAKER
BALER: TALCS PALEA BALER
BALMY: TALCS PALEA BALDY BALMY
BANAL: TALCS LAYER NAHAL FANAL BANAL
BANJO: TALCS RAMEN PANDA KANJI BANJO
BARGE: TALCS RAMEN GARBE BARGE
BARON: TALCS RAMEN BARON
BASAL: TALCS LASED VASAL BASAL
BASIC: TALCS CARSE BASIC
BASIL: TALCS LASED VASAL BASIL
BASIN: TALCS SANER BASON BASIN
BASIS: TALCS KARNS GAMES BAUDS BABAS BASIS
BASTE: TALCS SAITH PASTY BASTA BASTE
BATCH: TALCS NATCH WATCH PATCH BATCH
BATHE: TALCS RAITA DATUM EATHE BATHE
BATON: TALCS RAITA DATUM EATHE BATON
BATTY: TALCS RAITA BANTY BAWTY BATTY
BAWDY: TALCS RAMEN KADAI GAUDY BAWDY
BAYOU: TALCS RAMEN KADAI GABBY BAYOU
BEACH: TALCS REACH BEACH
BEADY: TALCS ARENA BEADY
BEARD: TALCS ARENA REBAR BEARE BEARD
BEAST: TALCS STARE BEAST
BEECH: TALCS CHICO HENCE REECH BEECH
BEEFY: TALCS RONDE BEGEM BEEFY
BEFIT: TALCS ROTTE MEINT BEFIT
BEGAN: TALCS ARENA VEGAN BEGAN
BEGAT: TALCS IRATE BEPAT BEGAT
BEGET: TALCS ROTTE MEINT BEWET BEGET
BEGIN: TALCS RONDE HEMIN BEGIN
BEGUN: TALCS RONDE HEMIN EEVEN BEGUN
BEING: TALCS RONDE HEMIN VEINY BEING
BELCH: TALCS MILCH BELCH
BELIE: TALCS POLEY MILLE BELIE
BELLE: TALCS POLEY MILLE BELLE
BELLY: TALCS POLEY BELLY
BELOW: TALCS POLEY JELLO MELON BELOW
BENCH: TALCS CHICO HENCE DENCH BENCH
BERET: TALCS ROTTE FREET EGRET BERET
BERRY: TALCS RONDE FERER BERRY
BERTH: TALCS ROTTE HERTZ BERTH
BESET: TALCS STIRE PESTO BESET
BETEL: TALCS LOTTE WETLY BETEL
BEVEL: TALCS LOUED REPEL BEVEL
BEZEL: TALCS LOUED REPEL BEVEL BEZEL
BIBLE: TALCS LOUED GERLE ANILE BIBLE
BICEP: TALCS COREY VICED BICEP
BIDDY: TALCS RONDE BUDDY BIDDY
BIGOT: TALCS ROTTE BIGOT
BILGE: TALCS POLEY MILLE BILGE
BILLY: TALCS POLEY GILLY DILLY BILLY
BINGE: TALCS RONDE GENIE HINGE MINGE WINGE
BINGO: TALCS RONDE PINGO JINGO BINGO
BIOME: TALCS RONDE EXOME BIOME
BIRCH: TALCS CHICO PINCH BIRCH
BIRTH: TALCS ROTTE FIRTH GIRTH BIRTH
BISON: TALCS SIREN VISON BISON
BITTY: TALCS ROTTE NUTTY DITTY BITTY
BLACK: TALCS PLACE CLACH BLACK
BLADE: TALCS ALANE GLARE BLAME BLAZE BLADE
BLAME: TALCS ALANE GLARE BLAME
BLAND: TALCS ALANE BLANK BLAND
BLANK: TALCS ALANE BLANK
BLARE: TALCS ALANE GLARE BLARE
BLAST: TALCS SPALT LEAST BLAST
BLAZE: TALCS ALANE GLARE BLAME BLAZE
BLEAK: TALCS ALANE GLEBA BLEAK
BLEAT: TALCS PLEAT BLEAT
BLEED: TALCS LOUED FLIED GLEED BLEED
BLEEP: TALCS LOUED REPEL BLEEP
BLEND: TALCS LOUED FIELD BLEND
BLESS: TALCS LORES SEILS BLESS
BLIMP: TALCS LOUED GIRLY BLINI BLIMP
BLIND: TALCS LOUED BLIND
BLINK: TALCS LOUED GIRLY BLINI BLINK
BLISS: TALCS LORES BLISS
BLITZ: TALCS LOTTE BLITZ
BLOAT: TALCS PLEAT BLOAT
BLOCK: TALCS LEUCO BLOCK
BLOKE: TALCS LOUED GLOBE BLORE BLOKE
BLOND: TALCS LOUED BLOOD BLOND
BLOOD: TALCS LOUED BLOOD
BLOOM: TALCS LOUED BLOOK BLOOP BLOOM
BLOWN: TALCS LOUED BLOOK BLOWY BLOWN
BLUER: TALCS LOUED BLUEY BLUER
BLUFF: TALCS LOUED FLUMP BLUFF
BLUNT: TALCS LOTTE GLINT BLUNT
BLURB: TALCS LOUED FLUMP BLURB
BLURT: TALCS LOTTE GLINT BLURT
BLUSH: TALCS SPIEL FLUSH BLUSH
BOARD: TALCS ARENA DIRAM HOARD BOARD
BOAST: TALCS STARE GHAST AVAST BOAST
BOBBY: TALCS RONDE GOMBO BOBBY
BONEY: TALCS RONDE BONEY
BONGO: TALCS RONDE BONGO
BONUS: TALCS DORES GOONS BONKS BONUS
BOOBY: TALCS RONDE GOMBO BOOBY
BOOST: TALCS STIRE GUSTY BOOST
BOOTH: TALCS ROTTE BOOTY BOOTH
BOOTY: TALCS ROTTE BOOTY
BOOZE: TALCS RONDE BOGIE BOOZE
BOOZY: TALCS RONDE GOMBO BOOKY BOOZY
BORAX: TALCS ARENA DIRAM HYRAX BORAX
BORNE: TALCS RONDE BORNE
BOSOM: TALCS SIREN BUSHY BOSOM
BOSSY: TALCS SIREN BUSHY BOSKY BOSSY
BOTCH: TALCS EDICT TROCK GOTCH BOTCH
BOUGH: TALCS RONDE GOMBO BOUGH
BOULE: TALCS LOUED BOULE
BOUND: TALCS RONDE WOUND BOUND
BOWEL: TALCS LOUED VOWEL BOWEL
BOXER: TALCS RONDE MOWER POKER GOFER BORER
BRACE: TALCS REACH BRACE
BRAID: TALCS ARENA BRAID
BRAIN: TALCS ARENA BRAWN BRAIN
BRAKE: TALCS ARENA GRADE BRAME BRAKE
BRAND: TALCS ARENA KRANG BRAND
BRASH: TALCS SPAER BRASH
BRASS: TALCS SEARS BRASS
BRAVE: TALCS ARENA GRADE BRAME BRAKE BRAZE
BRAVO: TALCS ARENA BRAID BRAKY BRAVO
BRAWL: TALCS ALANE DRAIL WRAWL BRAWL
BRAWN: TALCS ARENA BRAWN
BREAD: TALCS ARENA BREAD
BREAK: TALCS ARENA BREAD BREAK
BREED: TALCS RONDE DRIER GRUED FREED BREED
BRIAR: TALCS ARENA BRAID BRIAR
BRIBE: TALCS RONDE GERBE BRIBE
BRICK: TALCS CHICO PRICE WRICK BRICK
BRIDE: TALCS RONDE BRIDE
BRIEF: TALCS RONDE FERER GRIEF BRIEF
BRINE: TALCS RONDE URINE BRINE
BRING: TALCS RONDE BRUIN BRINY BRING
BRINK: TALCS RONDE BRUIN BRINY BRING BRINK
BRINY: TALCS RONDE BRUIN BRINY
BRISK: TALCS SIREN FRISK BRISK
BROAD: TALCS ARENA BRAID BROAD
BROIL: TALCS LOUED BLOOK BROIL
BROKE: TALCS RONDE PROBE BROME BROKE
BROOD: TALCS RONDE DROOK BROOD
BROOK: TALCS RONDE GROOM BROOK
BROOM: TALCS RONDE GROOM VROOM BROOM
BROTH: TALCS ROTTE BROTH
BROWN: TALCS RONDE PRION BROWN
BRUNT: TALCS ROTTE GRIPT BRUNT
BRUSH: TALCS SIREN HORSY BRUSH
BRUTE: TALCS ROTTE WRITE BRUTE
BUDDY: TALCS RONDE BUDDY
BUDGE: TALCS RONDE KIDGE BUDGE
BUGGY: TALCS RONDE PIGMY VUGHY FUGGY BUGGY
BUGLE: TALCS LOUED GUILE FUGLE BUGLE
BUILD: TALCS LOUED BUILD
BUILT: TALCS LOTTE GLINT BUILT
BULGE: TALCS POLEY MILLE DELVE BULGE
BULKY: TALCS POLEY GILLY BULKY
BULLY: TALCS POLEY GILLY BULLY
BUNCH: TALCS CHICO HENCE PUNCH BUNCH
BUNNY: TALCS RONDE GUNNY FUNNY NUNNY BUNNY
BURLY: TALCS LOUED RUMLY BURLY
BURNT: TALCS ROTTE GRIPT BURNT
BURST: TALCS STIRE WORST DURST HURST BURST
BUSED: TALCS SIREN DOPES BUSED
BUSHY: TALCS SIREN BUSHY
BUTCH: TALCS EDICT TROCK BUTCH
BUTTE: TALCS ROTTE FITTE BUTTE
BUXOM: TALCS RONDE HIMBO BUXOM
BUYER: TALCS RONDE FERER VIPER UMBER BUYER
BYLAW: TALCS POLAR UNLAY BYLAW
CABAL: TALCS CARLE CANAL CABAL
CABBY: TALCS CARED CAPON CABBY
CABIN: TALCS CARED CAPON CAMAN CABIN
CABLE: TALCS CARLE CABLE
CACAO: TALCS CARED CAPON CACAO
CACHE: TALCS CARED CANEH CACHE
CACTI: TALCS CARTE CANTY CACTI
CADDY: TALCS CARED CANDY CADDY
CADET: TALCS CARTE CADET
CAGEY: TALCS CARED CAKEY CAGEY
CAIRN: TALCS CARED CAURI CAIRN
CAMEL: TALCS CARLE CAVEL CAMEL
CAMEO: TALCS CARED CAKEY CANEH CAMEO
CANAL: TALCS CARLE CANAL
CANDY: TALCS CARED CANDY
CANNY: TALCS CARED CAPON CANNA CANNY
CANOE: TALCS CARED CANEH CANOE
CANON: TALCS CARED CAPON CANON
CAPER: TALCS CARED CAVER CABER CANER CAGER
CAPUT: TALCS CARTE CAPUT
CARAT: TALCS CARTE CARAT
CARGO: TALCS CARED CARBO CARGO
CAROL: TALCS CARLE CAROL
CARRY: TALCS CARED CARBO CARVY CARNY CARRY
CARVE: TALCS CARED CARVE
CASTE: TALCS CASTE
CATCH: TALCS NATCH WATCH PATCH BATCH CATCH
CATER: TALCS CARTE CATER
CATTY: TALCS CARTE CANTY CATTY
CAULK: TALCS CARLE CAULD CAULK
CAUSE: TALCS CARSE CAUSE
CAVIL: TALCS CARLE CANAL CAPUL CAVIL
CEASE: TALCS SCARP CEASE
CEDAR: TALCS CRENA CEDAR
CELLO: TALCS CELOM CELLO
CHAFE: TALCS CRENA CHAFE
CHAFF: TALCS CRENA COPAY CHAWK CHAFF
CHAIN: TALCS CRENA COWAN CHAIN
CHAIR: TALCS CRENA CYMAR CHAIR
CHALK: TALCS CLEAR CHOLA CHALK
CHAMP: TALCS CRENA COPAY CHAMP
CHANT: TALCS CRATE CHANT
CHAOS: TALCS CRAMS CHAWS CHAYS CHAIS CHAVS
CHARD: TALCS CRENA CYMAR CHARK CHARD
CHARM: TALCS CRENA CYMAR CHARM
CHART: TALCS CRATE CHART
CHASE: TALCS SCARP CEASE CHASE
CHASM: TALCS SCARP CEASE CHASM
CHEAP: TALCS CRENA CHEAP
CHEAT: TALCS CRATE CHEAT
CHECK: TALCS CHICO CHECK
CHEEK: TALCS COREY CIDED CHEEP CHEEK
CHEER: TALCS COREY CREED CHEER
CHESS: TALCS CORES CHEWS CHEFS CHESS
CHEST: TALCS COSET CHEST
CHICK: TALCS CHICO CHICH CHICK
CHIDE: TALCS COREY CHINE CHIME CHIVE CHIDE
CHIEF: TALCS COREY CIDED CUNEI CHIEF
CHILD: TALCS CLINE CHILL CHILD
CHILI: TALCS CLINE CHILL CHILD CHILI
CHILL: TALCS CLINE CHILL
CHIME: TALCS COREY CHINE CHIME
CHINA: TALCS CRENA CHINA
CHIRP: TALCS COREY CRUMP CHIRP
CHOCK: TALCS CHICO CHOCK
CHOIR: TALCS COREY CROON CHOIR
CHOKE: TALCS COREY CHOKE
CHORD: TALCS COREY CROON CHOIR CHORD
CHORE: TALCS COREY CRORE CHORE
CHOSE: TALCS SCORE CHOSE
CHUCK: TALCS CHICO CHECK CHUCK
CHUMP: TALCS COREY CUMIN CHUMP
CHUNK: TALCS COREY CUMIN CHUNK
CHURN: TALCS COREY CRUMP CHURR CHURN
CHUTE: TALCS CRUET CHUTE
CIDER: TALCS COREY CREED CIDER
CIGAR: TALCS CRENA CYMAR CIGAR
CINCH: TALCS CHICO CINCH
CIRCA: TALCS REACH CIRCA
CIVIC: TALCS COREY CUMIN CIVIC
CIVIL: TALCS CLINE CIBOL CIVIL
CLACK: TALCS PLACE CLACH CLACK
CLAIM: TALCS CLEAR CLAIM
CLAMP: TALCS CLEAR CLAIM CLAMP
CLANG: TALCS CLEAR CLAIM CLANG
CLANK: TALCS CLEAR CLAIM CLANG CLANK
CLASH: TALCS SCALP CLASH
CLASP: TALCS SCALP CLASP
CLASS: TALCS CLAPS CLAMS CLAES CLADS CLAWS
CLEAN: TALCS CLEAR CLEAN
CLEAR: TALCS CLEAR
CLEAT: TALCS CLAPT CLEAT
CLEFT: TALCS CLIFT CLEFT
CLERK: TALCS CLINE CLUED CLERK
CLICK: TALCS LEUCO FLICK CLICK
CLIFF: TALCS CLINE CLIMB CLIFF
CLIMB: TALCS CLINE CLIMB
CLING: TALCS CLINE CLINK CLING
CLINK: TALCS CLINE CLINK
CLOAK: TALCS CLEAR CLOAM CLOAK
CLOCK: TALCS LEUCO BLOCK CLOCK
CLONE: TALCS CLINE CLONE
CLOSE: TALCS SCULP CLOSE
CLOTH: TALCS CLIFT CLOTE CLOTH
CLOUD: TALCS CLINE CLUMP CLOUD
CLOUT: TALCS CLIFT CLOOT CLOUT
CLOVE: TALCS CLINE CLOYE CLOKE CLOVE
CLOWN: TALCS CLINE CLOWN
CLUCK: TALCS LEUCO PLUCK CLUCK
CLUED: TALCS CLINE CLUED
CLUMP: TALCS CLINE CLUMP
CLUNG: TALCS CLINE CLUNK CLUNG
COACH: TALCS REACH COACH
COAST: TALCS SCART COAST
COBRA: TALCS CRENA COBRA
COCOA: TALCS CRENA COBZA COCOA
COLON: TALCS CELOM COLOR COLON
COLOR: TALCS CELOM COLOR
COMET: TALCS CRUET CIVET COMET
COMFY: TALCS COREY COOMY COMFY
COMIC: TALCS COREY CONGO COXIB COMIC
COMMA: TALCS CRENA COBZA COCOA COMMA
CONCH: TALCS CHICO COUCH CONCH
CONDO: TALCS COREY CONGO CONVO CONDO
CONIC: TALCS COREY CONGO CONIN CONIC
COPSE: TALCS SCORE COPSE
CORAL: TALCS CLEAR CORAL
CORER: TALCS COREY CORER
CORNY: TALCS COREY CORBY CORNY
COUCH: TALCS CHICO COUCH
COUGH: TALCS COREY CONGO COUGH
COULD: TALCS CLINE COOLY COULD
COUNT: TALCS CRUET COUNT
COUPE: TALCS COREY COGUE COUPE
COURT: TALCS CRUET COURT
COVEN: TALCS COREY CODEN COZEN COPEN COHEN
COVER: TALCS COREY COOER COPER COWER COVER
COVET: TALCS CRUET CIVET COVET
COVEY: TALCS COREY COZEY COOEY COVEY
COWER: TALCS COREY COOER COPER COWER
COYLY: TALCS CLINE COOLY COYLY
CRACK: TALCS REACH DRACO CRACK
CRAFT: TALCS CRATE CRAFT
CRAMP: TALCS CRENA CRAPY CRAMP
CRANE: TALCS CRENA CRANE
CRANK: TALCS CRENA CRANK
CRASH: TALCS SCARP CRASH
CRASS: TALCS CRAMS CRAPS CRAWS CRAGS CRASS
CRATE: TALCS CRATE
CRAVE: TALCS CRENA CRARE CRAKE CRAVE
CRAWL: TALCS CLEAR CRAWL
CRAZE: TALCS CRENA CRARE CRAKE CRAVE CRAZE
CRAZY: TALCS CRENA CRAPY CRAZY
CREAK: TALCS CRENA CREAM CREAK
CREAM: TALCS CRENA CREAM
CREDO: TALCS COREY CRORE CREDO
CREED: TALCS COREY CREED
CREEK: TALCS COREY CREED CREEK
CREEP: TALCS COREY CREED CREEK CREEP
CREME: TALCS COREY CREPE CREWE CREME
CREPE: TALCS COREY CREPE
CREPT: TALCS CRUET CREPT
CRESS: TALCS CORES CREPS CRESS
CREST: TALCS COSET CHEST CREST
CRICK: TALCS CHICO CRICK
CRIED: TALCS COREY CREED CRIED
CRIER: TALCS COREY CREED CRIER
CRIME: TALCS COREY CREPE CRUDE CRINE CRIME
CRIMP: TALCS COREY CRUMP CRIMP
CRISP: TALCS SCORE CRUSY CRISP
CROAK: TALCS CRENA CRAPY CROAK
CROCK: TALCS CHICO CROCK
CRONE: TALCS COREY CRORE CROME CRONE
CRONY: TALCS COREY CRONY
CROOK: TALCS COREY CROON CROOK
CROSS: TALCS CORES CRONS CROGS CROPS CROSS
CROUP: TALCS COREY CROON CROWD CROMB CROUP
CROWD: TALCS COREY CROON CROWD
CROWN: TALCS COREY CROON CROWN
CRUDE: TALCS COREY CREPE CRUDE
CRUEL: TALCS CLINE CREEL CRUEL
CRUMB: TALCS COREY CRUMP CRUMB
CRUMP: TALCS COREY CRUMP
CRUSH: TALCS SCORE CRUSY CRUSH
CRUST: TALCS COSET CRUST
CRYPT: TALCS CRUET CROFT CRYPT
CUBIC: TALCS COREY CUMIN CUBIC
CUMIN: TALCS COREY CUMIN
CURIO: TALCS COREY CURIO
CURLY: TALCS CLINE COOLY CURLY
CURRY: TALCS COREY CURRY
CURSE: TALCS SCORE CRUSE CURSE
CURVE: TALCS COREY CERGE CURIE CURVE
CURVY: TALCS COREY CURRY CURVY
CUTIE: TALCS CRUET CUTIE
CYBER: TALCS COREY CYDER CYBER
CYCLE: TALCS CLINE CHYLE CYCLE
CYNIC: TALCS COREY CYNIC
DADDY: TALCS RAMEN KADAI BADDY FADDY DADDY
DAILY: TALCS LAYER MADLY DAILY
DAIRY: TALCS RAMEN BARKY HARDY DAIRY
DAISY: TALCS SANER PAYSD DAISY
DALLY: TALCS PALEA BALDY DALLY
DANCE: TALCS RANCH NANCE PANCE DANCE
DANDY: TALCS RAMEN PANDA BANDH DANDY
DATUM: TALCS RAITA DATUM
DAUNT: TALCS RAITA DATUM DAUNT
DEALT: TALCS PLEAT LEANT DEALT
DEATH: TALCS IRATE BEATH NEATH HEATH DEATH
DEBAR: TALCS ARENA REBAR KEBAR DEBAR
DEBIT: TALCS ROTTE MEINT BEFIT DEBIT
DEBUG: TALCS RONDE DEIFY DEBUG
DEBUT: TALCS ROTTE MEINT BEWET DEBUT
DECAL: TALCS CLEAR FECAL DECAL
DECAY: TALCS CRENA FACED DECAY
DECOR: TALCS COREY RECON DECOR
DECOY: TALCS COREY DECOY
DECRY: TALCS COREY DECRY
DEFER: TALCS RONDE DRIER DEFER
DEIGN: TALCS RONDE INDEW FIEND DEIGN
DEITY: TALCS ROTTE DEPTH DEITY
DELAY: TALCS POLAR UNLAY DELAY
DELTA: TALCS AGLET PELTA DELTA
DELVE: TALCS POLEY MILLE DELVE
DEMON: TALCS RONDE DEMON
DEMUR: TALCS RONDE DRIER DEBUR DEMUR
DENIM: TALCS RONDE DENIM
DENSE: TALCS SIREN MENSE DENSE
DEPOT: TALCS ROTTE DEPOT
DEPTH: TALCS ROTTE DEPTH
DERBY: TALCS RONDE DRIER DERBY
DETER: TALCS ROTTE MITER PETER DETER
DETOX: TALCS ROTTE BETON DETOX
DEUCE: TALCS CHICO PERCE FENCE DEUCE
DEVIL: TALCS LOUED NEELD DEVIL
DIARY: TALCS ARENA DIRAM DIARY
DICEY: TALCS COREY DICEY
DIGIT: TALCS ROTTE NITID DIGIT
DILLY: TALCS POLEY GILLY DILLY
DIMLY: TALCS LOUED DRILL DIMLY
DINER: TALCS RONDE ERNED DINER
DINGO: TALCS RONDE DINGO
DINGY: TALCS RONDE DUNGY DINGY
DIODE: TALCS RONDE EXODE DIODE
DIRGE: TALCS RONDE URDEE DIRKE DIRGE
DIRTY: TALCS ROTTE FIRTH VIRTU DIRTY
DISCO: TALCS SONCE PISCO DISCO
DITCH: TALCS EDICT DITCH
DITTO: TALCS ROTTE PUTTO DITTO
DITTY: TALCS ROTTE NUTTY DITTY
DIVER: TALCS RONDE DRIER DIMER DIKER DIVER
DIZZY: TALCS RONDE DIPPY DIVVY DIZZY
DODGE: TALCS RONDE DOBIE DODGE
DODGY: TALCS RONDE DOODY DODGY
DOGMA: TALCS ARENA PODIA DOUMA DOGMA
DOING: TALCS RONDE WOUND DOING
DOLLY: TALCS POLEY DOLLY
DONOR: TALCS RONDE DONOR
DONUT: TALCS ROTTE POINT DONUT
DOPEY: TALCS RONDE POHED DOPEY
DOUBT: TALCS ROTTE POINT DOUBT
DOUGH: TALCS RONDE DOODY DOUGH
DOWDY: TALCS RONDE DOWDY
DOWEL: TALCS LOUED YODEL DOWEL
DOWNY: TALCS RONDE WOUND DOWNY
DOWRY: TALCS RONDE DOBRO DOWRY
DOZEN: TALCS RONDE DOYEN DOVEN DOZEN
DRAFT: TALCS IRATE GRANT KRAFT DRAFT
DRAIN: TALCS ARENA BRAWN DRAIN
DRAKE: TALCS ARENA GRADE DRAPE DRAKE
DRAMA: TALCS ARENA BRAVA DRAMA
DRANK: TALCS ARENA KRANG BRANK PRANK DRANK
DRAPE: TALCS ARENA GRADE DRAPE
DRAWL: TALCS ALANE DRAIL DRAWL
DRAWN: TALCS ARENA BRAWN DRAWN
DREAD: TALCS ARENA BREAD OREAD DREAD
DREAM: TALCS ARENA BREAD DREAR DREAM
DRESS: TALCS DORES DREYS DREKS DRESS
DRIED: TALCS RONDE DRIER DRIED
DRIER: TALCS RONDE DRIER
DRIFT: TALCS ROTTE GRIPT DRIFT
DRILL: TALCS LOUED DRILL
DRINK: TALCS RONDE UNRID DRINK
DRIVE: TALCS RONDE URDEE DRIVE
DROIT: TALCS ROTTE GRIOT DROIT
DROLL: TALCS LOUED DROOL DROIL DROLL
DRONE: TALCS RONDE DRONE
DROOL: TALCS LOUED DROOL
DROOP: TALCS RONDE DROOK DROOP
DROSS: TALCS DORES DROPS DROSS
DROVE: TALCS RONDE DROVE
DROWN: TALCS RONDE FROND DROWN
DRUID: TALCS RONDE MUDIR DRUID
DRUNK: TALCS RONDE UNRID DRUNK
DRYER: TALCS RONDE DRIER DREER DRYER
DRYLY: TALCS LOUED DRILL DRYLY
DUCHY: TALCS COREY DUCKY DUCHY
DULLY: TALCS POLEY GILLY BULLY FULLY DULLY
DUMMY: TALCS RONDE DIPPY DUMKY DUMMY
DUMPY: TALCS RONDE DIPPY DUMPY
DUNCE: TALCS CHICO PERCE DUNCE
DUSKY: TALCS SIREN BUSHY MUSSY DUSKY
DUSTY: TALCS STIRE GUSTY DUSTY
DUTCH: TALCS EDICT DUTCH
DUVET: TALCS ROTTE MEINT DUVET
DWARF: TALCS ARENA DIRAM DWARF
DWELL: TALCS LOUED NEELD DWELL
DWELT: TALCS LOTTE GLENT DWELT
DYING: TALCS RONDE UNDUG DYING
EAGER: TALCS RAMEN PARED GAYER WAGER EAGER
EAGLE: TALCS LAYER PAGLE EAGLE
EARLY: TALCS LAYER EARLY
EARTH: TALCS RAITA PARTY GARTH EARTH
EASEL: TALCS LASED EASEL
EATEN: TALCS RAITA DATUM EATHE EATEN
EATER: TALCS RAITA GATOR WATER MATER DATER
EBONY: TALCS RONDE ENVOY EBONY
ECLAT: TALCS ECLAT
EDICT: TALCS EDICT
EDIFY: TALCS RONDE DEIFY EDIFY
EERIE: TALCS RONDE GERBE VERVE EERIE
EGRET: TALCS ROTTE FREET EGRET
EIGHT: TALCS ROTTE MEINT BIDET EIGHT
EJECT: TALCS EDICT ERUCT EJECT
EKING: TALCS RONDE HEMIN EXING EYING EKING
ELATE: TALCS PLEAT ELATE
ELBOW: TALCS LOUED GLOBE ELBOW
ELDER: TALCS LOUED DEBEL ELDER
ELECT: TALCS ELECT
ELEGY: TALCS LOUED GERLE ELEGY
ELFIN: TALCS LOUED GERLE FLEXI ELFIN
ELIDE: TALCS LOUED NEELD ELIDE
ELITE: TALCS LOTTE FLUTE BLITE ELITE
ELOPE: TALCS LOUED GLOBE ELOPE
ELUDE: TALCS LOUED ELUDE
EMAIL: TALCS ALANE LEARY EMAIL
EMBED: TALCS RONDE DEIFY UMPED EMBED
EMBER: TALCS RONDE FERER EMBER
EMCEE: TALCS COREY VICED EMCEE
EMPTY: TALCS ROTTE DEPTH EMPTY
ENACT: TALCS REACT EXACT EPACT ENACT
ENDOW: TALCS RONDE DEMON ENDOW
ENEMA: TALCS ARENA ENEMA
ENEMY: TALCS RONDE HEMIN ENZYM ENEMY
ENJOY: TALCS RONDE ENVOY ENJOY
ENNUI: TALCS RONDE PENNY ENNUI
ENSUE: TALCS SIREN MENSE ENSUE
ENTER: TALCS ROTTE MITER PETER ENTER
ENTRY: TALCS ROTTE MITER ENTRY
ENVOY: TALCS RONDE ENVOY
EPOCH: TALCS CHICO POUCH EPOCH
EPOXY: TALCS RONDE EMBOG EPOXY
EQUAL: TALCS ALANE MAERL PEDAL EQUAL
EQUIP: TALCS RONDE BEGEM EQUIP
ERASE: TALCS SPAER URASE ERASE
ERECT: TALCS EDICT ERUCT ERECT
ERODE: TALCS RONDE ERODE
ERROR: TALCS RONDE BEVOR ERROR
ERUPT: TALCS ROTTE FREET ERUPT
ESSAY: TALCS SPAER ISNAE ESSAY
ESTER: TALCS STIRE PERST ESTER
ETHER: TALCS ROTTE FREET ETHER
ETHIC: TALCS CRUET METIC ETHIC
ETHOS: TALCS SITES PENTS ETHOS
ETUDE: TALCS ROTTE TYNDE ETUDE
EVADE: TALCS ARENA BEADY EVADE
EVENT: TALCS ROTTE MEINT EVENT
EVERY: TALCS RONDE FERER EMERG EVERY
EVICT: TALCS EDICT EVICT
EVOKE: TALCS RONDE EXOME EVOKE
EXACT: TALCS REACT EXACT
EXALT: TALCS PLEAT LEANT EXALT
EXCEL: TALCS CLINE EXCEL
EXERT: TALCS ROTTE FREET EXERT
EXILE: TALCS LOUED GERLE EXILE
EXIST: TALCS STIRE GEIST EXIST
EXPEL: TALCS LOUED REPEL EXPEL
EXTOL: TALCS LOTTE METOL EXTOL
EXTRA: TALCS IRATE APERT EXTRA
EXULT: TALCS LOTTE GLENT EXULT
EYING: TALCS RONDE HEMIN EXING EYING
FABLE: TALCS LAYER PAGLE HABLE FABLE
FACET: TALCS CARTE FACET
FAINT: TALCS RAITA FAITH FAINT
FAIRY: TALCS RAMEN BARKY HARDY FAIRY
FAITH: TALCS RAITA BAITH FAITH
FALSE: TALCS SALLE FALSE
FANCY: TALCS RANCH NANCE DANCY FANCY
FANNY: TALCS RAMEN PANDA KANJI FANNY
FARCE: TALCS RANCH FARCY FARCE
FATAL: TALCS LATHE FATLY FATAL
FATTY: TALCS RAITA BANTY PATTY FATTY
FAULT: TALCS LATHE GAULT VAULT FAULT
FAUNA: TALCS RAMEN PANDA FAUNA
FAVOR: TALCS RAMEN BARKY PAGRI FAVOR
FEAST: TALCS STARE BEAST HEAST YEAST FEAST
FECAL: TALCS CLEAR FECAL
FEIGN: TALCS RONDE HEMIN FEIGN
FELLA: TALCS POLAR BULLA ZILLA FELLA
FELON: TALCS POLEY JELLO MELON BELON FELON
FEMME: TALCS RONDE PUMIE FEMME
FEMUR: TALCS RONDE FERER FEMUR
FENCE: TALCS CHICO PERCE FENCE
FERAL: TALCS ALANE MAERL FERAL
FERRY: TALCS RONDE FERER FERRY
FETAL: TALCS PLEAT METAL FETAL
FETCH: TALCS EDICT TRECK FETCH
FETID: TALCS ROTTE FETID
FETUS: TALCS SITES FETTS FETUS
FEVER: TALCS RONDE FERER FEYER FEWER FEVER
FEWER: TALCS RONDE FERER FEYER FEWER
FIBER: TALCS RONDE FERER FIXER FIVER FIBER
FIBRE: TALCS RONDE GERBE FIBRE
FICUS: TALCS CORES MUCUS FICUS
FIELD: TALCS LOUED FIELD
FIEND: TALCS RONDE INDEW FIEND
FIERY: TALCS RONDE FERER FIERY
FIFTH: TALCS ROTTE MINTY FIFTH
FIFTY: TALCS ROTTE MINTY FIFTY
FIGHT: TALCS ROTTE NITID WIFTY FIGHT
FILER: TALCS POLEY RILED MILER FILER
FILET: TALCS FILET
FILLY: TALCS POLEY GILLY DILLY BILLY FILLY
FILMY: TALCS POLEY GILLY FILMY
FILTH: TALCS FILET FILTH
FINAL: TALCS ALANE LINGA VINAL BINAL FINAL
FINCH: TALCS CHICO PINCH WINCH GINCH FINCH
FINER: TALCS RONDE BINER MINER NINER VINER
FIRST: TALCS STIRE ROSTI FIRST
FISHY: TALCS SIREN PISOS DISHY FISHY
FIXER: TALCS RONDE FERER FIXER
FIZZY: TALCS RONDE PIGMY FIZZY
FJORD: TALCS RONDE DROOK FIORD FJORD
FLACK: TALCS PLACE CLACH BLACK FLACK
FLAIL: TALCS ALANE FLARY FLAMM FLAFF FLAIL
FLAIR: TALCS ALANE FLARY FLAIR
FLAKE: TALCS ALANE GLARE BLAME FLAKE
FLAKY: TALCS ALANE FLARY FLAXY FLAWY FLAKY
FLAME: TALCS ALANE GLARE BLAME FLAME
FLANK: TALCS ALANE BLANK PLANK FLANK
FLARE: TALCS ALANE GLARE BLARE FLARE
FLASH: TALCS SHALE PLASH FLASH
FLASK: TALCS SHALE FLASK
FLECK: TALCS LEUCO CLECK FLECK
FLEET: TALCS LOTTE GLENT FLEET
FLESH: TALCS SPIEL WEELS FLESH
FLICK: TALCS LEUCO FLICK
FLIER: TALCS LOUED REPEL FLIER
FLING: TALCS LOUED GIRLY FLING
FLINT: TALCS LOTTE GLINT FLINT
FLIRT: TALCS LOTTE GLINT FLIRT
FLOAT: TALCS PLEAT BLOAT FLOAT
FLOCK: TALCS LEUCO BLOCK CLOCK FLOCK
FLOOD: TALCS LOUED BLOOD FLOOD
FLOOR: TALCS LOUED BLOOK GLOOP FLOOR
FLORA: TALCS ALANE ILIAD FLORA
FLOSS: TALCS LORES BLOGS SLOPS FLOSS
FLOUR: TALCS LOUED FUROL FLOUR
FLOUT: TALCS LOTTE GLOUT FLOUT
FLOWN: TALCS LOUED BLOOK FLONG FLOWN
FLUFF: TALCS LOUED FLUMP FLUNK FLURR FLUFF
FLUID: TALCS LOUED BLUID FLUID
FLUKE: TALCS LOUED FLUME FLUKE
FLUME: TALCS LOUED FLUME
FLUNG: TALCS LOUED FLUMP FLUNK FLUNG
FLUNK: TALCS LOUED FLUMP FLUNK
FLUSH: TALCS SPIEL FLUSH
FLUTE: TALCS LOTTE FLUTE
FLYER: TALCS LOUED REPEL FLIER FLYER
FOAMY: TALCS ARENA PIKAU WHAMO FOAMY
FOCAL: TALCS CLEAR FOCAL
FOCUS: TALCS CORES HOCKS DOCUS FOCUS
FOGGY: TALCS RONDE GOMBO FOGGY
FOIST: TALCS STIRE MOIST JOIST HOIST FOIST
FOLIO: TALCS POLEY HOLLO FOLIO
FOLLY: TALCS POLEY DOLLY FOLLY
FORAY: TALCS ARENA DIRAM HYRAX FORAY
FORCE: TALCS CHICO BONCE DOOCE FORCE
FORGE: TALCS RONDE FORME FORGE
FORGO: TALCS RONDE MOORY BORGO FORGO
FORTE: TALCS ROTTE FORTE
FORTH: TALCS ROTTE BORTY FORTH
FORTY: TALCS ROTTE BORTY PORTY DORTY FORTY
FORUM: TALCS RONDE MOORY FORUM
FOUND: TALCS RONDE WOUND BOUND MOUND FOUND
FOYER: TALCS RONDE MOWER POKER GOFER FOUER
FRAIL: TALCS ALANE DRAIL GRAIL FRAIL
FRAME: TALCS ARENA GRADE BRAME FRAME
FRANK: TALCS ARENA KRANG BRANK PRANK DRANK
FRAUD: TALCS ARENA BRAID FRAUD
FREAK: TALCS ARENA BREAD WREAK FREAK
FREED: TALCS RONDE DRIER GRUED FREED
FREER: TALCS RONDE FERER FREER
FRESH: TALCS SIREN EROSE FRESH
FRIAR: TALCS ARENA BRAID FRIAR
FRIED: TALCS RONDE DRIER FRIED
FRILL: TALCS LOUED GIRLY PRILL FRILL
FRISK: TALCS SIREN FRISK
FRITZ: TALCS ROTTE FIRTH FRITZ
FROCK: TALCS CHICO BONCE FROCK
FROND: TALCS RONDE FROND
FRONT: TALCS ROTTE GRIOT DROPT FRONT
FROST: TALCS STIRE WORST PROST FROST
FROTH: TALCS ROTTE BROTH FROTH
FROWN: TALCS RONDE PRION BROWN FROWN
FROZE: TALCS RONDE PROBE FRORE FROZE
FRUIT: TALCS ROTTE GRIPT BRUIT FRUIT
FUDGE: TALCS RONDE KIDGE BUDGE PUDGE MUDGE
FUGUE: TALCS RONDE PUMIE FUGUE
FULLY: TALCS POLEY GILLY BULLY FULLY
FUNGI: TALCS RONDE GUNNY FUNGI
FUNKY: TALCS RONDE GUNNY BUNJY FUNKY
FUNNY: TALCS RONDE GUNNY FUNNY
FUROR: TALCS RONDE GROOM JUROR FUROR
FURRY: TALCS RONDE GRIMY FURRY
FUSSY: TALCS SIREN BUSHY MUSSY PUSSY WUSSY
FUZZY: TALCS RONDE PIGMY FLYBY FUZZY
GAFFE: TALCS RAMEN BADGE GAUJE GAFFE
GAILY: TALCS LAYER MADLY HAILY GAILY
GAMER: TALCS RAMEN GAMER
GAMMA: TALCS RAMEN MAMBA GAMMA
GAMUT: TALCS RAITA DATUM MAZUT GAMUT
GASSY: TALCS SANER PAYSD GASSY
GAUDY: TALCS RAMEN KADAI GAUDY
GAUGE: TALCS RAMEN BADGE GAUGE
GAUNT: TALCS RAITA DATUM JAUNT NAUNT GAUNT
GAUZE: TALCS RAMEN BADGE GAUJE GAUZE
GAVEL: TALCS LAYER GAVEL
GAWKY: TALCS RAMEN KADAI GAWKY
GAYER: TALCS RAMEN PARED GAYER
GAYLY: TALCS LAYER GAYAL GAYLY
GAZER: TALCS RAMEN PARED GAYER GAGER GAZER
GECKO: TALCS COREY DECKO GECKO
GEEKY: TALCS RONDE BEGEM GEEKY
GEESE: TALCS SIREN SOUSE GEESE
GENIE: TALCS RONDE GENIE
GENRE: TALCS RONDE GENRE
GHOST: TALCS STIRE GUSTY GHOST
GHOUL: TALCS LOUED FUROL GHOUL
GIANT: TALCS IRATE GIANT
GIDDY: TALCS RONDE BUDDY DIDDY GIDDY
GIPSY: TALCS SIREN PISOS GIPSY
GIRLY: TALCS LOUED GIRLY
GIRTH: TALCS ROTTE FIRTH GIRTH
GIVEN: TALCS RONDE HEMIN GIVEN
GIVER: TALCS RONDE FERER VIPER HIVER GIVER
GLADE: TALCS ALANE GLARE GLADE
GLAND: TALCS ALANE BLANK LLANO GLAND
GLARE: TALCS ALANE GLARE
GLASS: TALCS FEALS SLAPS GLASS
GLAZE: TALCS ALANE GLARE GLADE GLAZE
GLEAM: TALCS ALANE GLEBA GLEAM
GLEAN: TALCS ALANE ELVAN GLEAN
GLIDE: TALCS LOUED NEELD GLIDE
GLINT: TALCS LOTTE GLINT
GLOAT: TALCS PLEAT BLOAT FLOAT GLOAT
GLOBE: TALCS LOUED GLOBE
GLOOM: TALCS LOUED BLOOK GLOOP GLOOM
GLORY: TALCS LOUED BLOOK FLONG GLORY
GLOSS: TALCS LORES BLOGS GLOWS GLOMS GLOPS
GLOVE: TALCS LOUED GLOBE GLOZE GLOVE
GLYPH: TALCS LOUED GIRLY GLYPH
GNASH: TALCS SPAER AWASH GNASH
GNOME: TALCS RONDE PHONE KNOWE GNOME
GODLY: TALCS LOUED DOILY GODLY
GOING: TALCS RONDE MOONY GOING
GOLEM: TALCS POLEY VOLED GOLEM
GOLLY: TALCS POLEY DOLLY FOLLY HOLLY LOLLY
GONAD: TALCS ARENA HOGAN GONAD
GONER: TALCS RONDE HONER BONER GONER
GOODY: TALCS RONDE DOWDY FOODY HOODY MOODY
GOOEY: TALCS RONDE BOKEH POGEY GOOEY
GOOFY: TALCS RONDE GOMBO GOOFY
GOOSE: TALCS SIREN SOUSE BOWSE GOOSE
GORGE: TALCS RONDE FORME GORGE
GOUGE: TALCS RONDE BOGIE VOUGE GOUGE
GOURD: TALCS RONDE DOBRO GOURD
GRACE: TALCS REACH BRACE GRACE
GRADE: TALCS ARENA GRADE
GRAFT: TALCS IRATE GRANT GRAFT
GRAIL: TALCS ALANE DRAIL GRAIL
GRAIN: TALCS ARENA BRAWN DRAIN GRAIN
GRAND: TALCS ARENA KRANG GRAND
GRANT: TALCS IRATE GRANT
GRAPE: TALCS ARENA GRADE GRAVE GRAPE
GRAPH: TALCS ARENA BRAID GRAPY GRAPH
GRASP: TALCS SPAER GRASP
GRASS: TALCS SEARS BRASS FRASS GRASS
GRATE: TALCS IRATE URATE WRATE ORATE GRATE
GRAVE: TALCS ARENA GRADE GRAVE
GRAVY: TALCS ARENA BRAID GRAPY GRAVY
GRAZE: TALCS ARENA GRADE GRAVE GRAPE GRAME
GREAT: TALCS IRATE ARMET GREAT
GREED: TALCS RONDE DRIER GRUED GREED
GREEN: TALCS RONDE GREEN
GREET: TALCS ROTTE FREET GREET
GRIEF: TALCS RONDE FERER GRIEF
GRILL: TALCS LOUED GIRLY GRILL
GRIME: TALCS RONDE GERBE GRIKE GRIPE GRIME
GRIMY: TALCS RONDE GRIMY
GRIND: TALCS RONDE UNRID GRIND
GRIPE: TALCS RONDE GERBE GRIKE GRIPE
GROAN: TALCS ARENA BRAWN ORGAN GROAN
GROIN: TALCS RONDE PRION GROIN
GROOM: TALCS RONDE GROOM
GROPE: TALCS RONDE PROBE GROPE
GROSS: TALCS DORES BROGS GROSS
GROUP: TALCS RONDE GROOM GROUP
GROUT: TALCS ROTTE GRIOT GROUT
GROVE: TALCS RONDE PROBE FRORE WROKE GROVE
GROWL: TALCS LOUED BLOOK GROWL
GROWN: TALCS RONDE PRION BROWN FROWN GROWN
GRUEL: TALCS LOUED BLUEY GRUEL
GRUFF: TALCS RONDE GRIMY GRUFF
GRUNT: TALCS ROTTE GRIPT GRUNT
GUARD: TALCS ARENA DIRAM HOARD GUARD
GUAVA: TALCS ARENA KHAYA GUAVA
GUESS: TALCS DORES KEENS SHEWS GUESS
GUEST: TALCS STIRE PESTO GUEST
GUIDE: TALCS RONDE EXUDE GUIDE
GUILD: TALCS LOUED BUILD GUILD
GUILE: TALCS LOUED GUILE
GUILT: TALCS LOTTE GLINT GUILT
GUISE: TALCS SIREN POISE GUISE
GULCH: TALCS MILCH BELCH CULCH GULCH
GULLY: TALCS POLEY GILLY GULLY
GUMBO: TALCS RONDE HIMBO JUMBO GUMBO
GUMMY: TALCS RONDE PIGMY GUMMY
GUPPY: TALCS RONDE PIGMY GUPPY
GUSTO: TALCS STIRE GUSTY GUSTO
GUSTY: TALCS STIRE GUSTY
GYPSY: TALCS SIREN BUSHY MOPSY GYPSY
HABIT: TALCS RAITA PATIN DAVIT HABIT
HAIRY: TALCS RAMEN BARKY HARDY HAIRY
HALVE: TALCS PALEA VALVE HALVE
HANDY: TALCS RAMEN PANDA BANDH HANDY
HAPPY: TALCS RAMEN KADAI GABBY ZAPPY YAPPY
HARDY: TALCS RAMEN BARKY PARRY HARDY
HAREM: TALCS RAMEN MAKER HAREM
HARPY: TALCS RAMEN BARKY PARRY HARPY
HARRY: TALCS RAMEN BARKY PARRY HARRY
HARSH: TALCS SANER HARSH
HASTE: TALCS SAITH HASTE
HASTY: TALCS SAITH HASTE HASTY
HATCH: TALCS NATCH WATCH PATCH BATCH CATCH
HATER: TALCS RAITA GATOR WATER MATER DATER
HAUNT: TALCS RAITA DATUM JAUNT NAUNT GAUNT
HAUTE: TALCS RAITA BANTY VAUTE HAUTE
HAVEN: TALCS RAMEN WAKEN PAVEN DAVEN HAVEN
HAVOC: TALCS CARED MACHO HAVOC
HAZEL: TALCS LAYER GAVEL HAZEL
HEADY: TALCS ARENA BEADY HEADY
HEARD: TALCS ARENA REBAR DEARY HEARD
HEART: TALCS IRATE HEART
HEATH: TALCS IRATE BEATH NEATH HEATH
HEAVE: TALCS ARENA BEADY HEAVE
HEAVY: TALCS ARENA BEADY HEAVY
HEDGE: TALCS RONDE KIDGE BUDGE HEDGE
HEFTY: TALCS ROTTE DEPTH HEFTY
HEIST: TALCS STIRE GEIST DEIST HEIST
HELIX: TALCS POLEY MILLE FELID HELIX
HELLO: TALCS POLEY JELLO HELLO
HENCE: TALCS CHICO HENCE
HERON: TALCS RONDE ERGON HERON
HILLY: TALCS POLEY GILLY DILLY BILLY FILLY
HINGE: TALCS RONDE GENIE HINGE
HIPPO: TALCS RONDE HIMBO HIPPO
HIPPY: TALCS RONDE PIGMY HIPPY
HITCH: TALCS EDICT GITCH BITCH MITCH WITCH
HOARD: TALCS ARENA DIRAM HOARD
HOBBY: TALCS RONDE GOMBO BOBBY YOBBY HOBBY
HOIST: TALCS STIRE MOIST JOIST HOIST
HOLLY: TALCS POLEY DOLLY FOLLY HOLLY
HOMER: TALCS RONDE MOWER GOMER VOMER HOMER
HONEY: TALCS RONDE BONEY MONEY PONEY HONEY
HONOR: TALCS RONDE HONOR
HORDE: TALCS RONDE BORDE HORDE
HORNY: TALCS RONDE MORON HORNY
HORSE: TALCS SIREN HEROS HORSE
HOTEL: TALCS LOTTE MOTEL HOTEL
HOTLY: TALCS LOTTE HOTLY
HOUND: TALCS RONDE WOUND BOUND MOUND FOUND
HOUSE: TALCS SIREN SOUSE MOUSE DOUSE BOUSE
HOVEL: TALCS LOUED VOWEL HOVEL
HOVER: TALCS RONDE MOWER POKER GOFER BORER
HOWDY: TALCS RONDE DOWDY HOWDY
HUMAN: TALCS ARENA HOGAN HUMAN
HUMID: TALCS RONDE DIPPY HUMID
HUMOR: TALCS RONDE GROOM HUMOR
HUMPH: TALCS RONDE PIGMY BUMPH HUMPH
HUMUS: TALCS DORES MINKS GYMPS BUMFS HUMUS
HUNCH: TALCS CHICO HENCE HUNCH
HUNKY: TALCS RONDE GUNNY BUNJY FUNKY HUNKY
HURRY: TALCS RONDE GRIMY FURRY HURRY
HUSKY: TALCS SIREN BUSHY HUSSY HUSKY
HUSSY: TALCS SIREN BUSHY HUSSY
HUTCH: TALCS EDICT TROCK BUTCH MUTCH CUTCH
HYDRO: TALCS RONDE DROOK HYDRO
HYENA: TALCS ARENA VEENA QUENA HYENA
HYMEN: TALCS RONDE HEMIN HYMEN
HYPER: TALCS RONDE FERER VIPER UPPER HYPER
ICILY: TALCS CLINE ICILY
ICING: TALCS COREY MUCID ICING
IDEAL: TALCS ALANE MAERL ZOEAL UVEAL IDEAL
IDIOM: TALCS RONDE DUOMO IDIOM
IDIOT: TALCS ROTTE BIGOT IMPOT IDIOT
IDLER: TALCS POLEY RILED IDLER
IDYLL: TALCS LOUED DRILL IDYLL
IGLOO: TALCS POLEY FILLO IGLOO
ILIAC: TALCS CLEAR ILIAC
IMAGE: TALCS ARENA BEADY PHAGE IMAGE
IMBUE: TALCS RONDE PUMIE IMBUE
IMPEL: TALCS LOUED REPEL IMPEL
IMPLY: TALCS LOUED GIRLY IMPLY
INANE: TALCS ARENA BEANY DIANE INANE
INBOX: TALCS RONDE GIPON INBOX
INCUR: TALCS COREY RUNIC INCUR
INDEX: TALCS RONDE INDEW INDEX
INEPT: TALCS ROTTE MEINT INEPT
INERT: TALCS ROTTE FREET PIERT INERT
INFER: TALCS RONDE GREEN INFER
INGOT: TALCS ROTTE BIGOT INGOT
INLAY: TALCS POLAR UNLAY INLAY
INLET: TALCS FILET INLET
INNER: TALCS RONDE BINER INNER
INPUT: TALCS ROTTE NITID QUINT INPUT
INTER: TALCS ROTTE MITER INTER
INTRO: TALCS ROTTE INTRO
IONIC: TALCS COREY DOMIC IONIC
IRATE: TALCS IRATE
IRONY: TALCS RONDE PRION IRONY
ISLET: TALCS ISLET
ISSUE: TALCS SIREN POISE ISSUE
ITCHY: TALCS CRUET NOTCH ITCHY
IVORY: TALCS RONDE GROOM IVORY
JAUNT: TALCS RAITA DATUM JAUNT
JAZZY: TALCS RAMEN KADAI GABBY ZAPPY JAZZY
JELLY: TALCS POLEY BELLY KELLY GELLY WELLY
JERKY: TALCS RONDE FERER PERKY JERKY
JETTY: TALCS ROTTE BETTY JETTY
JEWEL: TALCS LOUED REPEL BEVEL NEWEL JEWEL
JIFFY: TALCS RONDE PIGMY FIZZY BIFFY JIFFY
JOINT: TALCS ROTTE POINT JOINT
JOIST: TALCS STIRE MOIST JOIST
JOKER: TALCS RONDE MOWER POKER KOKER JOKER
JOLLY: TALCS POLEY DOLLY FOLLY HOLLY LOLLY
JOUST: TALCS STIRE GUSTY MOUST JOUST
JUDGE: TALCS RONDE KIDGE BUDGE PUDGE MUDGE
JUICE: TALCS CHICO PRICE JUICE
JUICY: TALCS CHICO PRICE JUICY
JUMBO: TALCS RONDE HIMBO JUMBO
JUMPY: TALCS RONDE PIGMY JUMPY
JUNTA: TALCS IRATE OUTTA JUNTA
JUNTO: TALCS ROTTE JUNTO
JUROR: TALCS RONDE GROOM JUROR
KAPPA: TALCS RAMEN KADAI KAPPA
KARMA: TALCS RAMEN MARIA PARMA KARMA
KAYAK: TALCS RAMEN KADAI KABAB KAWAU KAYAK
KEBAB: TALCS ARENA BEADY KEBAB
KHAKI: TALCS ARENA PIKAU ADUKI KHAKI
KINKY: TALCS RONDE GUNNY PINKY ZINKY KINKY
KIOSK: TALCS SIREN PISOS KIOSK
KITTY: TALCS ROTTE NUTTY DITTY BITTY KITTY
KNACK: TALCS REACH KIACK KYACK KNACK
KNAVE: TALCS ARENA VEGAN KNAVE
KNEAD: TALCS ARENA QUEAN KNEAD
KNEED: TALCS RONDE INDEW KNEED
KNEEL: TALCS LOUED REPEL WHEEL KNEEL
KNELT: TALCS LOTTE GLENT KNELT
KNIFE: TALCS RONDE NEIVE WHINE KNIFE
KNOCK: TALCS CHICO BONCE KNOCK
KNOLL: TALCS LOUED BLOOK KNOLL
KNOWN: TALCS RONDE GIPON KNOWN
KOALA: TALCS ALANE KRAAL KOALA
KRILL: TALCS LOUED GIRLY PRILL FRILL KRILL
LABEL: TALCS LAYER LAMED LABEL
LABOR: TALCS LAYER LAHAR LABOR
LADEN: TALCS LAYER LAMED LADEN
LADLE: TALCS LAYER LADLE
LAGER: TALCS LAYER LAGER
LANCE: TALCS LAICH LANCE
LANKY: TALCS LAYER LAMMY LANKY
LAPEL: TALCS LAYER LAMED LABEL LAPEL
LAPSE: TALCS LASED LAPSE
LARGE: TALCS LAYER LARGE
LARVA: TALCS LAYER LAURA LARVA
LASSO: TALCS LASED LASSY LASSI LASSU LASSO
LATCH: TALCS LATCH
LATER: TALCS LATHE LATEN LATER
LATHE: TALCS LATHE
LATTE: TALCS LATHE LATKE LATTE
LAUGH: TALCS LAYER LANAI LAZZO LAUGH
LAYER: TALCS LAYER
LEACH: TALCS PLACE LEACH
LEAFY: TALCS ALANE LEARY LEAVY LEAKY LEADY
LEAKY: TALCS ALANE LEARY LEAVY LEAKY
LEANT: TALCS PLEAT LEANT
LEAPT: TALCS PLEAT LEAPT
LEARN: TALCS ALANE LEARN
LEASE: TALCS SHALE LEASE
LEASH: TALCS SHALE LEASH
LEAST: TALCS SPALT LEAST
LEAVE: TALCS ALANE LEAVE
LEDGE: TALCS LOUED LEDGE
LEECH: TALCS LEUCO LECCY LEECH
LEERY: TALCS LOUED LIEGE LEERY
LEFTY: TALCS LOTTE LEFTY
LEGAL: TALCS ALANE MAERL PEDAL LEGAL
LEGGY: TALCS LOUED LIEGE LEGGY
LEMON: TALCS LOUED LEMON
LEMUR: TALCS LOUED LEMUR
LEPER: TALCS LOUED LINER LEPER
LEVEL: TALCS LOUED LINER LEVEL
LEVER: TALCS LOUED LINER LEPER LEVER
LIBEL: TALCS LOUED LINER LIBEL
LIEGE: TALCS LOUED LIEGE
LIGHT: TALCS LOTTE LIMIT LIGHT
LIKEN: TALCS LOUED LINER LIVEN LIKEN
LILAC: TALCS LILAC
LIMBO: TALCS LOUED LINGO LIMBO
LIMIT: TALCS LOTTE LIMIT
LINEN: TALCS LOUED LINER LINEN
LINER: TALCS LOUED LINER
LINGO: TALCS LOUED LINGO
LIPID: TALCS LOUED LIVID LIPID
LITHE: TALCS LOTTE LITHE
LIVER: TALCS LOUED LINER LIBER LIGER LIFER
LIVID: TALCS LOUED LIVID
LLAMA: TALCS ALANE ULAMA LLAMA
LOAMY: TALCS ALANE DRAIL QUALM LOAMY
LOATH: TALCS PLEAT LOATH
LOBBY: TALCS LOUED LOGON LOWRY LOBBY
LOCAL: TALCS CLEAR FOCAL LOCAL
LOCUS: TALCS CIELS LUCKS LOCUS
LODGE: TALCS LOUED LODGE
LOFTY: TALCS LOTTE LOFTY
LOGIC: TALCS CLINE LORIC LOGIC
LOGIN: TALCS LOUED LOGON LOGIN
LOOPY: TALCS LOUED LOGON LOOBY LOOKY LOOPY
LOOSE: TALCS SPIEL WEELS LOUSE LOOSE
LORRY: TALCS LOUED LOGON LOWRY LORRY
LOSER: TALCS SPIEL LOSER
LOUSE: TALCS SPIEL WEELS LOUSE
LOUSY: TALCS SPIEL FLUSH LOUSY
LOVER: TALCS LOUED LONER LOPER LOWER LOVER
LOWER: TALCS LOUED LONER LOPER LOWER
LOWLY: TALCS LOUED LOGON LOWRY LOWLY
LOYAL: TALCS ALANE MORAL POKAL JOUAL LOYAL
LUCID: TALCS CLINE LORIC LUCID
LUCKY: TALCS CLINE LOCUM LUCKY
LUMEN: TALCS LOUED LUREX LUMEN
LUMPY: TALCS LOUED LURGI LUMMY LUMPY
LUNAR: TALCS ALANE LINGA LUNAR
LUNCH: TALCS LEUCO LURCH LUNCH
LUNGE: TALCS LOUED LEMUR LUNGE
LUPUS: TALCS LORES LINKS LUPUS
LURCH: TALCS LEUCO LURCH
LURID: TALCS LOUED LURID
LUSTY: TALCS STILE GLOST LUSTY
LYING: TALCS LOUED LINKY LYING
LYMPH: TALCS LOUED LINKY LYMPH
LYNCH: TALCS LEUCO LYNCH
LYRIC: TALCS CLINE LORIC LYRIC
MACAW: TALCS CARED MACHO MACAW
MACHO: TALCS CARED MACHO
MACRO: TALCS CARED RACON MACRO
MADAM: TALCS RAMEN MAHUA MADAM
MADLY: TALCS LAYER MADLY
MAFIA: TALCS RAMEN MAHUA MAGMA MAFIA
MAGIC: TALCS CARED MACHO MAGIC
MAGMA: TALCS RAMEN MAHUA MAGMA
MAIZE: TALCS RAMEN MAVIE MAIZE
MAJOR: TALCS RAMEN MARIA MAJOR
MAKER: TALCS RAMEN MAKER
MAMBO: TALCS RAMEN MAMBA MAMBO
MAMMA: TALCS RAMEN MAMBA MAMMA
MAMMY: TALCS RAMEN MAMBA MAMMY
MANGA: TALCS RAMEN MANIA MANNA MANGA
MANGE: TALCS RAMEN MANGE
MANGO: TALCS RAMEN MANIA MANGO
MANGY: TALCS RAMEN MANIA MANGO MANGY
MANIA: TALCS RAMEN MANIA
MANIC: TALCS CARED MACHO MAGIC MANIC
MANLY: TALCS LAYER MADLY MANLY
MANOR: TALCS RAMEN MANOR
MAPLE: TALCS LAYER PAGLE MAPLE
MARCH: TALCS RANCH PARCH MARCH
MARRY: TALCS RAMEN MARIA MARRY
MARSH: TALCS SANER HARSH MARSH
MASON: TALCS SANER BASON MASON
MASSE: TALCS SANER PASSE BASSE MASSE
MATCH: TALCS NATCH WATCH PATCH BATCH CATCH
MATEY: TALCS RAITA DATUM MATEY
MAUVE: TALCS RAMEN MAVIE MAUVE
MAXIM: TALCS RAMEN MAHUA MADID MAXIM
MAYBE: TALCS RAMEN MAVIE MAYBE
MAYOR: TALCS RAMEN MARIA MAJOR MAYOR
MEALY: TALCS ALANE LEARY MEALY
MEANT: TALCS IRATE MEANT
MEATY: TALCS IRATE BEATH PEATY MEATY
MECCA: TALCS REACH MECCA
MEDAL: TALCS ALANE MAERL MEDAL
MEDIA: TALCS ARENA KEHUA MEDIA
MEDIC: TALCS COREY HEMIC MEDIC
MELEE: TALCS POLEY RILED GOLEM MELEE
MELON: TALCS POLEY JELLO MELON
MERCY: TALCS CHICO PERCE MERCY
MERGE: TALCS RONDE GERBE MERGE
MERIT: TALCS ROTTE FREET MERIT
MERRY: TALCS RONDE FERER BERRY HERRY VERRY
METAL: TALCS PLEAT METAL
METER: TALCS ROTTE MITER METER
METRO: TALCS ROTTE OFTER METRO
MICRO: TALCS COREY OCCUR MICRO
MIDGE: TALCS RONDE KIDGE MIDGE
MIDST: TALCS STIRE MIDST
MIGHT: TALCS ROTTE NITID WIFTY TIMBO MIGHT
MILKY: TALCS POLEY GILLY FILMY MILKY
MIMIC: TALCS COREY MUCID MIMIC
MINCE: TALCS CHICO MINCY MINCE
MINER: TALCS RONDE BINER MINER
MINIM: TALCS RONDE GUNNY MINIM
MINOR: TALCS RONDE MINOR
MINTY: TALCS ROTTE MINTY
MINUS: TALCS DORES MINKS MINGS MINUS
MIRTH: TALCS ROTTE FIRTH GIRTH BIRTH YIRTH
MISER: TALCS SIREN RIMES MISER
MISSY: TALCS SIREN PISOS MISSY
MOCHA: TALCS CRENA PUCKA MOCHA
MODAL: TALCS ALANE MORAL MODAL
MODEL: TALCS LOUED YODEL MODEL
MODEM: TALCS RONDE POHED MODEM
MOGUL: TALCS LOUED YOKUL WOFUL MOGUL
MOIST: TALCS STIRE MOIST
MOLAR: TALCS POLAR VOLAR BOLAR MOLAR
MOLDY: TALCS POLEY DOLLY GOLDY MOLDY
MONEY: TALCS RONDE BONEY MONEY
MONTH: TALCS ROTTE BOOTY FOUTH MONTH
MOODY: TALCS RONDE DOWDY FOODY HOODY MOODY
MOOSE: TALCS SIREN SOUSE BOWSE GOOSE MOOSE
MORAL: TALCS ALANE MORAL
MORON: TALCS RONDE MORON
MORPH: TALCS RONDE MOORY MORPH
MOSSY: TALCS SIREN BUSHY MOSSY
MOTEL: TALCS LOTTE MOTEL
MOTIF: TALCS ROTTE POTIN MOTIF
MOTOR: TALCS ROTTE MOTOR
MOTTO: TALCS ROTTE POTTY MOTTO
MOULT: TALCS LOTTE MOULT
MOUND: TALCS RONDE WOUND BOUND MOUND
MOUNT: TALCS ROTTE POINT MOUNT
MOURN: TALCS RONDE MORON MOURN
MOUSE: TALCS SIREN SOUSE MOUSE
MOUTH: TALCS ROTTE BOOTY FOUTH MOUTH
MOVER: TALCS RONDE MOWER MOVER
MOVIE: TALCS RONDE BOGIE MOXIE MOVIE
MOWER: TALCS RONDE MOWER
MUCKY: TALCS COREY DUCKY YUCKY GUCKY MUCKY
MUCUS: TALCS CORES MUCUS
MUDDY: TALCS RONDE BUDDY MUDDY
MULCH: TALCS MILCH MULCH
MUMMY: TALCS RONDE PIGMY MUMMY
MUNCH: TALCS CHICO HENCE PUNCH BUNCH DUNCH
MURAL: TALCS ALANE MORAL MURAL
MURKY: TALCS RONDE GRIMY MURKY
MUSHY: TALCS SIREN BUSHY PUSHY MUSHY
MUSIC: TALCS SCORE CUSPY MUSIC
MUSKY: TALCS SIREN BUSHY MUSSY MUSKY
MUSTY: TALCS STIRE GUSTY DUSTY MUSTY
MYRRH: TALCS RONDE GRIMY MYRRH
NADIR: TALCS RAMEN NAIRA NAZIR NADIR
NAIVE: TALCS RAMEN PANNE NAEVE NAIVE
NANNY: TALCS RAMEN PANDA KANJI FANNY NANNY
NASAL: TALCS LASED VASAL BASAL NASAL
NASTY: TALCS SAITH PASTY MASTY VASTY NASTY
NATAL: TALCS LATHE FATLY NATAL
NAVAL: TALCS LAYER NAHAL NAVAL
NAVEL: TALCS LAYER GAVEL FAVEL JAVEL NAVEL
NEEDY: TALCS RONDE NEDDY NEEDY
NEIGH: TALCS RONDE HEMIN NEIGH
NERDY: TALCS RONDE NERDY
NERVE: TALCS RONDE URINE NERVE
NEVER: TALCS RONDE GREEN NEPER NEWER NEVER
NEWER: TALCS RONDE GREEN NEPER NEWER
NEWLY: TALCS LOUED GERLE WEILS NEWLY
NICER: TALCS COREY RICED NICER
NICHE: TALCS COREY HEMIC NICHE
NIECE: TALCS CHICO MINCY NIECE
NIGHT: TALCS ROTTE NITID NIGHT
NINJA: TALCS ARENA DONGA BUNIA NINJA
NINNY: TALCS RONDE GUNNY MINNY FINNY HINNY
NINTH: TALCS ROTTE MINTY NINTH
NOBLE: TALCS LOUED MOBLE ROBLE NOBLE
NOBLY: TALCS LOUED MOOLI FONLY NOBLY
NOISE: TALCS SIREN NOISE
NOISY: TALCS SIREN NKOSI NOISY
NOMAD: TALCS ARENA HOGAN NOWAY NOMAD
NOOSE: TALCS SIREN MENSE NOOSE
NORTH: TALCS ROTTE BORTY FORTH WORTH NORTH
NOSEY: TALCS SIREN ENSEW NOSEY
NOTCH: TALCS EDICT TROCK GOTCH BOTCH NOTCH
NOVEL: TALCS LOUED VOWEL HOVEL NOVEL
NUDGE: TALCS RONDE UNDEE NUDGE
NURSE: TALCS SIREN NURSE
NUTTY: TALCS ROTTE NUTTY
NYLON: TALCS POLEY NYLON
NYMPH: TALCS RONDE NYMPH
OAKEN: TALCS RAMEN WAKEN BAKEN OAKEN
OBESE: TALCS SIREN SOUSE OBESE
OCCUR: TALCS COREY OCCUR
OCEAN: TALCS CRENA OCEAN
OCTAL: TALCS CLAPT OCTAL
OCTET: TALCS CRUET ONCET OCTET
ODDER: TALCS RONDE ORDER ODDER
ODDLY: TALCS LOUED DROOL ODDLY
OFFAL: TALCS ALANE MORAL OFFAL
OFFER: TALCS RONDE BEVOR ORMER OFFER
OFTEN: TALCS ROTTE BETON OFTEN
OLDEN: TALCS LOUED OLDEN
OLDER: TALCS LOUED OLDEN OLDER
OLIVE: TALCS LOUED GLOBE OLIVE
OMBRE: TALCS RONDE PROBE OMBRE
OMEGA: TALCS ARENA KEEMA OMEGA
ONION: TALCS RONDE GIPON INION ONION
ONSET: TALCS STIRE PESTO ONSET
OPERA: TALCS ARENA RUEDA OPERA
OPINE: TALCS RONDE PHONE OPINE
OPIUM: TALCS RONDE HIMBO OPIUM
OPTIC: TALCS CRUET NOTCH OPTIC
ORBIT: TALCS ROTTE GRIOT DROIT ORBIT
ORDER: TALCS RONDE ORDER
ORGAN: TALCS ARENA BRAWN ORGAN
OTHER: TALCS ROTTE OVERT OTHER
OTTER: TALCS ROTTE OTTER
OUGHT: TALCS ROTTE BIGOT OUGHT
OUNCE: TALCS CHICO BONCE OUNCE
OUTDO: TALCS ROTTE PITON OUTGO OUTDO
OUTER: TALCS ROTTE OFTER OXTER OUTER
OUTGO: TALCS ROTTE PITON OUTGO
OVARY: TALCS ARENA DIRAM HOARY OVARY
OVATE: TALCS IRATE ABATE ENATE OVATE
OVERT: TALCS ROTTE OVERT
OVINE: TALCS RONDE PHONE OVINE
OVOID: TALCS RONDE DUOMO OVOID
OWING: TALCS RONDE GIPON OWING
OWNER: TALCS RONDE GENRO OWNER
OXIDE: TALCS RONDE EXODE OXIDE
OZONE: TALCS RONDE PHONE OZONE
PADDY: TALCS RAMEN KADAI BADDY FADDY DADDY
PAGAN: TALCS RAMEN PAGAN
PAINT: TALCS RAITA FAITH PAINT
PALER: TALCS PALEA PALED PALER
PALSY: TALCS SALLE BALSA PALSY
PANEL: TALCS LAYER GAVEL HAZEL BABEL PANEL
PANIC: TALCS CARED MACHO PANIC
PANSY: TALCS SANER HANSA PANSY
PAPAL: TALCS LAYER NAHAL VAGAL PAPAL
PAPER: TALCS RAMEN PARED PAPER
PARER: TALCS RAMEN PARED PAREO PAREU PAREV
PARKA: TALCS RAMEN BARKY PARKA
PARRY: TALCS RAMEN BARKY PARRY
PARSE: TALCS SANER MARSE PARSE
PARTY: TALCS RAITA PARTY
PASTA: TALCS SAITH PASTY PASTA
PASTE: TALCS SAITH PASTY PASTA PASTE
PASTY: TALCS SAITH PASTY
PATCH: TALCS NATCH WATCH PATCH
PATIO: TALCS RAITA PATIN PATIO
PATSY: TALCS SAITH YATES PATSY
PATTY: TALCS RAITA BANTY PATTY
PAUSE: TALCS SANER PASSE PAUSE
PAYEE: TALCS RAMEN WAVEY HAYED PAYEE
PAYER: TALCS RAMEN PARED PAPER PAGER PAWER
PEACE: TALCS REACH PEACE
PEACH: TALCS REACH BEACH PEACH
PEARL: TALCS ALANE LEARY PEARL
PECAN: TALCS CRENA DECAN PECAN
PEDAL: TALCS ALANE MAERL PEDAL
PENAL: TALCS ALANE PENAL
PENCE: TALCS CHICO PERCE PEECE PENCE
PENNE: TALCS RONDE GENIE PENNE
PENNY: TALCS RONDE PENNY
PERCH: TALCS CHICO HENCE MERCH PERCH
PERIL: TALCS LOUED GERLE MERIL PERIL
PERKY: TALCS RONDE FERER PERKY
PESKY: TALCS SIREN SOUSE PESKY
PESTO: TALCS STIRE PESTO
PETAL: TALCS PLEAT PETAL
PETTY: TALCS ROTTE BETTY JETTY PETTY
PHASE: TALCS SPAER PEASE PHASE
PHONE: TALCS RONDE PHONE
PHONY: TALCS RONDE GIPON PHONY
PHOTO: TALCS ROTTE JUNTO PHOTO
PIANO: TALCS ARENA PIANO
PICKY: TALCS COREY DUCKY PICKY
PIECE: TALCS CHICO MINCY PIECE
PIETY: TALCS ROTTE DEPTH PIETY
PIGGY: TALCS RONDE PIGMY PIGGY
PILOT: TALCS FILET PILOT
PINCH: TALCS CHICO PINCH
PINEY: TALCS RONDE PENNY PINEY
PINKY: TALCS RONDE GUNNY PINKY
PINTO: TALCS ROTTE JUNTO PINTO
PIPER: TALCS RONDE FERER VIPER PIPER
PIQUE: TALCS RONDE PUMIE PIQUE
PITCH: TALCS EDICT GITCH BITCH MITCH WITCH
PITHY: TALCS ROTTE PITHY
PIVOT: TALCS ROTTE BIGOT DIVOT PIVOT
PIXEL: TALCS LOUED REPEL PIXEL
PIXIE: TALCS RONDE PUMIE PYXIE PIXIE
PIZZA: TALCS ARENA PODIA PIZZA
PLACE: TALCS PLACE
PLAID: TALCS ALANE FLARY PLAID
PLAIN: TALCS ALANE BLAIN PLAIN
PLAIT: TALCS PLEAT PLAIT
PLANE: TALCS ALANE PLANE
PLANK: TALCS ALANE BLANK PLANK
PLANT: TALCS PLEAT PLAIT PLATT PLANT
PLATE: TALCS PLEAT PLATE
PLAZA: TALCS ALANE ULAMA PLAZA
PLEAD: TALCS ALANE GLEBA ILEAL FLEAM PLEAD
PLEAT: TALCS PLEAT
PLIED: TALCS LOUED FLIED PLIED
PLIER: TALCS LOUED REPEL PLIER
PLUCK: TALCS LEUCO PLUCK
PLUMB: TALCS LOUED FLUMP PLUMY PLUMB
PLUME: TALCS LOUED FLUME GLUME PLUME
PLUMP: TALCS LOUED FLUMP PLUMP
PLUNK: TALCS LOUED FLUMP PLUNK
PLUSH: TALCS SPIEL PLUSH
POESY: TALCS SIREN SOUSE POESY
POINT: TALCS ROTTE POINT
POISE: TALCS SIREN POISE
POKER: TALCS RONDE MOWER POKER
POLAR: TALCS POLAR
POLKA: TALCS POLAR POLKA
POLYP: TALCS POLEY POLYP
POOCH: TALCS CHICO POUCH POOCH
POPPY: TALCS RONDE GOMBO POUPE POPPY
PORCH: TALCS CHICO POUCH POOCH PORCH
POSER: TALCS SIREN HOSER POSER
POSIT: TALCS STIRE MIDST POSIT
POSSE: TALCS SIREN SOUSE FOSSE GOSSE POSSE
POUCH: TALCS CHICO POUCH
POUND: TALCS RONDE WOUND BOUND MOUND FOUND
POUTY: TALCS ROTTE BOOTY PONTY POUTY
POWER: TALCS RONDE MOWER POWER
PRANK: TALCS ARENA KRANG BRANK PRANK
PRAWN: TALCS ARENA BRAWN DRAWN PRAWN
PREEN: TALCS RONDE GREEN PREEN
PRESS: TALCS DORES SEIRS PRESS
PRICE: TALCS CHICO PRICE
PRICK: TALCS CHICO PRICE PRICK
PRIDE: TALCS RONDE BRIDE GRIDE PRIDE
PRIED: TALCS RONDE DRIER FRIED WRIED PRIED
PRIME: TALCS RONDE GERBE FRIZE PRIME
PRIMO: TALCS RONDE GROOM PRIMO
PRINT: TALCS ROTTE GRIPT PRINT
PRIOR: TALCS RONDE GROOM PRIOR
PRISM: TALCS SIREN FRISK GRISY PRISM
PRIVY: TALCS RONDE GRIMY PRIVY
PRIZE: TALCS RONDE GERBE FRIZE PRIZE
PROBE: TALCS RONDE PROBE
PRONE: TALCS RONDE KRONE PRONE
PRONG: TALCS RONDE PRION PRONK PRONG
PROOF: TALCS RONDE GROOM BROOK PROOF
PROSE: TALCS SIREN EROSE PROSE
PROUD: TALCS RONDE DROOK PROUD
PROVE: TALCS RONDE PROBE PROVE
PROWL: TALCS LOUED BLOOK GROWL PROWL
PROXY: TALCS RONDE GROOM FRORY PROXY
PRUDE: TALCS RONDE BRIDE GRYDE PRUDE
PRUNE: TALCS RONDE URINE PRUNE
PSALM: TALCS SHALE PSALM
PUBIC: TALCS COREY MUCID PUBIC
PUDGY: TALCS RONDE DIPPY PUDGY
PUFFY: TALCS RONDE PIGMY PUFFY
PULPY: TALCS POLEY PULPY
PULSE: TALCS SOLDE PULSE
PUNCH: TALCS CHICO HENCE PUNCH
PUPAL: TALCS ALANE MORAL PIBAL PUPAL
PUPIL: TALCS LOUED RUMLY PUPIL
PUPPY: TALCS RONDE PIGMY PUFFY PUPPY
PUREE: TALCS RONDE GERBE HIREE PUREE
PURER: TALCS RONDE FERER WIRER PURER
PURGE: TALCS RONDE GERBE VIRGE PURGE
PURSE: TALCS SIREN HEROS BURSE PURSE
PUSHY: TALCS SIREN BUSHY PUSHY
PUTTY: TALCS ROTTE NUTTY GUTTY JUTTY VUTTY
PYGMY: TALCS RONDE PIGMY PYGMY
QUACK: TALCS REACH KIACK QUACK
QUAIL: TALCS ALANE DRAIL QUAIL
QUAKE: TALCS ARENA BEADY PHAGE QUAKE
QUALM: TALCS ALANE DRAIL QUALM
QUARK: TALCS ARENA DIRAM HOARY QUARK
QUART: TALCS IRATE OTARY QUART
QUASH: TALCS SPAER AWASH GNASH QUASH
QUASI: TALCS SPAER AWASH MIASM QUASI
QUEEN: TALCS RONDE HEMIN QUEEN
QUEER: TALCS RONDE FERER EMBER QUEER
QUELL: TALCS LOUED GUILE QUELL
QUERY: TALCS RONDE FERER PREMY QUERY
QUEST: TALCS STIRE PESTO GUEST QUEST
QUEUE: TALCS RONDE PUMIE FUGUE QUEUE
QUICK: TALCS CHICO PRICE JUICY QUICK
QUIET: TALCS ROTTE MEINT QUIET
QUILL: TALCS LOUED RUMLY QUILL
QUILT: TALCS LOTTE GLINT BUILT QUILT
QUIRK: TALCS RONDE GRIMY QUIRK
QUITE: TALCS ROTTE UNITE QUITE
QUOTA: TALCS IRATE OUTTA QUOTA
QUOTE: TALCS ROTTE QUOTE
QUOTH: TALCS ROTTE JUNTO QUOTH
RABBI: TALCS RAMEN RADIO RAHUI RABBI
RABID: TALCS RAMEN RADIO RABID
RACER: TALCS CARED FACER MACER RACER
RADAR: TALCS RAMEN RADIO RADAR
RADII: TALCS RAMEN RADIO RADIX RADII
RADIO: TALCS RAMEN RADIO
RAINY: TALCS RAMEN RANDY RAINY
RAISE: TALCS SANER MARSE RASSE RAISE
RAJAH: TALCS RAMEN RADIO RAYAH RAJAH
RALLY: TALCS PALEA BALDY RALLY
RALPH: TALCS PALEA JALOP RALPH
RAMEN: TALCS RAMEN
RANCH: TALCS RANCH
RANDY: TALCS RAMEN RANDY
RANGE: TALCS RAMEN RAINE RANGE
RAPID: TALCS RAMEN RADIO RABID RAPID
RARER: TALCS RAMEN RARED RAREE RARER
RASPY: TALCS SANER HARSH RASPY
RATIO: TALCS RAITA RATIO
RATTY: TALCS RAITA RATTY
RAVEN: TALCS RAMEN RAVEN
RAYON: TALCS RAMEN RAYON
RAZOR: TALCS RAMEN RADIO RAZOR
REACH: TALCS REACH
REACT: TALCS REACT
READY: TALCS ARENA REBAR REAMY READY
REALM: TALCS ALANE LEARY REALM
REARM: TALCS ARENA REBAR REARM
REBAR: TALCS ARENA REBAR
REBEL: TALCS LOUED REPEL REFEL REBEL
REBUS: TALCS DORES SEIRS REENS REBUS
REBUT: TALCS ROTTE RIVET REBUT
RECAP: TALCS CRENA ACRED RECAP
RECUR: TALCS COREY RECUR
RECUT: TALCS CRUET RECUT
REEDY: TALCS RONDE REDDY REEDY
REFER: TALCS RONDE REEFY REFER
REFIT: TALCS ROTTE RIVET REBIT REMIT REFIT
REGAL: TALCS ALANE MAERL FERAL REGAL
REHAB: TALCS ARENA REBAR REHAB
REIGN: TALCS RONDE REPIN REIGN
RELAX: TALCS POLAR RELAY RELAX
RELAY: TALCS POLAR RELAY
RELIC: TALCS CELOM RELIC
REMIT: TALCS ROTTE RIVET REBIT REMIT
RENAL: TALCS ALANE PENAL GENAL VENAL RENAL
RENEW: TALCS RONDE RENEW
REPAY: TALCS ARENA REBAR REPAY
REPEL: TALCS LOUED REPEL
REPLY: TALCS LOUED GERLE REPLY
RERUN: TALCS RONDE REPIN REMEN RERUN
RESET: TALCS STIRE PERST RESET
RESIN: TALCS SIREN RESIN
RETCH: TALCS EDICT TRECK RETCH
RETRO: TALCS ROTTE RETRO
RETRY: TALCS ROTTE RETRY
REUSE: TALCS SIREN EROSE REUSE
REVEL: TALCS LOUED REPEL REFEL REBEL REVEL
REVUE: TALCS RONDE REVIE REVUE
RHINO: TALCS RONDE RHINO
RHYME: TALCS RONDE REVIE RHYME
RIDER: TALCS RONDE REDID RIDER
RIDGE: TALCS RONDE RIDGE
RIFLE: TALCS LOUED GERLE RIFLE
RIGHT: TALCS ROTTE RIGHT
RIGID: TALCS RONDE RIGID
RIGOR: TALCS RONDE RUMPO RIGOR
RINSE: TALCS SIREN RINSE
RIPEN: TALCS RONDE REPIN RIPEN
RIPER: TALCS RONDE REEFY REMAP RIPER
RISEN: TALCS SIREN RISEN
RISER: TALCS SIREN RIMES RISER
RISKY: TALCS SIREN RISHI RISKY
RIVAL: TALCS ALANE MORAL RIYAL RIVAL
RIVER: TALCS RONDE REEFY REMAP RIVER
RIVET: TALCS ROTTE RIVET
ROACH: TALCS REACH ROACH
ROAST: TALCS STARE BRAST ROAST
ROBIN: TALCS RONDE ROBIN
ROBOT: TALCS ROTTE ROBOT
ROCKY: TALCS COREY ROCKY
RODEO: TALCS RONDE RODED RODEO
ROGER: TALCS RONDE ROPER ROGER
ROGUE: TALCS RONDE ROGUE
ROOMY: TALCS RONDE ROOPY ROOFY ROOMY
ROOST: TALCS STIRE WORST ROYST ROUST ROOST
ROTOR: TALCS ROTTE ROTOR
ROUGE: TALCS RONDE ROGUE ROUGE
ROUGH: TALCS RONDE ROOPY ROUGH
ROUND: TALCS RONDE ROWND ROUND
ROUSE: TALCS SIREN EROSE ROUSE
ROUTE: TALCS ROTTE RONTE ROUTE
ROVER: TALCS RONDE ROPER ROGER ROWER ROVER
ROWDY: TALCS RONDE ROWDY
ROWER: TALCS RONDE ROPER ROGER ROWER
ROYAL: TALCS ALANE MORAL ROYAL
RUDDY: TALCS RONDE RUDDY
RUDER: TALCS RONDE REDID RUDER
RUGBY: TALCS RONDE RHUMB RUGBY
RULER: TALCS POLEY RILED RULER
RUMBA: TALCS ARENA MOIRA RUMBA
RUMOR: TALCS RONDE RUMPO RUMOR
RUPEE: TALCS RONDE REVIE RUPEE
RURAL: TALCS ALANE MORAL FURAL DURAL JURAL
RUSTY: TALCS STIRE WORST RUSTY
SADLY: TALCS LASED SADLY
SAFER: TALCS SANER SAGER SAKER SASER SABER
SAINT: TALCS SAITH SAIST SAINT
SALAD: TALCS SALLE SALOP SALSA SALAD
SALLY: TALCS SALLE SALLY
SALON: TALCS SALLE SALOP SALON
SALSA: TALCS SALLE SALOP SALSA
SALTY: TALCS SALUT SALTO SALTY
SALVE: TALCS SALLE SALVE
SALVO: TALCS SALLE SALOP SALVO
SANDY: TALCS SANER SANGO SANDY
SANER: TALCS SANER
SAPPY: TALCS SANER SAUBA SAVOY SAPPY
SASSY: TALCS SANER SAUBA SAVOY SAPPY SAGGY
SATIN: TALCS SAITH SATAI SATIN
SATYR: TALCS SAITH SATYR
SAUCE: TALCS SAICE SAUCE
SAUCY: TALCS SAICE SAUCY
SAUNA: TALCS SANER SAVIN SAUNA
SAUTE: TALCS SAITH SANTO SAUTE
SAVOR: TALCS SANER SAPOR SAVOR
SAVOY: TALCS SANER SAUBA SAVOY
SAVVY: TALCS SANER SAUBA SAVOY SAVVY
SCALD: TALCS SCALP SCALD
SCALE: TALCS SCALP SCALD SCALA SCALY SCALL
SCALP: TALCS SCALP
SCALY: TALCS SCALP SCALD SCALA SCALY
SCAMP: TALCS SCARP SCAUP SCAMP
SCANT: TALCS SCART SCATT SCANT
SCARE: TALCS SCARP SCARY SCARF SCARE
SCARF: TALCS SCARP SCARY SCARF
SCARY: TALCS SCARP SCARY
SCENE: TALCS SCORE SCENE
SCENT: TALCS COSET SCENT
SCION: TALCS SCORE SCHMO SCION
SCOFF: TALCS SCORE SCOOP SCOFF
SCOLD: TALCS SCULP SCOLD
SCONE: TALCS SCORE SCOPE SCONE
SCOOP: TALCS SCORE SCOOP
SCOPE: TALCS SCORE SCOPE
SCORE: TALCS SCORE
SCORN: TALCS SCORE SCORN
SCOUR: TALCS SCORE SCOUR
SCOUT: TALCS COSET SCOUT
SCOWL: TALCS SCULP SCOWL
SCRAM: TALCS SCARP SCRAG SCRAY SCRAB SCRAE
SCRAP: TALCS SCARP SCRAP
SCREE: TALCS SCORE SCREE
SCREW: TALCS SCORE SCREW
SCRUB: TALCS SCORE SCRIM SCRUB
SCRUM: TALCS SCORE SCRIM SCRUM
SCUBA: TALCS SCARP SCHWA SCUBA
SEDAN: TALCS SPAER SEDAN
SEEDY: TALCS SIREN SPODE SEEDY
SEGUE: TALCS SIREN SPODE SEGUE
SEIZE: TALCS SIREN SPIKE SWIVE SEISE SEIZE
SEMEN: TALCS SIREN SEWEN SEMEN
SENSE: TALCS SIREN SHONE SENSE
SEPIA: TALCS SPAER SEPAD SEPIA
SERIF: TALCS SIREN SERIF
SERUM: TALCS SIREN SURGE SERUM
SERVE: TALCS SIREN SURGE SERVE
SETUP: TALCS STIRE SPENT SETUP
SEVEN: TALCS SIREN SEWEN SEMEN SEYEN SEVEN
SEVER: TALCS SIREN SKEER SEDER SEVER
SEWER: TALCS SIREN SKEER SEDER SEVER SEFER
SHACK: TALCS SHACK
SHADE: TALCS SPAER SHAME SHAKE SHAVE SHADE
SHADY: TALCS SPAER SHANK SHAYA SHADY
SHAFT: TALCS STARE SWATH SHAFT
SHAKE: TALCS SPAER SHAME SHAKE
SHAKY: TALCS SPAER SHANK SHAKO SHAKY
SHALE: TALCS SHALE
SHALL: TALCS SHALE SHALM SHALL
SHALT: TALCS SPALT SHALT
SHAME: TALCS SPAER SHAME
SHANK: TALCS SPAER SHANK
SHAPE: TALCS SPAER SHAPE
SHARD: TALCS SPAER SNARK SWARM SHARD
SHARE: TALCS SPAER SOARE SNARE SHARE
SHARK: TALCS SPAER SNARK SHARK
SHARP: TALCS SPAER SHARP
SHAVE: TALCS SPAER SHAME SHAKE SHAVE
SHAWL: TALCS SHALE SHAUL SHAWL
SHEAR: TALCS SPAER SEWAR SKEAR SMEAR SHEAR
SHEEN: TALCS SIREN SEWEN SHEEN
SHEEP: TALCS SIREN SKEED SHEEP
SHEER: TALCS SIREN SKEER SHEER
SHEET: TALCS STIRE SPENT SHEET
SHEIK: TALCS SIREN SPIKE SMEIK SHEIK
SHELF: TALCS SPIEL SOYLE SKELF SHELF
SHELL: TALCS SPIEL SMELL SWELL SKELL SHELL
SHIED: TALCS SIREN SKIED SPIED SHIED
SHIFT: TALCS STIRE SHIFT
SHINE: TALCS SIREN SEGNI SWINE SHINE
SHINY: TALCS SIREN SPINK SWING SHINY
SHIRE: TALCS SIREN SWIRE SHIRE
SHIRK: TALCS SIREN SHIRK
SHIRT: TALCS STIRE SNIRT SHIRT
SHOAL: TALCS SHALE SHOAL
SHOCK: TALCS SONCE SMOCK SHOCK
SHONE: TALCS SIREN SHONE
SHOOK: TALCS SIREN SOPHY SHOJO SHOOK
SHOOT: TALCS STIRE SHUNT SHOTT SHOOT
SHORE: TALCS SIREN SHORE
SHORN: TALCS SIREN SWORN SHORN
SHORT: TALCS STIRE SPORT SKORT SNORT SHORT
SHOUT: TALCS STIRE SHUNT SHOUT
SHOVE: TALCS SIREN SPODE SHOVE
SHOWN: TALCS SIREN SWOON SHOWN
SHOWY: TALCS SIREN SOPHY SHOWY
SHREW: TALCS SIREN SERED SORER SPREW SHREW
SHRUB: TALCS SIREN SPROG SHRUB
SHRUG: TALCS SIREN SPROG SHRUG
SHUCK: TALCS SONCE SPICY SHUCK
SHUNT: TALCS STIRE SHUNT
SHUSH: TALCS SIREN SOPHY SMUSH SHUSH
SHYLY: TALCS SPIEL SHULN SHYLY
SIEGE: TALCS SIREN SIEGE
SIEVE: TALCS SIREN SIEGE SIEVE
SIGHT: TALCS STIRE SIXTH SIGHT
SIGMA: TALCS SPAER SUBAH SIGNA SIGMA
SILKY: TALCS SOLDE SULLY SILKY
SILLY: TALCS SOLDE SULLY SILLY
SINCE: TALCS SONCE SINCE
SINEW: TALCS SIREN SINEW
SINGE: TALCS SIREN SINGE
SIREN: TALCS SIREN
SISSY: TALCS SIREN SISSY
SIXTH: TALCS STIRE SIXTH
SIXTY: TALCS STIRE SIXTH SIXTY
SKATE: TALCS STARE SKATE
SKIER: TALCS SIREN SHIER SPIER SKIER
SKIFF: TALCS SIREN SKIOS SKIVY SKIFF
SKILL: TALCS SPIEL SKIRL SKILL
SKIMP: TALCS SIREN SKIOS SKIVY SKIFF SKIMP
SKIRT: TALCS STIRE SNIRT SHIRT SPIRT SKIRT
SKULK: TALCS SPIEL SHULN SKULK
SKULL: TALCS SPIEL SKOOL SKULL
SKUNK: TALCS SIREN SNOWY SUNUP SKUNK
SLACK: TALCS SLACK
SLAIN: TALCS SHALE SWAIL SLAID SLAIN
SLANG: TALCS SHALE SWAIL SLANG
SLANT: TALCS SPALT SLANT
SLASH: TALCS SHALE SLASH
SLATE: TALCS SPALT SLATE
SLAVE: TALCS SHALE SLAKE SLANE SLAVE
SLEEK: TALCS SPIEL SLEER SLEEK
SLEEP: TALCS SPIEL SLEEP
SLEET: TALCS STILE SLEPT SLEET
SLEPT: TALCS STILE SLEPT
SLICE: TALCS SLICK SLICE
SLICK: TALCS SLICK
SLIDE: TALCS SPIEL SLIME SLIVE SLIDE
SLIME: TALCS SPIEL SLIME
SLIMY: TALCS SPIEL SHILY SLIMY
SLING: TALCS SPIEL SHILY SLINK SLING
SLINK: TALCS SPIEL SHILY SLINK
SLOOP: TALCS SPIEL SLURP SLOOP
SLOPE: TALCS SPIEL SLYPE SLOPE
SLOSH: TALCS SPIEL SHULN SLOSH
SLOTH: TALCS STILE SOTOL SLOTH
SLUMP: TALCS SPIEL SLURP SLUMP
SLUNG: TALCS SPIEL SHULN SLUNK SLUNG
SLUNK: TALCS SPIEL SHULN SLUNK
SLURP: TALCS SPIEL SLURP
SLUSH: TALCS SPIEL SHULN SLUSH
SLYLY: TALCS SPIEL SHULN SLYLY
SMACK: TALCS SHACK SWACK SNACK SMACK
SMALL: TALCS SHALE SPALL SMALL
SMART: TALCS STARE SPART SWART SKART SMART
SMASH: TALCS SPAER SHANK SWASH SMASH
SMEAR: TALCS SPAER SEWAR SKEAR SMEAR
SMELL: TALCS SPIEL SMELL
SMELT: TALCS STILE SMELT
SMILE: TALCS SPIEL SLIME SMILE
SMIRK: TALCS SIREN SHIRK SMIRK
SMITE: TALCS STIRE SHITE SKITE SMITE
SMITH: TALCS STIRE SHIFT SMITH
SMOCK: TALCS SONCE SMOCK
SMOKE: TALCS SIREN SPODE SHOVE SMOKE
SMOKY: TALCS SIREN SOPHY SMOKY
SMOTE: TALCS STIRE SHOTE SMOTE
SNACK: TALCS SHACK SWACK SNACK
SNAIL: TALCS SHALE SWAIL SPAIL SKAIL SNAIL
SNAKE: TALCS SPAER SHAME SOAVE SEAZE SWAGE
SNAKY: TALCS SPAER SHANK SNAKY
SNARE: TALCS SPAER SOARE SNARE
SNARL: TALCS SHALE SWAIL SNARL
SNEAK: TALCS SPAER SEDAN SNEAK
SNEER: TALCS SIREN SNEER
SNIDE: TALCS SIREN SEGNI SNIDE
SNIFF: TALCS SIREN SPINK SNIFF
SNIPE: TALCS SIREN SEGNI SNIDE SNIPE
SNOOP: TALCS SIREN SNOWY SNOOP
SNORE: TALCS SIREN SNORE
SNORT: TALCS STIRE SPORT SKORT SNORT
SNOUT: TALCS STIRE SHUNT SNOUT
SNOWY: TALCS SIREN SNOWY
SNUCK: TALCS SONCE SNUCK
SNUFF: TALCS SIREN SNOWY SNUFF
SOAPY: TALCS SPAER SWAMP SOAPY
SOBER: TALCS SIREN SKEER SOBER
SOGGY: TALCS SIREN SOPHY SODDY SOGGY
SOLAR: TALCS SELVA SOLAN SOLAH SOLAR
SOLID: TALCS SOLDE SOLID
SOLVE: TALCS SOLDE SOLVE
SONAR: TALCS SPAER SIMAR SOFAR SONAR
SONIC: TALCS SCORE SONIC
SOOTH: TALCS STIRE SHUNT SOWTH SOOTH
SOOTY: TALCS STIRE SHUNT SOFTY SOOTY
SORRY: TALCS SIREN SPROG SORBO SORRY
SOUND: TALCS SIREN SNOWY SOUND
SOUTH: TALCS STIRE SHUNT SOUTH
SOWER: TALCS SIREN SKEER SOBER SOGER SOWER
SPACE: TALCS SHACK SPACY SPACE
SPADE: TALCS SPAER SPANE SPADE
SPANK: TALCS SPAER SPAIN SPANK
SPARE: TALCS SPAER SPARE
SPARK: TALCS SPAER SPARD SPARK
SPASM: TALCS SPAER SPAIN SPAYD SPAZZ SPASM
SPAWN: TALCS SPAER SPAIN SPAWN
SPEAK: TALCS SPAER SPEAN SPEAK
SPEAR: TALCS SPAER SPEAR
SPECK: TALCS SONCE SPECK
SPEED: TALCS SIREN SKEED SPEED
SPELL: TALCS SPIEL SPELL
SPELT: TALCS STILE SMELT SPELT
SPEND: TALCS SIREN SHONE SPEND
SPENT: TALCS STIRE SPENT
SPERM: TALCS SIREN SHORE SPERM
SPICE: TALCS SONCE SPICE
SPICY: TALCS SONCE SPICY
SPIED: TALCS SIREN SKIED SPIED
SPIEL: TALCS SPIEL
SPIKE: TALCS SIREN SPIKE
SPIKY: TALCS SIREN SKIOS SPIKY
SPILL: TALCS SPIEL SPILL
SPILT: TALCS STILE SPILT
SPINE: TALCS SIREN SEGNI SWINE SHINE SPINE
SPINY: TALCS SIREN SPINK SPINY
SPIRE: TALCS SIREN SWIRE SHIRE SPIRE
SPITE: TALCS STIRE SHITE SKITE SMITE SUITE
SPLAT: TALCS SPLAT
SPLIT: TALCS ISLET SPLIT
SPOIL: TALCS SPIEL SPOIL
SPOKE: TALCS SIREN SPODE SPOKE
SPOOF: TALCS SIREN SOPHY SPOOM SPOOF
SPOOK: TALCS SIREN SOPHY SPOOM SPOOF SPOOK
SPOOL: TALCS SPIEL SPOOL
SPOON: TALCS SIREN SWOON SPOON
SPORE: TALCS SIREN SHORE SMORE SPORE
SPORT: TALCS STIRE SPORT
SPOUT: TALCS STIRE SHUNT SMOUT SPOUT
SPRAY: TALCS SPAER SPRAY
SPREE: TALCS SIREN SERED SPREE
SPRIG: TALCS SIREN SKRIK SPRIG
SPUNK: TALCS SIREN SNOWY SUNUP SPUNK
SPURN: TALCS SIREN SWORN SPURN
SPURT: TALCS STIRE SPORT SPURT
SQUAD: TALCS SPAER SUBAH SQUAD
SQUAT: TALCS STARE SUTTA SQUAT
SQUIB: TALCS SIREN SKIOS SIZED SQUIB
STACK: TALCS STACK
STAFF: TALCS STARE STANG STAPH STAFF
STAGE: TALCS STARE STANE STATE STAKE STAGE
STAID: TALCS STARE STANG STAPH STAFF STAID
STAIN: TALCS STARE STANG STAIN
STAIR: TALCS STARE STAIR
STAKE: TALCS STARE STANE STATE STAKE
STALE: TALCS SPALT STALL STALK STALE
STALK: TALCS SPALT STALL STALK
STALL: TALCS SPALT STALL
STAMP: TALCS STARE STANG STAPH STAMP
STAND: TALCS STARE STANG STANK STAND
STANK: TALCS STARE STANG STANK
STARE: TALCS STARE
STARK: TALCS STARE STARK
START: TALCS STARE STARK START
STASH: TALCS STARE STANG STAPH STASH
STATE: TALCS STARE STANE STATE
STAVE: TALCS STARE STANE STATE STAKE STAGE
STEAD: TALCS STARE STEAD
STEAK: TALCS STARE STEAD STEAN STEAM STEAK
STEAL: TALCS SPALT SETAL STEAL
STEAM: TALCS STARE STEAD STEAN STEAM
STEED: TALCS STIRE STEND STEED
STEEL: TALCS STILE STEEL
STEEP: TALCS STIRE STEND STEEP
STEER: TALCS STIRE STREP STEER
STEIN: TALCS STIRE STEIN
STERN: TALCS STIRE STERN
STICK: TALCS SOUCT STICK
STIFF: TALCS STIRE STINK STIMY STIFF
STILL: TALCS STILE STILL
STILT: TALCS STILE STILL STILT
STING: TALCS STIRE STINK STINT STING
STINK: TALCS STIRE STINK
STINT: TALCS STIRE STINK STINT
STOCK: TALCS SOUCT STOCK
STOIC: TALCS COSET STOIC
STOKE: TALCS STIRE STOPE STONE STOVE STOKE
STOLE: TALCS STILE STOLE
STOMP: TALCS STIRE STUNT STOOP STOWP STOMP
STONE: TALCS STIRE STOPE STONE
STONY: TALCS STIRE STUNT STONY
STOOD: TALCS STIRE STUNT STOOP STOOD
STOOL: TALCS STILE STOOL
STOOP: TALCS STIRE STUNT STOOP
STORE: TALCS STIRE STYRE STORE
STORK: TALCS STIRE STORY STORM STORK
STORM: TALCS STIRE STORY STORM
STORY: TALCS STIRE STORY
STOUT: TALCS STIRE STUNT STOUT
STOVE: TALCS STIRE STOPE STONE STOVE
STRAP: TALCS STARE STRAY STRAG STRAW STRAP
STRAW: TALCS STARE STRAY STRAG STRAW
STRAY: TALCS STARE STRAY
STRIP: TALCS STIRE STRIP
STRUT: TALCS STIRE STROP STRUT
STUCK: TALCS SOUCT STUCK
STUDY: TALCS STIRE STUNT STUMP STUDY
STUFF: TALCS STIRE STUNT STUMP STUDY STUFF
STUMP: TALCS STIRE STUNT STUMP
STUNG: TALCS STIRE STUNT STUNG
STUNK: TALCS STIRE STUNT STUNG STUNK
STUNT: TALCS STIRE STUNT
STYLE: TALCS STILE STOLE STELE STYLE
SUAVE: TALCS SPAER SHAME SOAVE SUAVE
SUGAR: TALCS SPAER SIMAR SOFAR SUGAR
SUING: TALCS SIREN SPINK SWING SUING
SUITE: TALCS STIRE SHITE SKITE SMITE SUITE
SULKY: TALCS SOLDE SULLY SULKY
SULLY: TALCS SOLDE SULLY
SUMAC: TALCS SCARP SUMAC
SUNNY: TALCS SIREN SNOWY SUNNY
SUPER: TALCS SIREN SKEER SOBER SHYER SUPER
SURER: TALCS SIREN SERED SORER SURER
SURGE: TALCS SIREN SURGE
SURLY: TALCS SPIEL SHULN SURLY
SUSHI: TALCS SIREN SKIOS SUSHI
SWAMI: TALCS SPAER SHANK SWAMI
SWAMP: TALCS SPAER SWAMP
SWARM: TALCS SPAER SNARK SWARM
SWASH: TALCS SPAER SHANK SWASH
SWATH: TALCS STARE SWATH
SWEAR: TALCS SPAER SEWAR SWEAR
SWEAT: TALCS STARE SWEAT
SWEEP: TALCS SIREN SKEED SHEEP SWEEP
SWEET: TALCS STIRE SPENT SHEET SWEET
SWELL: TALCS SPIEL SMELL SWELL
SWEPT: TALCS STIRE SPENT SWEPT
SWIFT: TALCS STIRE SHIFT SWIFT
SWILL: TALCS SPIEL SKIRL SHILL SWILL
SWINE: TALCS SIREN SEGNI SWINE
SWING: TALCS SIREN SPINK SWING
SWIRL: TALCS SPIEL SKIRL SWIRL
SWISH: TALCS SIREN SKIOS SWISH
SWOON: TALCS SIREN SWOON
SWOOP: TALCS SIREN SOPHY SPOOM SWOOP
SWORD: TALCS SIREN SMOOR SPORK SWORD
SWORE: TALCS SIREN SHORE SMORE SPORE SWORE
SWORN: TALCS SIREN SWORN
SWUNG: TALCS SIREN SNOWY SWUNG
SYNOD: TALCS SIREN SNOWY SYNOD
SYRUP: TALCS SIREN SPROG SYRUP
TABBY: TALCS TATER TANKA TABID TABBY
TABLE: TALCS TABLA TABLE
TABOO: TALCS TATER TANKA TABID TABBY TABOO
TACIT: TALCS TACET TACIT
TACKY: TALCS TACET TACKY
TAFFY: TALCS TATER TANKA TABID TAGMA TAFFY
TAINT: TALCS TATER TANTI TAINT
TAKEN: TALCS TATER TAPEN TAKEN
TAKER: TALCS TATER TAPER TAVER TAWER TAXER
TALLY: TALCS TALAK TALLY
TALON: TALCS TALAK TALLY TALON
TAMER: TALCS TATER TAPER TAVER TAWER TAXER
TANGO: TALCS TATER TANKA TANGO
TANGY: TALCS TATER TANKA TANGO TANGY
TAPER: TALCS TATER TAPER
TAPIR: TALCS TATER TAXOR TAPIR
TARDY: TALCS TATER TAYRA TARDY
TAROT: TALCS TATER TAROT
TASTE: TALCS TASER TASSE TASTE
TASTY: TALCS TASER TASSA TASTY
TATTY: TALCS TATER TATOU TATTY
TAUNT: TALCS TATER TANTI TAUNT
TAWNY: TALCS TATER TANKA TAUON TAWNY
TEACH: TALCS TEACH
TEARY: TALCS TRAIN THARM TEARY
TEASE: TALCS TESTA TEASE
TEDDY: TALCS TRINE TOPED TEDDY
TEETH: TALCS TRINE TOPED THEFT TEETH
TEMPO: TALCS TRINE TOPED TEMPO
TENET: TALCS TRINE TONEY TENET
TENOR: TALCS TRINE TENOR
TENSE: TALCS TORSE TENSE
TENTH: TALCS TRINE TONEY TENDU TENTH
TEPEE: TALCS TRINE TUTEE TEPEE
TEPID: TALCS TRINE TEMPI TEPID
TERRA: TALCS TRAIN TERGA TERRA
TERSE: TALCS TORSE TERSE
TESTY: TALCS TORSE TSKED TESTY
THANK: TALCS TRAIN THANG THANK
THEFT: TALCS TRINE TOPED THEFT
THEIR: TALCS TRINE TITER THEIR
THEME: TALCS TRINE TUTEE THEBE THEME
THERE: TALCS TRINE THERE
THESE: TALCS TORSE TENSE THESE
THETA: TALCS TRAIN TWEAK THEMA THETA
THICK: TALCS TRICE THICK
THIEF: TALCS TRINE THIEF
THIGH: TALCS TRINE THIGH
THING: TALCS TRINE TYING TOING THING
THINK: TALCS TRINE TYING THINK
THIRD: TALCS TRINE THIRD
THONG: TALCS TRINE TOWNY THONG
THORN: TALCS TRINE THORN
THOSE: TALCS TORSE THOSE
THREE: TALCS TRINE THERE THREE
THREW: TALCS TRINE TWYER THREW
THROB: TALCS TRINE THROW THROB
THROW: TALCS TRINE THROW
THRUM: TALCS TRINE THROW THRUM
THUMB: TALCS TRINE TUMPY THUMB
THUMP: TALCS TRINE TUMPY THUMP
THYME: TALCS TRINE TUTEE THYME
TIARA: TALCS TRAIN TIARA
TIBIA: TALCS TRAIN TOMIA TIBIA
TIDAL: TALCS TIDAL
TIGER: TALCS TRINE TITER TIMER TIGER
TIGHT: TALCS TRINE TITUP TIGHT
TILDE: TALCS TILER TILDE
TIMER: TALCS TRINE TITER TIMER
TIMID: TALCS TRINE TITUP TIMID
TIPSY: TALCS TORSE TUISM TIPSY
TITAN: TALCS TRAIN TITAN
TITHE: TALCS TRINE TOZIE TITHE
TITLE: TALCS TRIOL TITLE
TOAST: TALCS TESTA TOAST
TODAY: TALCS TRAIN TWEAK TODAY
TODDY: TALCS TRINE TUMPY TUFTY TOWZY TODDY
TOKEN: TALCS TRINE TONEY TOKEN
TONAL: TALCS TIDAL TYPAL TONAL
TONGA: TALCS TRAIN TONKA TONGA
TONIC: TALCS TONIC
TOOTH: TALCS TRINE TUMPY THOFT TOOTH
TOPAZ: TALCS TRAIN TWEAK TODAY TOPAZ
TOPIC: TALCS TONIC TOXIC TORIC TOPIC
TORCH: TALCS TRICE TORCH
TORSO: TALCS TORSE TORSI TORSO
TORUS: TALCS TORES TORRS TORUS
TOTAL: TALCS TIDAL TYPAL TONAL TOTAL
TOTEM: TALCS TRINE TOPED TOTEM
TOUCH: TALCS TRICE TOUCH
TOUGH: TALCS TRINE TUMPY TOUGH
TOWEL: TALCS TRIOL THOWL TOWEL
TOWER: TALCS TRINE TWYER TOWER
TOXIC: TALCS TONIC TOXIC
TOXIN: TALCS TRINE TIGON TOXIN
TRACE: TALCS TEACH TRACE
TRACK: TALCS TEACH TRACT TRACK
TRACT: TALCS TEACH TRACT
TRADE: TALCS TRAIN TRAPE TRAVE TRADE
TRAIL: TALCS TIDAL TRAIL
TRAIN: TALCS TRAIN
TRAIT: TALCS TRAIN TRAIK TRAIT
TRAMP: TALCS TRAIN TRAPE TRAMP
TRASH: TALCS TESTA TSADI TRASH
TRAWL: TALCS TIDAL TRAWL
TREAD: TALCS TRAIN TREAD
TREAT: TALCS TRAIN TREAD TREAT
TREND: TALCS TRINE TREND
TRIAD: TALCS TRAIN TRIAD
TRIAL: TALCS TIDAL TRIAL
TRIBE: TALCS TRINE TRITE TRIPE TRIKE TRIBE
TRICE: TALCS TRICE
TRICK: TALCS TRICE TRICK
TRIED: TALCS TRINE TRIER TRIED
TRIPE: TALCS TRINE TRITE TRIPE
TRITE: TALCS TRINE TRITE
TROLL: TALCS TRIOL TROLL
TROOP: TALCS TRINE TROOP
TROPE: TALCS TRINE TROKE TROVE TROPE
TROUT: TALCS TRINE TROOP TROTH TROUT
TROVE: TALCS TRINE TROKE TROVE
TRUCE: TALCS TRICE TRUCE
TRUCK: TALCS TRICE TRUCK
TRUER: TALCS TRINE TRUED TRUER
TRULY: TALCS TRIOL TRULY
TRUMP: TALCS TRINE TROOP TRUMP
TRUNK: TALCS TRINE TRONK TRUNK
TRUSS: TALCS TORES TRIGS TRUSS
TRUST: TALCS TORSE TRUST
TRUTH: TALCS TRINE TROOP TRUTH
TRYST: TALCS TORSE TRUST TRIST TRYST
TUBAL: TALCS TIDAL TYPAL TONAL TUBAL
TUBER: TALCS TRINE TWYER TOTER TUBER
TULIP: TALCS TILER TULIP
TULLE: TALCS TILER TULLE
TUMOR: TALCS TRINE THROW TUTOR TUMOR
TUNIC: TALCS TONIC TUNIC
TURBO: TALCS TRINE THROW TURBO
TUTOR: TALCS TRINE THROW TUTOR
TWANG: TALCS TRAIN THANG TWANG
TWEAK: TALCS TRAIN TWEAK
TWEED: TALCS TRINE TOPED TWEED
TWEET: TALCS TRINE TOPED TWEET
TWICE: TALCS TRICE TWICE
TWINE: TALCS TRINE THINE TWINE
TWIRL: TALCS TRIOL THIRL TWIRL
TWIST: TALCS TORSE TUISM TWIST
TWIXT: TALCS TRINE THIGH TWIXT
TYING: TALCS TRINE TYING
UDDER: TALCS RONDE DRIER EDGER UDDER
ULCER: TALCS CLINE ULCER
ULTRA: TALCS PLEAT ULTRA
UMBRA: TALCS ARENA MOIRA UMBRA
UNCLE: TALCS CLINE UNCLE
UNCUT: TALCS CRUET INCUT UNCUT
UNDER: TALCS RONDE UNDER
UNDID: TALCS RONDE UNDUG UNDID
UNDUE: TALCS RONDE UNDEE UNDUE
UNFED: TALCS RONDE INDEW KNEED UNBED UNFED
UNFIT: TALCS ROTTE NITID UNWIT UNFIT
UNIFY: TALCS RONDE NYMPH UNIFY
UNION: TALCS RONDE GIPON INION ONION UNION
UNITE: TALCS ROTTE UNITE
UNITY: TALCS ROTTE MINTY UNITY
UNLIT: TALCS FILET UPLIT UNLIT
UNMET: TALCS ROTTE MEINT UNMET
UNSET: TALCS STIRE PESTO UNSET
UNTIE: TALCS ROTTE HYTHE UNTIE
UNTIL: TALCS LOTTE UNTIL
UNWED: TALCS RONDE INDEW UNWED
UNZIP: TALCS RONDE NYMPH UNZIP
UPPER: TALCS RONDE FERER VIPER UPPER
UPSET: TALCS STIRE PESTO UPSET
URBAN: TALCS ARENA BRAWN URBAN
URINE: TALCS RONDE URINE
USAGE: TALCS SPAER MEASE USAGE
USHER: TALCS SIREN HOSER USHER
USING: TALCS SIREN NKOSI USING
USUAL: TALCS SHALE LYSSA USUAL
USURP: TALCS SIREN HORSY USURP
UTILE: TALCS LOTTE UTILE
UTTER: TALCS ROTTE UTTER
VAGUE: TALCS RAMEN BADGE GAUJE VAGUE
VALET: TALCS WALTY VALET
VALID: TALCS PALEA BALDY VALID
VALOR: TALCS PALEA BALDY VALOR
VALUE: TALCS PALEA VALVE VALUE
VALVE: TALCS PALEA VALVE
VAPID: TALCS RAMEN KADAI PAVID VAPID
VAPOR: TALCS RAMEN BARKY PAGRI VAPOR
VAULT: TALCS LATHE GAULT VAULT
VAUNT: TALCS RAITA DATUM JAUNT NAUNT GAUNT
VEGAN: TALCS ARENA VEGAN
VENOM: TALCS RONDE ENNOG VENOM
VENUE: TALCS RONDE GENIE PENNE VENUE
VERGE: TALCS RONDE GERBE MERGE VERGE
VERSE: TALCS SIREN HEROS PERMS VERSE
VERSO: TALCS SIREN HEROS VERSO
VERVE: TALCS RONDE GERBE VERVE
VICAR: TALCS CRENA ACARI VICAR
VIDEO: TALCS RONDE GEOID VIDEO
VIGIL: TALCS LOUED GIRLY VIGIL
VIGOR: TALCS RONDE GROOM VIGOR
VILLA: TALCS POLAR BULLA ZILLA VILLA
VINYL: TALCS LOUED GIRLY VINYL
VIOLA: TALCS ALANE MORAL IDOLA VIOLA
VIPER: TALCS RONDE FERER VIPER
VIRAL: TALCS ALANE MORAL FURAL GYRAL VIRAL
VIRUS: TALCS DORES KIRNS MIRVS VIRUS
VISIT: TALCS STIRE MIDST WISHT VISIT
VISOR: TALCS SIREN RISHI VISOR
VISTA: TALCS STARE AGIST VISTA
VITAL: TALCS PLEAT ROTAL VITAL
VIVID: TALCS RONDE DIPPY VIVID
VIXEN: TALCS RONDE HEMIN GIVEN VIXEN
VOCAL: TALCS CLEAR FOCAL LOCAL VOCAL
VODKA: TALCS ARENA PODIA HODJA VODKA
VOGUE: TALCS RONDE BOGIE POGGE YOGEE VOGUE
VOICE: TALCS CHICO YOICK VOICE
VOILA: TALCS ALANE MORAL BOXLA VOILA
VOMIT: TALCS ROTTE POINT VOMIT
VOTER: TALCS ROTTE DOTER VOTER
VOUCH: TALCS CHICO POUCH GOUCH MOUCH VOUCH
VOWEL: TALCS LOUED VOWEL
VYING: TALCS RONDE NYMPH VYING
WACKY: TALCS CARED MACHO WACKY
WAFER: TALCS RAMEN PARED GAYER FAKER WAFER
WAGER: TALCS RAMEN PARED GAYER WAGER
WAGON: TALCS RAMEN PAGAN WAGON
WAIST: TALCS SAITH MAIST WAIST
WAIVE: TALCS RAMEN BADGE FAUVE WAIVE
WALTZ: TALCS WALTY WALTZ
WARTY: TALCS RAITA PARTY WARTY
WASTE: TALCS SAITH PASTY BASTA WASTE
WATCH: TALCS NATCH WATCH
WATER: TALCS RAITA GATOR WATER
WAVER: TALCS RAMEN PARED GAYER FAKER HAVER
WAXEN: TALCS RAMEN WAKEN WAXEN
WEARY: TALCS ARENA REBAR DEARY WEARY
WEAVE: TALCS ARENA BEADY HEAVE WEAVE
WEDGE: TALCS RONDE KIDGE BUDGE HEDGE WEDGE
WEEDY: TALCS RONDE WEEDY
WEIGH: TALCS RONDE BEGEM WEIGH
WEIRD: TALCS RONDE DRIER WEIRD
WELCH: TALCS MILCH BELCH WELCH
WELSH: TALCS SOLDE WELSH
WENCH: TALCS CHICO HENCE DENCH BENCH KENCH
WHACK: TALCS REACH CHACK WHACK
WHALE: TALCS ALANE LEAVE DWALE WHALE
WHARF: TALCS ARENA DIRAM HOARY WHARF
WHEAT: TALCS IRATE BEPAT WHEAT
WHEEL: TALCS LOUED REPEL WHEEL
WHELP: TALCS LOUED GERLE KVELL WHELP
WHERE: TALCS RONDE GERBE FRERE WHERE
WHICH: TALCS CHICO WHICH
WHIFF: TALCS RONDE PIGMY WHIFF
WHILE: TALCS LOUED GERLE ANILE WHILE
WHINE: TALCS RONDE NEIVE WHINE
WHINY: TALCS RONDE NYMPH WHINY
WHIRL: TALCS LOUED GIRLY WHIRL
WHISK: TALCS SIREN WHISK
WHITE: TALCS ROTTE UNITE EVITE WHITE
WHOLE: TALCS LOUED GLOBE PROLE WHOLE
WHOOP: TALCS RONDE HIMBO WHOOF WHOOP
WHOSE: TALCS SIREN SOUSE OBESE WHOSE
WIDEN: TALCS RONDE INDEW WIDEN
WIDER: TALCS RONDE DRIER EIDER WIDER
WIDOW: TALCS RONDE DUOMO WIDOW
WIDTH: TALCS ROTTE MINTY FIFTH WIDTH
WIELD: TALCS LOUED FIELD BIELD WIELD
WIGHT: TALCS ROTTE NITID WIFTY WIGHT
WILLY: TALCS POLEY GILLY DILLY BILLY FILLY
WIMPY: TALCS RONDE PIGMY WIMPY
WINCE: TALCS CHICO MINCY WINCE
WINCH: TALCS CHICO PINCH WINCH
WINDY: TALCS RONDE BUNDY WINDY
WISER: TALCS SIREN RIMES WISER
WISPY: TALCS SIREN PISOS WISPY
WITCH: TALCS EDICT GITCH BITCH MITCH WITCH
WITTY: TALCS ROTTE NUTTY DITTY BITTY KITTY
WOKEN: TALCS RONDE HOVEN WOMEN WOKEN
WOMAN: TALCS ARENA HOGAN POWAN WOMAN
WOMEN: TALCS RONDE HOVEN WOMEN
WOODY: TALCS RONDE DOWDY WOODY
WOOER: TALCS RONDE MOWER WOOER
WOOLY: TALCS LOUED MOOLI GOOLY HOOLY WOOLY
WOOZY: TALCS RONDE GOMBO WOOPY WOOFY WOOZY
WORDY: TALCS RONDE WORDY
WORLD: TALCS LOUED WOOLD WORLD
WORRY: TALCS RONDE MOORY WORRY
WORSE: TALCS SIREN HEROS GORSE MORSE WORSE
WORST: TALCS STIRE WORST
WORTH: TALCS ROTTE BORTY FORTH WORTH
WOULD: TALCS LOUED NOULD MOULD WOULD
WOUND: TALCS RONDE WOUND
WOVEN: TALCS RONDE HOVEN WOVEN
WRACK: TALCS REACH DRACO CRACK BRACK FRACK
WRATH: TALCS IRATE PRATT WRATH
WREAK: TALCS ARENA BREAD WREAK
WRECK: TALCS CHICO PERCE DRECK WRECK
WREST: TALCS STIRE PERST WREST
WRING: TALCS RONDE BRUIN IRING WRING
WRIST: TALCS STIRE WRIST
WRITE: TALCS ROTTE WRITE
WRONG: TALCS RONDE PRION WRONG
WROTE: TALCS ROTTE WROTE
WRUNG: TALCS RONDE BRUIN WRUNG
WRYLY: TALCS LOUED GIRLY WRYLY
YACHT: TALCS CARTE YACHT
YEARN: TALCS ARENA DEARN YEARN
YEAST: TALCS STARE BEAST HEAST YEAST
YIELD: TALCS LOUED FIELD BIELD WIELD YIELD
YOUNG: TALCS RONDE MOONY YOUNG
YOUTH: TALCS ROTTE BOOTY YOUTH
ZEBRA: TALCS ARENA DERMA HEJRA ZEBRA
ZESTY: TALCS STIRE PESTO YESTY FESTY ZESTY
ZONAL: TALCS ALANE LINGA ZONAL
Success: 2252
Fail: 63
Avg guess: 4.070
