ABACK: CANST ARECA ABACI ABACK
ABASE: CANST SMASH LEASE URASE ABASE
ABATE: CANST REATA AMATE ABATE
ABBEY: CANST AREAL AZIDE ABBEY
ABBOT: CANST ALERT ADBOT ABBOT
ABHOR: CANST AREAL AMOUR ABHOR
ABIDE: CANST AREAL AZIDE ABIDE
ABLED: CANST AREAL AGILE ABLED
ABODE: CANST AREAL AZIDE ABODE
ABORT: CANST ALERT APORT AMORT ABORT
ABOUT: CANST ALERT ADBOT ABOUT
ABOVE: CANST AREAL AZIDE ABOVE
ABUSE: CANST SMASH AROSE ABUSE
ABYSS: CANST SMASH FOSSA ABYSS
ACORN: CANST PUCAN ACORN
ACRID: CANST ARECA AURIC ACRID
ACTOR: CANST TRACE ACTOR
ACUTE: CANST TRACE ACUTE
ADAGE: CANST AREAL AGAZE APAGE ADAGE
ADAPT: CANST ALERT ADBOT ADMIT ADAPT
ADEPT: CANST ALERT ADEPT
ADMIN: CANST ARGAN AXION ADMIN
ADMIT: CANST ALERT ADBOT ADMIT
ADOBE: CANST AREAL AZIDE ADOBE
ADOPT: CANST ALERT ADBOT ADOPT
ADORE: CANST AREAL AIRED ADORE
ADORN: CANST ARGAN APRON ADORN
ADULT: CANST ALERT ADULT
AFFIX: CANST AREAL AUDIO AFFIX
AFIRE: CANST AREAL AIRED AFIRE
AFOOT: CANST ALERT ADBOT AFOOT
AFOUL: CANST AREAL AFOUL
AFTER: CANST REATA ARTEL APTER AFTER
AGAIN: CANST ARGAN AGAIN
AGAPE: CANST AREAL AGAZE AGAPE
AGATE: CANST REATA AMATE ABATE AGATE
AGENT: CANST RIANT AMENT AHENT AGENT
AGILE: CANST AREAL AGILE
AGING: CANST ARGAN AGONE AGING
AGLOW: CANST AREAL ALOUD AGLOO AGLOW
AGONY: CANST ARGAN AGONE AGONY
AGORA: CANST AREAL AGORA
AGREE: CANST AREAL AIRED AGREE
AHEAD: CANST AREAL AHEAP AHEAD
AIDER: CANST AREAL AIRED AIDER
AISLE: CANST REALS AISLE
ALARM: CANST AREAL ALARM
ALBUM: CANST AREAL ALOUD ALMUG ALBUM
ALERT: CANST ALERT
ALGAE: CANST AREAL ALGAE
ALIBI: CANST AREAL ALOUD ALIBI
ALIEN: CANST ARGAN AXION ALIEN
ALIGN: CANST ARGAN ALIGN
ALIKE: CANST AREAL AGILE ALIKE
ALIVE: CANST AREAL AGILE ALIKE ALIVE
ALLAY: CANST AREAL ALWAY ALLAY
ALLEY: CANST AREAL AGILE ABLED ALLEY
ALLOT: CANST ALERT ALOFT ALLOT
ALLOW: CANST AREAL ALOUD ALLOY ALLOW
ALLOY: CANST AREAL ALOUD ALLOY
ALOFT: CANST ALERT ALOFT
ALONE: CANST ARGAN ANILE ALONE
ALONG: CANST ARGAN AGONE ALONG
ALOOF: CANST AREAL ALOUD ALOOF
ALOUD: CANST AREAL ALOUD
ALPHA: CANST AREAL ALPHA
ALTAR: CANST REATA ARTAL ALTAR
ALTER: CANST REATA ARTEL ALTER
AMASS: CANST SMASH AMASS
AMAZE: CANST AREAL AGAZE AMAZE
AMBER: CANST AREAL AIRED AGGER AMBER
AMBLE: CANST AREAL AGILE AMOLE AMBLE
AMEND: CANST ARGAN ANILE AMEND
AMISS: CANST SMASH AMISS
AMITY: CANST REATA AGUTI AMITY
AMONG: CANST ARGAN AGONE ALONG AMONG
AMPLE: CANST AREAL AGILE AMOLE AMBLE AMPLE
AMPLY: CANST AREAL ALOUD AMPLY
AMUSE: CANST SMASH AMUSE
ANGEL: CANST ARGAN ANGEL
ANGER: CANST ARGAN ANGRY ANGER
ANGLE: CANST ARGAN ANGEL ANGLE
ANGRY: CANST ARGAN ANGRY
ANGST: CANST ANGST
ANIME: CANST ARGAN ANILE ANIME
ANKLE: CANST ARGAN ANILE ANOLE ANKLE
ANNEX: CANST GENAL PANNE ANNEX
ANNOY: CANST GENAL DINNA ANNOY
ANNUL: CANST GENAL ANNUL
ANODE: CANST ARGAN ANILE ANODE
ANTIC: CANST ACTIN ANTIC
ANVIL: CANST ARGAN ANILE ANVIL
AORTA: CANST REATA AORTA
APART: CANST ALERT APORT APART
APHID: CANST AREAL AUDIO ADMIX APHID
APING: CANST ARGAN AGONE AXING AWING AKING
APNEA: CANST GENAL PANNE APNEA
APPLE: CANST AREAL AGILE AMOLE APPLE
APPLY: CANST AREAL ALOUD AMPLY APPLY
APRON: CANST ARGAN APRON
APTLY: CANST REATA DOTAL APTLY
ARBOR: CANST AREAL ARDOR ARBOR
ARDOR: CANST AREAL ARDOR
ARENA: CANST ARGAN ARENA
ARGUE: CANST AREAL ARMED ARGUE
ARISE: CANST SMASH AROSE ARISE
ARMOR: CANST AREAL ARDOR ARBOR ARMOR
AROMA: CANST AREAL AROMA
AROSE: CANST SMASH AROSE
ARRAY: CANST AREAL ARRAH ARRAY
ARROW: CANST AREAL ARDOR ARROW
ARSON: CANST SLANE ANOAS ARSON
ARTSY: CANST TRASH ARTSY
ASCOT: CANST SCRAT ASCOT
ASHEN: CANST SLANE ASPEN ASHEN
ASIDE: CANST REALS ASKED ASIDE
ASKEW: CANST REALS ASKED ASKEW
ASSAY: CANST REALS SIMAS ASSAY
ASSET: CANST SPRAT ASSOT ASSET
ATOLL: CANST REATA DOTAL ATOLL
ATONE: CANST TRAIN ANTAE ATONE
ATTIC: CANST TRACE OCTAD ATTIC
AUDIO: CANST AREAL AUDIO
AUDIT: CANST ALERT ADBOT AUDIT
AUGUR: CANST AREAL AMOUR AUGUR
AUNTY: CANST MENTA AUNTY
AVAIL: CANST AREAL AVAIL
AVERT: CANST ALERT APERT AVERT
AVIAN: CANST ARGAN ADMAN AVIAN
AVOID: CANST AREAL AUDIO AXOID AVOID
AWAIT: CANST ALERT ADBOT AUGHT AWAIT
AWAKE: CANST AREAL AGAZE AWAKE
AWARD: CANST AREAL AGORA AWARD
AWARE: CANST AREAL AWARE
AWASH: CANST SMASH BLASH AWASH
AWFUL: CANST AREAL AFOUL AWFUL
AWOKE: CANST AREAL AZIDE ABOVE AWOKE
AXIAL: CANST AREAL ALGAL APPAL AXIAL
AXIOM: CANST AREAL AUDIO AXIOM
AXION: CANST ARGAN AXION
AZURE: CANST AREAL AIRED AFORE AZURE
BACON: CANST RACON MACON BACON
BADGE: CANST MARLE BADGE
BADLY: CANST MARLE DALLY BADLY
BAGEL: CANST MARLE GALED BAGEL
BAGGY: CANST MARLE KADAI GABBY BAGGY
BAKER: CANST MARLE GAPER WAKER DAKER RAKER
BALER: CANST MARLE WALER BALER
BALMY: CANST MARLE BALMY
BANAL: CANST KANAE FANAL BANAL
BANJO: CANST KANAE GANDY MANOR BANJO
BARGE: CANST MARLE GARBE BARGE
BARON: CANST RAVEN MARON BARON
BASAL: CANST EARLS VASAL BASAL
BASIC: CANST SAICK BASIC
BASIL: CANST EARLS VASAL BASIL
BASIN: CANST NARIS BASIN
BASIS: CANST EARLS MAIKS SADIS OASIS BASIS
BASTE: CANST TATES HASTE WASTE PASTE BASTE
BATCH: CANST TACHO HATCH LATCH BATCH
BATHE: CANST TALER VAWTE BATHE
BATON: CANST OATEN BATON
BATTY: CANST TALER MATAI BATTY
BAWDY: CANST MARLE KADAI GAUDY BAWDY
BAYOU: CANST MARLE KADAI GABBY BAYOU
BEACH: CANST ARECA PLACE BEACH
BEADY: CANST AREAL HEADY BEADY
BEARD: CANST AREAL DEARY HEARD BEARD
BEAST: CANST LEAST BEAST
BEECH: CANST LOCIE DRECK BEECH
BEEFY: CANST DROLE BEGEM BEEFY
BEFIT: CANST RELIT PETIT DEBIT BEFIT
BEGAN: CANST ARGAN LIGAN BEGAN
BEGAT: CANST ALERT BEGAT
BEGET: CANST RELIT DEPOT BEGET
BEGIN: CANST IRONE LEVIN HEMIN BEGIN
BEGUN: CANST IRONE LEBEN BEGUN
BEING: CANST IRONE MEINY BEING
BELCH: CANST LOCIE FELCH WELCH BELCH
BELIE: CANST DROLE GLIME BELIE
BELLE: CANST DROLE UMBLE BELLE
BELLY: CANST DROLE KVELL BELLY
BELOW: CANST DROLE HOLEY BELOW
BENCH: CANST OUNCE WENCH KENCH BENCH
BERET: CANST RELIT BERET
BERRY: CANST DROLE REFER PERRY BERRY
BERTH: CANST TORTE BERTH
BESET: CANST SPRIT BESOT BESET
BETEL: CANST TORTE DEBIT BETEL
BEVEL: CANST DROLE GEMEL BEVEL
BEZEL: CANST DROLE GEMEL BEVEL BEZEL
BIBLE: CANST DROLE UMBLE BIBLE
BICEP: CANST LOCIE DICER BICEP
BIDDY: CANST DROLE FUDGY WIDDY BIDDY
BIGOT: CANST RELIT PITOT JIGOT BIGOT
BILGE: CANST DROLE GLIME LIEGE BILGE
BILLY: CANST DROLE HILLY FILLY BILLY
BINGE: CANST DINGE WINGE MINGE GINGE HINGE
BINGO: CANST DINGE LINGY JINGO BINGO
BIOME: CANST DROLE POOVE EXOME BIOME
BIRCH: CANST LOCIE WRICK BIRCH
BIRTH: CANST TORTE YIRTH FIRTH GIRTH BIRTH
BISON: CANST REINS VISON BISON
BITTY: CANST TORTE BUTTY BITTY
BLACK: CANST ARECA LOACH PLACK FLACK BLACK
BLADE: CANST AREAL MEALY GLADE BLADE
BLAME: CANST AREAL MEALY FLAME BLAME
BLAND: CANST ARGAN LIANE BLAND
BLANK: CANST ARGAN LIANE BLAND BLANK
BLARE: CANST AREAL GLARE FLARE BLARE
BLAST: CANST LEAST BLAST
BLAZE: CANST AREAL MEALY GLADE BLAZE
BLEAK: CANST AREAL FLEAM BLEAK
BLEAT: CANST ALERT BLEAT
BLEED: CANST DROLE BILED BLUED BLEED
BLEEP: CANST DROLE GEMEL BLEEP
BLEND: CANST IRONE EBONY BLEND
BLESS: CANST SOUSE DRESS BLESS
BLIMP: CANST DROLE FILMY BLIMP
BLIND: CANST IRONE LYING PLINK BLIND
BLINK: CANST IRONE LYING PLINK BLINK
BLISS: CANST SOUSE BRISS BLISS
BLITZ: CANST TORTE MILTY BLITZ
BLOAT: CANST ALERT PLAIT GLOAT FLOAT BLOAT
BLOCK: CANST LOCIE FLOCK BLOCK
BLOKE: CANST DROLE GLOBE BLOKE
BLOND: CANST IRONE PLONG BLOND
BLOOD: CANST DROLE FLOOD BLOOD
BLOOM: CANST DROLE BLOOP BLOOM
BLOWN: CANST IRONE BLOWN
BLUER: CANST DROLE LIVER PULER GLUER BLUER
BLUFF: CANST DROLE FILMY PLUFF BLUFF
BLUNT: CANST INEPT BURNT BLUNT
BLURB: CANST DROLE LURRY BLURB
BLURT: CANST RELIT BLURT
BLUSH: CANST SOUSE BRUSH BLUSH
BOARD: CANST AREAL MOIRA HOARD BOARD
BOAST: CANST LEAST ROAST BOAST
BOBBY: CANST DROLE GOMBO BOBBY
BONEY: CANST DINGE HONER BONEY
BONGO: CANST DINGE MONGO PONGO BONGO
BONUS: CANST SINED BONGS BONUS
BOOBY: CANST DROLE GOOPY BOOKY BOOMY BOOBY
BOOST: CANST REIST GHOST YTOST BOOST
BOOTH: CANST TORTE FOOTY BOOTH
BOOTY: CANST TORTE FOOTY ZOOTY BOOTY
BOOZE: CANST DROLE POOVE BOOZE
BOOZY: CANST DROLE GOOPY BOOKY BOOMY BOOBY
BORAX: CANST AREAL DIRAM HYRAX BORAX
BORNE: CANST IRONE MORNE BORNE
BOSOM: CANST LORES SOPHY BOSOM
BOSSY: CANST SOUSE LOSSY BOSSY
BOTCH: CANST TRICE KUTCH GOTCH BOTCH
BOUGH: CANST DROLE GOMBO BOGGY BOUGH
BOULE: CANST DROLE BOGLE BOULE
BOUND: CANST IRONE POWNY FOHNS BOUND
BOWEL: CANST DROLE HOLEY VOXEL BOWEL
BOXER: CANST DROLE PORER VOMER FOYER WOKER
BRACE: CANST ARECA BRACE
BRAID: CANST AREAL GRAIP BRAID
BRAIN: CANST ARGAN DRAIN BRAIN
BRAKE: CANST AREAL GRADE BRAME BRAZE BRAKE
BRAND: CANST ARGAN DRANK BRAND
BRASH: CANST SMASH BLASH BRASH
BRASS: CANST SMASH GRASS FRASS BRASS
BRAVE: CANST AREAL GRADE BRAME BRAZE BRAKE
BRAVO: CANST AREAL GRAIP BRAKY BRAVO
BRAWL: CANST AREAL DRAIL BRAWL
BRAWN: CANST ARGAN DRAIN PRAWN BRAWN
BREAD: CANST AREAL BREAD
BREAK: CANST AREAL BREAD BREAK
BREED: CANST DROLE PRIED GREED FREED BREED
BRIAR: CANST AREAL BRIAR
BRIBE: CANST DROLE GRIME FRIZE BRIBE
BRICK: CANST LOCIE WRICK BRICK
BRIDE: CANST DROLE PRIDE GRIDE BRIDE
BRIEF: CANST DROLE PREIF GRIEF BRIEF
BRINE: CANST IRONE URINE BRINE
BRING: CANST IRONE BRING
BRINK: CANST IRONE BRING BRINK
BRINY: CANST IRONE BRING BRINK BRINY
BRISK: CANST SOUSE GIRSH BRISK
BROAD: CANST AREAL BRIAR BROAD
BROIL: CANST DROLE PROWL BROIL
BROKE: CANST DROLE PROKE BROKE
BROOD: CANST DROLE PROUD BROOD
BROOK: CANST DROLE GROOF BROOM BROOK
BROOM: CANST DROLE GROOF BROOM
BROTH: CANST TORTE BROTH
BROWN: CANST IRONE FROWN BROWN
BRUNT: CANST INEPT BURNT BRUNT
BRUSH: CANST SOUSE BRUSH
BRUTE: CANST TORTE WRITE BRUTE
BUDDY: CANST DROLE FUDGY PUDDY BUDDY
BUDGE: CANST DROLE GUIDE PUDGE FUDGE BUDGE
BUGGY: CANST DROLE PIGMY VUGHY BUGGY
BUGLE: CANST DROLE UMBLE BUGLE
BUILD: CANST DROLE BUILD
BUILT: CANST RELIT GUILT BUILT
BULGE: CANST DROLE GLIME BULGE
BULKY: CANST DROLE FILMY BULGY BULKY
BULLY: CANST DROLE HILLY GULLY BULLY
BUNCH: CANST OUNCE RUNCH BUNCH
BUNNY: CANST DINGE FUNKY BUNJY BUNNY
BURLY: CANST DROLE MURLY GURLY BURLY
BURNT: CANST INEPT BURNT
BURST: CANST REIST BRUST BURST
BUSED: CANST LORES SPEED MUSED BUSED
BUSHY: CANST LORES HUSKY MUSHY PUSHY GUSHY
BUTCH: CANST TRICE KUTCH DUTCH BUTCH
BUTTE: CANST TORTE BITTE BUTTE
BUXOM: CANST DROLE GOMBO BUXOM
BUYER: CANST DROLE REFER VIPER BUYER
BYLAW: CANST AREAL PULAO BYLAW
CABAL: CANST CARED CALPA CABAL
CABBY: CANST CARED CALPA CABOC CABBY
CABIN: CANST CAJON CAIRN CABIN
CABLE: CANST CARED CABLE
CACAO: CANST CARED CALPA CACAO
CACHE: CANST CARED CABLE CAVIE CACHE
CACTI: CANST CATER CACTI
CADDY: CANST CARED CADDY
CADET: CANST CARET CADET
CAGEY: CANST CARED CAMEL CAKEY CAGEY
CAIRN: CANST CAJON CAIRN
CAMEL: CANST CARED CAMEL
CAMEO: CANST CARED CAMEL CAMEO
CANAL: CANST CANED CANNA CANAL
CANDY: CANST CANED CANDY
CANNY: CANST CANED CANNA CANNY
CANOE: CANST CANED CANOE
CANON: CANST CANED CANNA CANON
CAPER: CANST CARED CAGER CAPER
CAPUT: CANST CARET CAGOT CAPUT
CARAT: CANST CARET CARAT
CARGO: CANST CARED CAROB CARGO
CAROL: CANST CARED CAROB CAROM CAROL
CARRY: CANST CARED CAROB CARAP CARRY
CARVE: CANST CARED CARLE CARVE
CASTE: CANST CASTE
CATCH: CANST CATER CATTY CATCH
CATER: CANST CATER
CATTY: CANST CATER CATTY
CAULK: CANST CARED CALPA CAULK
CAUSE: CANST CARSE CAUSE
CAVIL: CANST CARED CALPA CAULK CAVIL
CEASE: CANST CLASH CRASS CEASE
CEDAR: CANST CLARO CIMAR CEDAR
CELLO: CANST COURE CHEMO CELLO
CHAFE: CANST CLARO CHACE CHAPE CHAFE
CHAFF: CANST CLARO CHACE CHAFF
CHAIN: CANST CHANK CHAIN
CHAIR: CANST CLARO CRAPE CHAIR
CHALK: CANST CLARO CHALK
CHAMP: CANST CLARO CHACE CHAFF CHAYA CHAWK
CHANT: CANST CHANT
CHAOS: CANST CHALS CHARS CHAMS CHAYS CHAPS
CHARD: CANST CLARO CRARE CHARA CHARK CHARY
CHARM: CANST CLARO CRARE CHARA CHARK CHARY
CHART: CANST CHART
CHASE: CANST CLASH CHASE
CHASM: CANST CLASH CHASE CHASM
CHEAP: CANST CLARO CHICA CHEAP
CHEAT: CANST CHART CHEAT
CHECK: CANST COURE CLIED CHEWY CHECK
CHEEK: CANST COURE CLIED CHEEP CHEEK
CHEER: CANST COURE CREED CHEER
CHESS: CANST CORSE CHESS
CHEST: CANST CROST CHEST
CHICK: CANST COURE CIVIL COMIC CHICH CHICK
CHIDE: CANST COURE CLIME CHIVE CHIDE
CHIEF: CANST COURE CLIED CHIEF
CHILD: CANST COURE CIVIL CLIFF CHILD
CHILI: CANST COURE CIVIL CHILI
CHILL: CANST COURE CIVIL CHILL
CHIME: CANST COURE CLIME CHIME
CHINA: CANST CHANK CHINA
CHIRP: CANST COURE CHIRP
CHOCK: CANST COURE CHOKO CHOCK
CHOIR: CANST COURE CROCK CHOIR
CHOKE: CANST COURE CLOKE CHOKE
CHORD: CANST COURE CHORD
CHORE: CANST COURE CRORE CHORE
CHOSE: CANST CORSE CHOSE
CHUCK: CANST COURE CHUCK
CHUMP: CANST COURE CHUCK CHUFF CHUMP
CHUNK: CANST COLIN CURNY CHUNK
CHURN: CANST COLIN CHURN
CHUTE: CANST CUTER CHUTE
CIDER: CANST COURE CREED CIDER
CIGAR: CANST CLARO CIMAR CIGAR
CINCH: CANST CONEY CINCH
CIRCA: CANST CLARO CIMAR CIRCA
CIVIC: CANST COURE CIVIL CIVIC
CIVIL: CANST COURE CIVIL
CLACK: CANST CLARO CLAME CLACH CLACK
CLAIM: CANST CLARO CLAME CLAIM
CLAMP: CANST CLARO CLAME CLAMP
CLANG: CANST CHANK CLANG
CLANK: CANST CHANK CRANK CLANK
CLASH: CANST CLASH
CLASP: CANST CLASH CLASS CLASP
CLASS: CANST CLASH CLASS
CLEAN: CANST CHANK COWAN CLEAN
CLEAR: CANST CLARO CLEAR
CLEAT: CANST CHART CLEAT
CLEFT: CANST CRUET CLEFT
CLERK: CANST COURE CLERK
CLICK: CANST COURE CIVIL CLIFF CLIMB CLICK
CLIFF: CANST COURE CIVIL CLIFF
CLIMB: CANST COURE CIVIL CLIFF CLIMB
CLING: CANST COLIN CLING
CLINK: CANST COLIN CLING CLINK
CLOAK: CANST CLARO CLOAK
CLOCK: CANST COURE CHOKO CLOCK
CLONE: CANST COLIN CLONK CLONE
CLOSE: CANST CORSE CHOSE CLOSE
CLOTH: CANST CUTER CLOTH
CLOUD: CANST COURE CLOUD
CLOUT: CANST CRUET CLOUT
CLOVE: CANST COURE CLOKE CLOVE
CLOWN: CANST COLIN CLOWN
CLUCK: CANST COURE CHUCK CLUCK
CLUED: CANST COURE CLUEY CLUED
CLUMP: CANST COURE CHUCK CLUMP
CLUNG: CANST COLIN CLUNK CLUNG
COACH: CANST CLARO COACH
COAST: CANST CLAST COAST
COBRA: CANST CLARO COPRA COBRA
COCOA: CANST CLARO COMAE COBIA COCOA
COLON: CANST COLIN COLON
COLOR: CANST COURE CORBY COLOR
COMET: CANST CRUET COVET COMET
COMFY: CANST COURE COOMB COMIC COMFY
COMIC: CANST COURE COOMB COMIC
COMMA: CANST CLARO COMAE COMMA
CONCH: CANST CONEY CONIC CONCH
CONDO: CANST CONEY CONIC CONGO CONDO
CONIC: CANST CONEY CONIC
COPSE: CANST CORSE COPSE
CORAL: CANST CLARO CORAL
CORER: CANST COURE COREY CORED CORER
CORNY: CANST COLIN CORNO CORNY
COUCH: CANST COURE COUCH
COUGH: CANST COURE COUCH COUGH
COULD: CANST COURE COUCH COULD
COUNT: CANST CLINT COUNT
COUPE: CANST COURE COUPE
COURT: CANST CRUET COURT
COVEN: CANST COLIN CODEN COVEN
COVER: CANST COURE COREY COVER
COVET: CANST CRUET COVET
COVEY: CANST COURE CODEX COZEY COOEY COVEY
COWER: CANST COURE COREY COVER COOER COMER
COYLY: CANST COURE COOMB COLIC COYLY
CRACK: CANST CLARO CRAPE CRAIC CRACK
CRAFT: CANST CHART CRAFT
CRAMP: CANST CLARO CRAPE CRAMP
CRANE: CANST CHANK CLANG CYANO CRANE
CRANK: CANST CHANK CRANK
CRASH: CANST CLASH CRASH
CRASS: CANST CLASH CRASS
CRATE: CANST COTTA CRATE
CRAVE: CANST CLARO CRAPE CRAZE CRAKE CRAVE
CRAWL: CANST CLARO CRAAL CRAWL
CRAZE: CANST CLARO CRAPE CRAZE
CRAZY: CANST CLARO CRAPE CRAIC CRAZY
CREAK: CANST CLARO CIMAR CREAK
CREAM: CANST CLARO CIMAR CREAM
CREDO: CANST COURE CREDO
CREED: CANST COURE CREED
CREEK: CANST COURE CREED CREEK
CREEP: CANST COURE CREED CREEK CREEL CREEP
CREME: CANST COURE CREME
CREPE: CANST COURE CREME CREPE
CREPT: CANST CRUET CREPT
CRESS: CANST CORSE CRESS
CREST: CANST CROST CREST
CRICK: CANST COURE CRICK
CRIED: CANST COURE CREED CRIED
CRIER: CANST COURE CREED CRYER CRIER
CRIME: CANST COURE CREME CRIME
CRIMP: CANST COURE CRICK CRIMP
CRISP: CANST CORSE CRUSH CRISP
CROAK: CANST CLARO CORAM CROAK
CROCK: CANST COURE CROCK
CRONE: CANST COLIN CONEY CRONE
CRONY: CANST COLIN CONEY CRONY
CROOK: CANST COURE CROCK CROOK
CROSS: CANST CORSE CROSS
CROUP: CANST COURE CLOUR CROUP
CROWD: CANST COURE CROCK CROOL CROMB CROWD
CROWN: CANST COLIN CHOON CROWN
CRUDE: CANST COURE CRUDE
CRUEL: CANST COURE CRUEL
CRUMB: CANST COURE CRUMP CRUMB
CRUMP: CANST COURE CRUMP
CRUSH: CANST CORSE CRUSH
CRUST: CANST CROST CREST CRUST
CRYPT: CANST CRUET CROFT CRYPT
CUBIC: CANST COURE CUBIC
CUMIN: CANST COLIN CUMIN
CURIO: CANST COURE CLOUR CURIO
CURLY: CANST COURE CURLY
CURRY: CANST COURE CURRY
CURSE: CANST CORSE CURSE
CURVE: CANST COURE CURIE CURVE
CURVY: CANST COURE CURLY CURVY
CUTIE: CANST CUTER CUTIE
CYBER: CANST COURE CREED CYBER
CYCLE: CANST COURE CLIME CYCLE
CYNIC: CANST CONEY CYNIC
DADDY: CANST MARLE KADAI BADDY PADDY WADDY
DAILY: CANST MARLE DALLY DAILY
DAIRY: CANST MARLE RAKIA PADRI YAIRD DAIRY
DAISY: CANST SALSE DAISY
DALLY: CANST MARLE DALLY
DANCE: CANST HANCE RANCE PANCE DANCE
DANDY: CANST KANAE GANDY BANDY DANDY
DATUM: CANST TALER MATAI DATUM
DAUNT: CANST DAUNT
DEALT: CANST ALERT DEALT
DEATH: CANST REATA BEATH DEATH
DEBAR: CANST AREAL REBAR KEBAR DEBAR
DEBIT: CANST RELIT PETIT DEBIT
DEBUG: CANST DROLE DEBUD DEBUG
DEBUT: CANST RELIT DEPOT DEBUT
DECAL: CANST ARECA LACED DECAL
DECAY: CANST ARECA LACED DECAF DECAY
DECOR: CANST LOCIE DECOR
DECOY: CANST LOCIE DECOR DECOY
DECRY: CANST LOCIE RUCHE DECRY
DEFER: CANST DROLE DIMER DUPER DEFER
DEIGN: CANST IRONE LEVIN DEIGN
DEITY: CANST TORTE MELTY DEITY
DELAY: CANST AREAL BELAY DELAY
DELTA: CANST REATA PELTA DELTA
DELVE: CANST DROLE DELVE
DEMON: CANST IRONE DEMON
DEMUR: CANST DROLE DIMER DEMUR
DENIM: CANST DINGE DENIM
DENSE: CANST SENSE MENSE DENSE
DEPOT: CANST RELIT DEPOT
DEPTH: CANST TORTE MELTY DEPTH
DERBY: CANST DROLE DIMER DERBY
DETER: CANST TORTE PETRI DETER
DETOX: CANST TORTE DEPOT DETOX
DEUCE: CANST LOCIE PEECE DEUCE
DEVIL: CANST DROLE DEVEL DEVIL
DIARY: CANST AREAL MOIRA DIARY
DICEY: CANST LOCIE DICER DICED DICEY
DIGIT: CANST RELIT OOBIT DIXIT DIGIT
DILLY: CANST DROLE DULLY DILLY
DIMLY: CANST DROLE DULLY DIMLY
DINER: CANST DINGE DINER
DINGO: CANST DINGE DINGY DINGO
DINGY: CANST DINGE DINGY
DIODE: CANST DROLE DIODE
DIRGE: CANST DROLE DIRKE DIRGE
DIRTY: CANST TORTE YIRTH DIRTY
DISCO: CANST SOUCE FLOCS PISCO DISCO
DITCH: CANST TRICE HITCH PITCH BITCH WITCH
DITTO: CANST TORTE DITTO
DITTY: CANST TORTE BUTTY DITTY
DIVER: CANST DROLE DIMER DIVER
DIZZY: CANST DROLE DUPED DIVVY DIZZY
DODGE: CANST DROLE DODGE
DODGY: CANST DROLE DODGY
DOGMA: CANST AREAL PODIA DOUMA DOGMA
DOING: CANST IRONE HOING GOING BOING DOING
DOLLY: CANST DROLE DOWLY DOLLY
DONOR: CANST DINGE DONOR
DONUT: CANST DENET DONUT
DOPEY: CANST DROLE DOMED DOPEY
DOUBT: CANST RELIT BHOOT DOUBT
DOUGH: CANST DROLE DODGY DOGGO DOUGH
DOWDY: CANST DROLE DODGY DOWDY
DOWEL: CANST DROLE DOWEL
DOWNY: CANST IRONE POWNY DOWNY
DOWRY: CANST DROLE DORMY DOWRY
DOZEN: CANST IRONE DEMON DOVEN DOZEN
DRAFT: CANST ALERT PRATT DRAFT
DRAIN: CANST ARGAN DRAIN
DRAKE: CANST AREAL GRADE DRAKE
DRAMA: CANST AREAL BRAVA GRAMA DRAMA
DRANK: CANST ARGAN DRANK
DRAPE: CANST AREAL GRADE DRAKE DRAVE DRAPE
DRAWL: CANST AREAL DRAIL DRAWL
DRAWN: CANST ARGAN DRAIN DRAWN
DREAD: CANST AREAL BREAD DREAD
DREAM: CANST AREAL BREAD DREAM
DRESS: CANST SOUSE DRESS
DRIED: CANST DROLE DREER DRIED
DRIER: CANST DROLE DREER DRIER
DRIFT: CANST RELIT GRIFT DRIFT
DRILL: CANST DROLE DRYLY DRILL
DRINK: CANST IRONE BRING PRINK DRINK
DRIVE: CANST DROLE DRERE DRIVE
DROIT: CANST RELIT BRUIT DROIT
DROLL: CANST DROLE DROLL
DRONE: CANST IRONE DRONE
DROOL: CANST DROLE DROIL DROOL
DROOP: CANST DROLE DROOK DROOP
DROSS: CANST SOUSE GLOSS PROSS DROSS
DROVE: CANST DROLE DROME DROVE
DROWN: CANST IRONE FROWN BROWN GROWN DROWN
DRUID: CANST DROLE DRUID
DRUNK: CANST IRONE DRUNK
DRYER: CANST DROLE DREER DRIER DRYER
DRYLY: CANST DROLE DRYLY
DUCHY: CANST LOCIE DUCHY
DULLY: CANST DROLE DULLY
DUMMY: CANST DROLE DUPED DUMMY
DUMPY: CANST DROLE DUPED DUMPY
DUNCE: CANST OUNCE DUNCE
DUSKY: CANST LORES HUSKY DUSKY
DUSTY: CANST TIRES STULM BUSTY FUSTY GUSTY
DUTCH: CANST TRICE KUTCH DUTCH
DUVET: CANST RELIT MOTET UPJET DUVET
DWARF: CANST AREAL MOIRA GUARD DWARF
DWELL: CANST DROLE DWELL
DWELT: CANST RELIT FLEET DWELT
DYING: CANST IRONE LYING VYING HYING DYING
EAGER: CANST MARLE GAPER EAGER
EAGLE: CANST MARLE HABLE PADLE EAGLE
EARLY: CANST MARLE EARLY
EARTH: CANST TALER RATHE EARTH
EASEL: CANST EARLS EASEL
EATEN: CANST OATEN PATEN EATEN
EATER: CANST TALER GATER PATER WATER HATER
EBONY: CANST IRONE EBONY
ECLAT: CANST REACT ECLAT
EDICT: CANST DICOT EDICT
EDIFY: CANST DROLE EIKED EDIFY
EERIE: CANST DROLE RIEVE EERIE
EGRET: CANST RELIT GREET EGRET
EIGHT: CANST RELIT ZIBET EIGHT
EJECT: CANST DICOT ERECT EJECT
EKING: CANST IRONE MEINY EHING EKING
ELATE: CANST REATA PLATE ELATE
ELBOW: CANST DROLE HOLEY FLEXO ELBOW
ELDER: CANST DROLE RULED ELDER
ELECT: CANST DICOT ERECT EJECT ELECT
ELEGY: CANST DROLE GEMEL ELEGY
ELFIN: CANST IRONE LEVIN ELDIN ELFIN
ELIDE: CANST DROLE ELIDE
ELITE: CANST TORTE ELITE
ELOPE: CANST DROLE GLOBE PLOYE ELOPE
ELUDE: CANST DROLE ELIDE ELUDE
EMAIL: CANST AREAL EMAIL
EMBED: CANST DROLE EIKED EDGED EMBED
EMBER: CANST DROLE REFER EMMER EMEER EMBER
EMCEE: CANST LOCIE BECKE EMCEE
EMPTY: CANST TORTE MELTY EMPTY
ENACT: CANST ENACT
ENDOW: CANST IRONE DEMON ENDOW
ENEMA: CANST ARGAN LIANE ENEMA
ENEMY: CANST IRONE LEBEN ENEMY
ENJOY: CANST IRONE DEMON ENJOY
ENNUI: CANST DINGE BENNI ENNUI
ENSUE: CANST REINS SOKEN ENSUE
ENTER: CANST NOTER INTER ENTER
ENTRY: CANST NOTER ENTRY
ENVOY: CANST IRONE DEMON ENJOY ENVOY
EPOCH: CANST LOCIE OCKER EPOCH
EPOXY: CANST DROLE ZOOEY EPOXY
EQUAL: CANST AREAL MEDAL EQUAL
EQUIP: CANST DROLE BEGEM EQUIP
ERASE: CANST SMASH LEASE ERASE
ERECT: CANST DICOT ERECT
ERODE: CANST DROLE ERODE
ERROR: CANST DROLE GREBO ORMER ERROR
ERUPT: CANST RELIT GREET ERUPT
ESSAY: CANST REALS ASKED ESSAY
ESTER: CANST TIRES ESTER
ETHER: CANST TORTE PETRI ETHER
ETHIC: CANST TRICE METIC ETHIC
ETHOS: CANST TIRES LESTS ETHOS
ETUDE: CANST TORTE LITHE ETUDE
EVADE: CANST AREAL HEADY EVADE
EVENT: CANST INEPT BRENT GLENT EVENT
EVERY: CANST DROLE REFER EVERY
EVICT: CANST DICOT EVICT
EVOKE: CANST DROLE POOVE EVOHE EVOKE
EXACT: CANST REACT EPACT EXACT
EXALT: CANST ALERT DEALT EXALT
EXCEL: CANST LOCIE EXCEL
EXERT: CANST RELIT GREET EVERT EXERT
EXILE: CANST DROLE UMBLE EXILE
EXIST: CANST REIST EXIST
EXPEL: CANST DROLE GEMEL WHEEL EXPEL
EXTOL: CANST TORTE DEPOT EXTOL
EXTRA: CANST REATA TREFA EXTRA
EXULT: CANST RELIT FLEET EXULT
EYING: CANST IRONE MEINY EYING
FABLE: CANST MARLE HABLE FABLE
FACET: CANST TACET FACET
FAINT: CANST DAUNT FAINT
FAIRY: CANST MARLE RAKIA PADRI VAIRY HAIRY
FAITH: CANST TALER MATAI HABIT FAITH
FALSE: CANST SALSE HALSE FALSE
FANCY: CANST HANCE FANCY
FANNY: CANST KANAE GANDY NANNY JANNY FANNY
FARCE: CANST RACHE FARCE
FATAL: CANST TALER FATLY FATAL
FATTY: CANST TALER MATAI BATTY PATTY FATTY
FAULT: CANST GAMUT HAULT DAULT VAULT FAULT
FAUNA: CANST RAVEN NABLA FAUNA
FAVOR: CANST MARLE RAKIA VAPOR FAVOR
FEAST: CANST LEAST BEAST FEAST
FECAL: CANST ARECA LACED FECAL
FEIGN: CANST IRONE LEVIN DEIGN FEIGN
FELLA: CANST AREAL MEALY FELLA
FELON: CANST IRONE DEMON PELON BELON FELON
FEMME: CANST DROLE PUMIE JEMBE FEMME
FEMUR: CANST DROLE REFER FEMUR
FENCE: CANST OUNCE FENCE
FERAL: CANST AREAL REGAL FERAL
FERRY: CANST DROLE REFER FERRY
FETAL: CANST REATA FETAL
FETCH: CANST TRICE LETCH VETCH KETCH FETCH
FETID: CANST TORTE DEBIT FETID
FETUS: CANST TIRES LESTS HETHS FETUS
FEVER: CANST DROLE REFER FEWER FEVER
FEWER: CANST DROLE REFER FEWER
FIBER: CANST DROLE REFER FIXER FIVER FIBER
FIBRE: CANST DROLE RIEVE FIRIE FIBRE
FICUS: CANST SOUCE SCRUM FUCUS FICUS
FIELD: CANST DROLE FIELD
FIEND: CANST IRONE MEINY PIEND FIEND
FIERY: CANST DROLE REFER FIERY
FIFTH: CANST TORTE MILTY WIDTH FIFTH
FIFTY: CANST TORTE MILTY WIFTY FIFTY
FIGHT: CANST RELIT PITOT BIDET KIGHT WIGHT
FILER: CANST DROLE LIVER MILER FILER
FILET: CANST RELIT GILET FILET
FILLY: CANST DROLE HILLY FILLY
FILMY: CANST DROLE FILMY
FILTH: CANST TORTE MILTY FILTH
FINAL: CANST GENAL VINAL FINAL
FINCH: CANST OUNCE GINCH PINCH FINCH
FINER: CANST DINGE LINER FINER
FIRST: CANST REIST FIRST
FISHY: CANST LORES HUSKY FISHY
FIXER: CANST DROLE REFER FIXER
FIZZY: CANST DROLE PIGMY FIZZY
FJORD: CANST DROLE BOORD FIORD FJORD
FLACK: CANST ARECA LOACH PLACK FLACK
FLAIL: CANST AREAL QUAIL FLAIL
FLAIR: CANST AREAL GLAIR FLAIR
FLAKE: CANST AREAL MEALY GLADE BLAZE FLAKE
FLAKY: CANST AREAL IDOLA FLAMY FLAKY
FLAME: CANST AREAL MEALY FLAME
FLANK: CANST ARGAN LIANE BLAND FLANK
FLARE: CANST AREAL GLARE FLARE
FLASH: CANST SMASH BLASH PLASH FLASH
FLASK: CANST SMASH LEASE FLASK
FLECK: CANST LOCIE FELCH FLECK
FLEET: CANST RELIT FLEET
FLESH: CANST SOUSE WELSH FLESH
FLICK: CANST LOCIE FILCH FLICK
FLIER: CANST DROLE LIVER FLIER
FLING: CANST IRONE LYING FLING
FLINT: CANST INEPT GLINT FLINT
FLIRT: CANST RELIT LIROT FLIRT
FLOAT: CANST ALERT PLAIT GLOAT FLOAT
FLOCK: CANST LOCIE FLOCK
FLOOD: CANST DROLE FLOOD
FLOOR: CANST DROLE FLOOR
FLORA: CANST AREAL GLAIR FLORA
FLOSS: CANST SOUSE GLOSS FLOSS
FLOUR: CANST DROLE FLOOR FLOUR
FLOUT: CANST RELIT YMOLT GLOUT FLOUT
FLOWN: CANST IRONE BLOWN FLOWN
FLUFF: CANST DROLE FILMY FLUFF
FLUID: CANST DROLE FLUID
FLUKE: CANST DROLE GLIME BLYPE FLUKE
FLUME: CANST DROLE GLIME FLUME
FLUNG: CANST IRONE BLUNK FLUNG
FLUNK: CANST IRONE BLUNK PLUNK FLUNK
FLUSH: CANST SOUSE BRUSH PLUSH FLUSH
FLUTE: CANST TORTE ELITE FLYTE FLUTE
FLYER: CANST DROLE LIVER PULER FLYER
FOAMY: CANST AREAL PODIA FOAMY
FOCAL: CANST ARECA LOCAL FOCAL
FOCUS: CANST SOUCE HOCUS LOCUS FOCUS
FOGGY: CANST DROLE GOMBO FOGGY
FOIST: CANST REIST HOIST ZOIST JOIST MOIST
FOLIO: CANST DROLE POLIO FOLIO
FOLLY: CANST DROLE LOWLY GOLLY FOLLY
FORAY: CANST AREAL DIRAM HYRAX FORAY
FORCE: CANST LOCIE DOUCE FORCE
FORGE: CANST DROLE ROWIE FORGE
FORGO: CANST DROLE MORRO FORGO
FORTE: CANST TORTE FORTE
FORTH: CANST TORTE FORTY FORTH
FORTY: CANST TORTE FORTY
FORUM: CANST DROLE MORRO GORMY FORUM
FOUND: CANST IRONE POWNY FOHNS FOUND
FOYER: CANST DROLE PORER VOMER FOYER
FRAIL: CANST AREAL DRAIL FRAIL
FRAME: CANST AREAL GRADE BRAME FRAME
FRANK: CANST ARGAN DRANK FRANK
FRAUD: CANST AREAL GRAIP BRAKY FRAUD
FREAK: CANST AREAL BREAD FREAK
FREED: CANST DROLE PRIED GREED FREED
FREER: CANST DROLE PREIF FREER
FRESH: CANST SOUSE WELSH FRESH
FRIAR: CANST AREAL BRIAR FRIAR
FRIED: CANST DROLE PRIED WRIED FRIED
FRILL: CANST DROLE GRILL KRILL BRILL PRILL
FRISK: CANST SOUSE GIRSH BRISK FRISK
FRITZ: CANST TORTE GRITH FRITZ
FROCK: CANST LOCIE BROCH FROCK
FROND: CANST IRONE PRONG FROND
FRONT: CANST INEPT BURNT FRONT
FROST: CANST REIST BRUST PROST FROST
FROTH: CANST TORTE BROTH FROTH
FROWN: CANST IRONE FROWN
FROZE: CANST DROLE PROKE FROZE
FRUIT: CANST RELIT BRUIT FRUIT
FUDGE: CANST DROLE GUIDE PUDGE FUDGE
FUGUE: CANST DROLE PUMIE FUGUE
FULLY: CANST DROLE HILLY GULLY BULLY FULLY
FUNGI: CANST DINGE WONGI LUNGI FUNGI
FUNKY: CANST DINGE FUNKY
FUNNY: CANST DINGE FUNKY FUNNY
FUROR: CANST DROLE MORRO JUROR FUROR
FURRY: CANST DROLE MURRY HURRY FURRY
FUSSY: CANST SOUSE WUSSY PUSSY FUSSY
FUZZY: CANST DROLE PIGMY FLYBY FUZZY
GAFFE: CANST MARLE BADGE GAUZE GAFFE
GAILY: CANST MARLE DALLY HAILY GAILY
GAMER: CANST MARLE GAMER
GAMMA: CANST MARLE GAMBA GAMMA
GAMUT: CANST GAMUT
GASSY: CANST SALSE MASSY BASSY GASSY
GAUDY: CANST MARLE KADAI GAUDY
GAUGE: CANST MARLE BADGE GAUGE
GAUNT: CANST DAUNT HAUNT VAUNT GAUNT
GAUZE: CANST MARLE BADGE GAUZE
GAVEL: CANST MARLE GALED GAVEL
GAWKY: CANST MARLE KADAI YAPOK GAWKY
GAYER: CANST MARLE GAPER GAZER GAYER
GAYLY: CANST MARLE DALLY HAILY GAYLY
GAZER: CANST MARLE GAPER GAZER
GECKO: CANST LOCIE DECOR GECKO
GEEKY: CANST DROLE BEGEM GEEKY
GEESE: CANST SOUSE PRESE LEESE FEESE GEESE
GENIE: CANST DINGE GENIE
GENRE: CANST DINGE GENRE
GHOST: CANST REIST GHOST
GHOUL: CANST DROLE BLOOP GHOUL
GIANT: CANST RIANT GIANT
GIDDY: CANST DROLE FUDGY GIDDY
GIPSY: CANST SOUSE GIRSH GIPSY
GIRLY: CANST DROLE MURLY GIRLY
GIRTH: CANST TORTE YIRTH FIRTH GIRTH
GIVEN: CANST IRONE LEVIN GIVEN
GIVER: CANST DROLE REFER VIPER HIVER GIVER
GLADE: CANST AREAL MEALY GLADE
GLAND: CANST ARGAN KLANG GLAND
GLARE: CANST AREAL GLARE
GLASS: CANST SMASH GRASS GLASS
GLAZE: CANST AREAL MEALY GLADE GLAZE
GLEAM: CANST AREAL FLEAM GLEAM
GLEAN: CANST ARGAN BEGAN GLEAN
GLIDE: CANST DROLE ELIDE GLIDE
GLINT: CANST INEPT GLINT
GLOAT: CANST ALERT PLAIT GLOAT
GLOBE: CANST DROLE GLOBE
GLOOM: CANST DROLE BLOOP KLOOF GLOOM
GLORY: CANST DROLE FLOOR GLORY
GLOSS: CANST SOUSE GLOSS
GLOVE: CANST DROLE GLOBE GLOVE
GLYPH: CANST DROLE FILMY GLYPH
GNASH: CANST GNASH
GNOME: CANST IRONE KNOWE GNOME
GODLY: CANST DROLE WOULD GODLY
GOING: CANST IRONE HOING GOING
GOLEM: CANST DROLE HOLEY GOLEM
GOLLY: CANST DROLE LOWLY GOLLY
GONAD: CANST GENAL GONAD
GONER: CANST DINGE GONER
GOODY: CANST DROLE HOODY FOODY BOODY MOODY
GOOEY: CANST DROLE ZOOEY GOOEY
GOOFY: CANST DROLE GOOPY GOOKY GOOBY GOOFY
GOOSE: CANST SOUSE WORSE POISE MOOSE BOOSE
GORGE: CANST DROLE ROWIE FORGE GORGE
GOUGE: CANST DROLE BOGIE VOUGE GOUGE
GOURD: CANST DROLE ROWDY BOURD GOURD
GRACE: CANST ARECA BRACE GRACE
GRADE: CANST AREAL GRADE
GRAFT: CANST ALERT PRATT DRAFT KRAFT GRAFT
GRAIL: CANST AREAL DRAIL FRAIL GRAIL
GRAIN: CANST ARGAN GRAIN
GRAND: CANST ARGAN PRANG GRAND
GRANT: CANST RIANT TRANT GRANT
GRAPE: CANST AREAL GRADE GRAPE
GRAPH: CANST AREAL GRAIP GRAPH
GRASP: CANST SMASH LEASE BRAST GRASP
GRASS: CANST SMASH GRASS
GRATE: CANST REATA GRATE
GRAVE: CANST AREAL GRADE GRAPE GRAZE GRAVE
GRAVY: CANST AREAL GRAIP GRAFF GRAVY
GRAZE: CANST AREAL GRADE GRAPE GRAZE
GREAT: CANST ALERT GREAT
GREED: CANST DROLE PRIED GREED
GREEN: CANST IRONE GREEN
GREET: CANST RELIT GREET
GRIEF: CANST DROLE PREIF GRIEF
GRILL: CANST DROLE GRILL
GRIME: CANST DROLE GRIME
GRIMY: CANST DROLE GRIMY
GRIND: CANST IRONE BRING GRIND
GRIPE: CANST DROLE GRIME GRIKE GRIZE GRIPE
GROAN: CANST ARGAN GROAN
GROIN: CANST IRONE GROIN
GROOM: CANST DROLE GROOF GROOM
GROPE: CANST DROLE PROKE GROPE
GROSS: CANST SOUSE GLOSS GROSS
GROUP: CANST DROLE GROOF GROVY GROUP
GROUT: CANST RELIT POORT TROUT GROUT
GROVE: CANST DROLE PROKE FROZE GROVE
GROWL: CANST DROLE PROWL GROWL
GROWN: CANST IRONE FROWN BROWN GROWN
GRUEL: CANST DROLE GRUEL
GRUFF: CANST DROLE GRIMY GRUFF
GRUNT: CANST INEPT BURNT GRUNT
GUARD: CANST AREAL MOIRA GUARD
GUAVA: CANST AREAL KHAYA GUAVA
GUESS: CANST SOUSE GUESS
GUEST: CANST REIST GOEST GHEST GUEST
GUIDE: CANST DROLE GUIDE
GUILD: CANST DROLE BUILD GUILD
GUILE: CANST DROLE UMBLE GUILE
GUILT: CANST RELIT GUILT
GUISE: CANST SOUSE PULSE GUYSE GUISE
GULCH: CANST LOCIE GULCH
GULLY: CANST DROLE HILLY GULLY
GUMBO: CANST DROLE GOMBO GUMBO
GUMMY: CANST DROLE PIGMY GUMMY
GUPPY: CANST DROLE PIGMY GUPPY
GUSTO: CANST TIRES STULM BUSTY GUSTO
GUSTY: CANST TIRES STULM BUSTY FUSTY GUSTY
GYPSY: CANST SOUSE GIRSH GYPSY
HABIT: CANST GAMUT RABAT HABIT
HAIRY: CANST MARLE RAKIA PADRI VAIRY HAIRY
HALVE: CANST MARLE HALVE
HANDY: CANST KANAE GANDY BANDY DANDY RANDY
HAPPY: CANST MARLE KADAI GABBY ZAPPY YAPPY
HARDY: CANST MARLE BARDY HARDY
HAREM: CANST MARLE HAREM
HARPY: CANST MARLE BARDY PARRY HARPY
HARRY: CANST MARLE BARDY PARRY HARRY
HARSH: CANST SALSE DAISY HARSH
HASTE: CANST TATES HASTE
HASTY: CANST TATES HASTY
HATCH: CANST TACHO HATCH
HATER: CANST TALER GATER PATER WATER HATER
HAUNT: CANST DAUNT HAUNT
HAUTE: CANST TALER VAWTE MATTE HAUTE
HAVEN: CANST RAVEN DAVEN PAVEN HAVEN
HAVOC: CANST RACHE LAUCH HAVOC
HAZEL: CANST MARLE GALED LABEL FAVEL HAZEL
HEADY: CANST AREAL HEADY
HEARD: CANST AREAL DEARY HEARD
HEART: CANST ALERT FEART HEART
HEATH: CANST REATA BEATH DEATH HEATH
HEAVE: CANST AREAL HEADY HEAME HEAVE
HEAVY: CANST AREAL HEADY HEAPY HEAVY
HEDGE: CANST DROLE GUIDE WEDGE HEDGE
HEFTY: CANST TORTE MELTY DEITY HEFTY
HEIST: CANST REIST GEIST FEIST DEIST HEIST
HELIX: CANST DROLE GEMEL HELIX
HELLO: CANST DROLE HELLO
HENCE: CANST OUNCE FENCE PENCE HENCE
HERON: CANST IRONE REWON HERON
HILLY: CANST DROLE HILLY
HINGE: CANST DINGE WINGE MINGE GINGE HINGE
HIPPO: CANST DROLE GOMBO ZIPPO HIPPO
HIPPY: CANST DROLE PIGMY YIPPY ZIPPY HIPPY
HITCH: CANST TRICE HITCH
HOARD: CANST AREAL MOIRA HOARD
HOBBY: CANST DROLE GOMBO BOBBY YOBBY HOBBY
HOIST: CANST REIST HOIST
HOLLY: CANST DROLE LOWLY GOLLY FOLLY MOLLY
HOMER: CANST DROLE PORER VOMER HOMER
HONEY: CANST DINGE HONER HONEY
HONOR: CANST DINGE FUNKY HONOR
HORDE: CANST DROLE BORDE HORDE
HORNY: CANST IRONE HORNY
HORSE: CANST SOUSE WORSE DORSE HORSE
HOTEL: CANST TORTE MOTEL HOTEL
HOTLY: CANST TORTE MOLTO HOTLY
HOUND: CANST IRONE POWNY FOHNS HOUND
HOUSE: CANST SOUSE DOUSE ROUSE YOUSE MOUSE
HOVEL: CANST DROLE HOLEY HOVEL
HOVER: CANST DROLE PORER VOMER HOVER
HOWDY: CANST DROLE IODID HOWDY
HUMAN: CANST ARGAN KULAN HUMAN
HUMID: CANST DROLE FUDGY HUMID
HUMOR: CANST DROLE MORRO HUMOR
HUMPH: CANST DROLE PIGMY BUMPH HUMPH
HUMUS: CANST LORES SIMPS HUMFS HUMUS
HUNCH: CANST OUNCE RUNCH BUNCH PUNCH MUNCH
HUNKY: CANST DINGE FUNKY JUNKY HUNKY
HURRY: CANST DROLE MURRY HURRY
HUSKY: CANST LORES HUSKY
HUSSY: CANST SOUSE WUSSY PUSSY FUSSY MUSSY
HUTCH: CANST TRICE KUTCH DUTCH BUTCH MUTCH
HYDRO: CANST DROLE ROWDY HYDRO
HYENA: CANST ARGAN LIANE BEANY HYENA
HYMEN: CANST IRONE LEBEN UNPEN HYMEN
HYPER: CANST DROLE REFER VIPER HYPER
ICILY: CANST LOCIE FILCH ICILY
ICING: CANST NICER ICING
IDEAL: CANST AREAL IDEAL
IDIOM: CANST DROLE IODID IDIOM
IDIOT: CANST RELIT PITOT IDIOT
IDLER: CANST DROLE RULED IDLER
IDYLL: CANST DROLE BUILD IDYLL
IGLOO: CANST DROLE POLIO IGLOO
ILIAC: CANST ARECA LOCAL YCLAD ILIAC
IMAGE: CANST AREAL HEADY QUAKE IMAGE
IMBUE: CANST DROLE PUMIE IMBUE
IMPEL: CANST DROLE GEMEL UMBEL IMPEL
IMPLY: CANST DROLE HILLY IMPLY
INANE: CANST ARGAN LIANE INANE
INBOX: CANST IRONE IODIN INBOX
INCUR: CANST NICER INCUR
INDEX: CANST IRONE INDEW INDEX
INEPT: CANST INEPT
INERT: CANST INEPT INERT
INFER: CANST IRONE INKER INFER
INGOT: CANST INEPT INWIT INGOT
INLAY: CANST ARGAN NODAL INLAY
INLET: CANST INEPT INLET
INNER: CANST DINGE BENNI INNER
INPUT: CANST INEPT INPUT
INTER: CANST NOTER INTER
INTRO: CANST NOTER INTRO
IONIC: CANST OUNCE IONIC
IRATE: CANST REATA GRATE ORATE FRATE URATE
IRONY: CANST IRONE IRONY
ISLET: CANST SPRIT ISLET
ISSUE: CANST LORES SPIDE ISSUE
ITCHY: CANST TRICE LOTIC ITCHY
IVORY: CANST DROLE ROOKY IVORY
JAUNT: CANST DAUNT HAUNT VAUNT GAUNT TAUNT
JAZZY: CANST MARLE KADAI GABBY ZAPPY JAZZY
JELLY: CANST DROLE KVELL BELLY FELLY WELLY
JERKY: CANST DROLE REFER PERKY KERKY JERKY
JETTY: CANST TORTE JETTY
JEWEL: CANST DROLE GEMEL BEVEL JEWEL
JIFFY: CANST DROLE PIGMY FIZZY JIFFY
JOINT: CANST INEPT GLINT JOINT
JOIST: CANST REIST HOIST ZOIST JOIST
JOKER: CANST DROLE PORER VOMER FOYER WOKER
JOLLY: CANST DROLE LOWLY GOLLY FOLLY MOLLY
JOUST: CANST REIST GHOST MOUST JOUST
JUDGE: CANST DROLE GUIDE PUDGE FUDGE BUDGE
JUICE: CANST LOCIE DRICE JUICE
JUICY: CANST LOCIE WRICK JUICY
JUMBO: CANST DROLE GOMBO BUMBO JUMBO
JUMPY: CANST DROLE PIGMY HUMPY JUMPY
JUNTA: CANST MENTA JUNTA
JUNTO: CANST TONEY PUNTO JUNTO
JUROR: CANST DROLE MORRO JUROR
KAPPA: CANST MARLE KADAI KAPPA
KARMA: CANST MARLE HARAM PARMA KARMA
KAYAK: CANST MARLE KADAI KABAB KAYAK
KEBAB: CANST AREAL BEMAD HEJAB KEBAB
KHAKI: CANST AREAL PODIA KHAZI KHAKI
KINKY: CANST DINGE PINNY LINKY HINKY ZINKY
KIOSK: CANST SOUSE PROSY WHOSO KIOSK
KITTY: CANST TORTE BUTTY DITTY KITTY
KNACK: CANST PUCAN ACING KNACK
KNAVE: CANST ARGAN LIANE KNAVE
KNEAD: CANST ARGAN NODAL KNEAD
KNEED: CANST IRONE LEBEN ENDEW KNEED
KNEEL: CANST IRONE LEBEN KNEEL
KNELT: CANST INEPT KNELT
KNIFE: CANST IRONE NIEVE KNIFE
KNOCK: CANST NICER YCOND KNOCK
KNOLL: CANST IRONE BLOWN KNOLL
KNOWN: CANST IRONE BLOWN KNOWN
KOALA: CANST AREAL PALLA JHALA KOALA
KRILL: CANST DROLE GRILL KRILL
LABEL: CANST MARLE GALED LABEL
LABOR: CANST MARLE LAVRA LABOR
LADEN: CANST RAVEN WAKEN ZAZEN LADEN
LADLE: CANST MARLE HABLE PADLE LADLE
LAGER: CANST MARLE WALER LAXER LADER LAGER
LANCE: CANST HANCE RANCE PANCE DANCE LANCE
LANKY: CANST KANAE MANKY LANKY
LAPEL: CANST MARLE GALED LABEL LAPEL
LAPSE: CANST SALSE LAPSE
LARGE: CANST MARLE LARGE
LARVA: CANST MARLE LARKY LARVA
LASSO: CANST SALSE LASSI LASSO
LATCH: CANST TACHO HATCH LATCH
LATER: CANST TALER LATER
LATHE: CANST TALER LATKE LATTE LATHE
LATTE: CANST TALER LATKE LATTE
LAUGH: CANST MARLE HALVA LAUGH
LAYER: CANST MARLE WALER LAXER LADER LAGER
LEACH: CANST ARECA PLACE LEACH
LEAFY: CANST AREAL MEALY LEAFY
LEAKY: CANST AREAL MEALY LEAFY LEAKY
LEANT: CANST RIANT ALANT LEANT
LEAPT: CANST ALERT DEALT LEAPT
LEARN: CANST ARGAN YEARN DEARN LEARN
LEASE: CANST SMASH LEASE
LEASH: CANST SMASH BLASH LEASH
LEAST: CANST LEAST
LEAVE: CANST AREAL MEALY LEAVE
LEDGE: CANST DROLE ELIDE LEDGE
LEECH: CANST LOCIE LEUCH LEECH
LEERY: CANST DROLE LIVER LEERY
LEFTY: CANST TORTE MELTY LEFTY
LEGAL: CANST AREAL MEDAL LEGAL
LEGGY: CANST DROLE GEMEL LEUGH LEGGY
LEMON: CANST IRONE DEMON LEMON
LEMUR: CANST DROLE LIVER LEMUR
LEPER: CANST DROLE LIVER LUGER LEPER
LEVEL: CANST DROLE GEMEL BEVEL LEVEL
LEVER: CANST DROLE LIVER LEVER
LIBEL: CANST DROLE GEMEL PUZEL LIBEL
LIEGE: CANST DROLE GLIME LIEGE
LIGHT: CANST RELIT GUILT LIGHT
LIKEN: CANST IRONE LEVIN LIMEN LIKEN
LILAC: CANST ARECA LOCAL LILAC
LIMBO: CANST DROLE POLIO LIMBO
LIMIT: CANST RELIT LIMIT
LINEN: CANST DINGE LINER LINEN
LINER: CANST DINGE LINER
LINGO: CANST DINGE LINGY LINGO
LIPID: CANST DROLE FLUID LIVID LIPID
LITHE: CANST TORTE LITHE
LIVER: CANST DROLE LIVER
LIVID: CANST DROLE FLUID LIVID
LLAMA: CANST AREAL PALLA LLAMA
LOAMY: CANST AREAL IDOLA LOAMY
LOATH: CANST REATA PLATY LOATH
LOBBY: CANST DROLE POLIO LOGGY LOBBY
LOCAL: CANST ARECA LOCAL
LOCUS: CANST SOUCE HOCUS LOCUS
LODGE: CANST DROLE LODGE
LOFTY: CANST TORTE FOOTY LOFTY
LOGIC: CANST LOCIE LOGIC
LOGIN: CANST IRONE YOGIN LOGIN
LOOPY: CANST DROLE BLOOP LOOPY
LOOSE: CANST SOUSE WORSE POISE MOOSE BOOSE
LORRY: CANST DROLE FUROL LORRY
LOSER: CANST LORES LOSER
LOUSE: CANST SOUSE DOUSE ROUSE YOUSE MOUSE
LOUSY: CANST SOUSE BOUSY LOUSY
LOVER: CANST DROLE LOWER LOVER
LOWER: CANST DROLE LOWER
LOWLY: CANST DROLE LOWLY
LOYAL: CANST AREAL PODAL MOLAL LOYAL
LUCID: CANST LOCIE LUCID
LUCKY: CANST LOCIE LUCKY
LUMEN: CANST IRONE LEBEN LUMEN
LUMPY: CANST DROLE FILMY LUMPY
LUNAR: CANST GENAL ULNAR LUNAR
LUNCH: CANST OUNCE RUNCH BUNCH PUNCH MUNCH
LUNGE: CANST DINGE MENGE LUNGE
LUPUS: CANST LORES LISPS LUPUS
LURCH: CANST LOCIE LURCH
LURID: CANST DROLE LURID
LUSTY: CANST TIRES STULM LUSTY
LYING: CANST IRONE LYING
LYMPH: CANST DROLE FILMY LYMPH
LYNCH: CANST OUNCE GINCH LYNCH
LYRIC: CANST LOCIE LUDIC LYRIC
MACAW: CANST RACHE YACCA MACAW
MACHO: CANST RACHE BACHA MACHI MACHO
MACRO: CANST RACHE MACRO
MADAM: CANST MARLE MAMBA MADAM
MADLY: CANST MARLE MADLY
MAFIA: CANST MARLE MAMBA MAHWA MAFIA
MAGIC: CANST RACHE GAUCY MAGIC
MAGMA: CANST MARLE MAMBA MAGMA
MAIZE: CANST MARLE MAMIE MAIZE
MAJOR: CANST MARLE MAJOR
MAKER: CANST MARLE MAKER
MAMBO: CANST MARLE MAMBA MAMBO
MAMMA: CANST MARLE MAMBA MAMMA
MAMMY: CANST MARLE MAMBA MAMMY
MANGA: CANST KANAE MANGA
MANGE: CANST KANAE RANGE MANGE
MANGO: CANST KANAE GANDY FANGO MANGO
MANGY: CANST KANAE GANDY RANGY MANGY
MANIA: CANST KANAE MANGA MANNA MANIA
MANIC: CANST HANCE PANIC MANIC
MANLY: CANST KANAE GANDY NANNY MANLY
MANOR: CANST KANAE GANDY MANOR
MAPLE: CANST MARLE MAILE MAPLE
MARCH: CANST RACHE PARCH MARCH
MARRY: CANST MARLE MARRA MARRI MARRY
MARSH: CANST SALSE DAISY HARSH MARSH
MASON: CANST NARIS SAMAN MASON
MASSE: CANST SALSE PASSE MASSE
MATCH: CANST TACHO HATCH LATCH BATCH MATCH
MATEY: CANST TALER MATEY
MAUVE: CANST MARLE MAMIE MAYBE MADGE MAUVE
MAXIM: CANST MARLE MAMBA MAXIM
MAYBE: CANST MARLE MAMIE MAYBE
MAYOR: CANST MARLE MAJOR MAYOR
MEALY: CANST AREAL MEALY
MEANT: CANST RIANT ALANT MEANT
MEATY: CANST REATA BEATH PEATY MEATY
MECCA: CANST ARECA MECCA
MEDAL: CANST AREAL MEDAL
MEDIA: CANST AREAL HEADY MEDIA
MEDIC: CANST LOCIE DEMIC MEDIC
MELEE: CANST DROLE GLIME MELEE
MELON: CANST IRONE DEMON MELON
MERCY: CANST LOCIE DRECK MERCH MERCY
MERGE: CANST DROLE RIEVE BERME MERGE
MERIT: CANST RELIT MERIT
MERRY: CANST DROLE REFER PERRY BERRY KERRY
METAL: CANST REATA FETAL PETAL METAL
METER: CANST TORTE PETRI DETER METER
METRO: CANST TORTE RETOX METRO
MICRO: CANST LOCIE MICRO
MIDGE: CANST DROLE GUIDE KIDGE MIDGE
MIDST: CANST REIST DIDST MIDST
MIGHT: CANST RELIT PITOT BIDET KIGHT WIGHT
MILKY: CANST DROLE FILMY MILKY
MIMIC: CANST LOCIE MUCID MIMIC
MINCE: CANST OUNCE FENCE MINCE
MINER: CANST DINGE LINER FINER MINER
MINIM: CANST DINGE PINNY MINIM
MINOR: CANST DINGE PINNY MINIM MINOR
MINTY: CANST TONEY RUNTY MINTY
MINUS: CANST SINED GINKS MINOS MINUS
MIRTH: CANST TORTE YIRTH FIRTH GIRTH BIRTH
MISER: CANST LORES SKIER MISER
MISSY: CANST SOUSE BRISS PISSY HISSY KISSY
MOCHA: CANST ARECA PUCKA MOCHA
MODAL: CANST AREAL PODAL MODAL
MODEL: CANST DROLE MOLED MODEL
MODEM: CANST DROLE POHED MODEM
MOGUL: CANST DROLE POLIO LOGGY MOGUL
MOIST: CANST REIST HOIST ZOIST JOIST MOIST
MOLAR: CANST AREAL POLAR VOLAR BOLAR MOLAR
MOLDY: CANST DROLE GOLDY MOLDY
MONEY: CANST DINGE HONER BONEY MONEY
MONTH: CANST TONEY MONTH
MOODY: CANST DROLE HOODY FOODY BOODY MOODY
MOOSE: CANST SOUSE WORSE POISE MOOSE
MORAL: CANST AREAL ROMAL MORAL
MORON: CANST IRONE BOURN MORON
MORPH: CANST DROLE MORRO MORPH
MOSSY: CANST SOUSE LOSSY BOSSY MOSSY
MOTEL: CANST TORTE MOTEL
MOTIF: CANST TORTE MOLTO MOTHY MOTIF
MOTOR: CANST TORTE MOTOR
MOTTO: CANST TORTE MOTTO
MOULT: CANST RELIT YMOLT MOULT
MOUND: CANST IRONE POWNY FOHNS BOUND MOUND
MOUNT: CANST INEPT BURNT FOUNT MOUNT
MOURN: CANST IRONE BOURN MOURN
MOUSE: CANST SOUSE DOUSE ROUSE YOUSE MOUSE
MOUTH: CANST TORTE FOOTY MOUTH
MOVER: CANST DROLE PORER VOMER MOVER
MOVIE: CANST DROLE BOGIE MOXIE MOVIE
MOWER: CANST DROLE PORER VOMER MOWER
MUCKY: CANST LOCIE DUCHY GUCKY YUCKY MUCKY
MUCUS: CANST SOUCE SCRUM MUCUS
MUDDY: CANST DROLE FUDGY PUDDY BUDDY WUDDY
MULCH: CANST LOCIE GULCH MULCH
MUMMY: CANST DROLE PIGMY MUMMY
MUNCH: CANST OUNCE RUNCH BUNCH PUNCH MUNCH
MURAL: CANST AREAL ROMAL MURAL
MURKY: CANST DROLE MURRY MURKY
MUSHY: CANST LORES HUSKY MUSHY
MUSIC: CANST SOUCE SCRUM MUCKS MUSIC
MUSKY: CANST LORES HUSKY DUSKY MUSKY
MUSTY: CANST TIRES STULM MUSTH MUSTY
MYRRH: CANST DROLE MURRY MYRRH
NADIR: CANST RAVEN NAZIR NADIR
NAIVE: CANST RAVEN NAIVE
NANNY: CANST KANAE GANDY NANNY
NASAL: CANST NARIS NASAL
NASTY: CANST TAINS NASTY
NATAL: CANST OATEN NATTY NATAL
NAVAL: CANST RAVEN NAVAL
NAVEL: CANST RAVEN NAVEW NAVEL
NEEDY: CANST IRONE LEBEN NEEDY
NEIGH: CANST IRONE LEVIN NEIGH
NERDY: CANST IRONE RUNED NERDY
NERVE: CANST IRONE ENURE NERVE
NEVER: CANST IRONE RUNED NEPER NEWER NEVER
NEWER: CANST IRONE RUNED NEPER NEWER
NEWLY: CANST IRONE LEBEN NEWLY
NICER: CANST NICER
NICHE: CANST NICER NICHE
NIECE: CANST NICER NIECE
NIGHT: CANST INEPT GLINT NIGHT
NINJA: CANST GENAL DINNA NINJA
NINNY: CANST DINGE PINNY MINNY NINNY
NINTH: CANST TONEY NINTH
NOBLE: CANST IRONE NOBLE
NOBLY: CANST IRONE NYLON NOBLY
NOISE: CANST NOISY NOISE
NOISY: CANST NOISY
NOMAD: CANST ARGAN NODAL NOMAD
NOOSE: CANST NOISY NOOSE
NORTH: CANST NOTER NORTH
NOSEY: CANST REINS SOKEN NOSEY
NOTCH: CANST ONTIC NOTCH
NOVEL: CANST IRONE DEMON ONELY NOVEL
NUDGE: CANST IRONE NEELE NUDGE
NURSE: CANST NOISY NEESE NURSE
NUTTY: CANST NOTER NUTTY
NYLON: CANST IRONE NYLON
NYMPH: CANST IRONE BUNDT NYMPH
OAKEN: CANST RAVEN WAKEN BAKEN OAKEN
OBESE: CANST SOUSE BROSE OBESE
OCCUR: CANST LOCIE BUCKO OCCUR
OCEAN: CANST PUCAN OCEAN
OCTAL: CANST TRACE OCTAD OCTAL
OCTET: CANST DICOT OCTET
ODDER: CANST DROLE ROPED ODDER
ODDLY: CANST DROLE WOULD ODDLY
OFFAL: CANST AREAL PODAL OFFAL
OFFER: CANST DROLE PORER OMBER OFFER
OFTEN: CANST NOTER OFTEN
OLDEN: CANST IRONE DEMON OLDEN
OLDER: CANST DROLE OLDER
OLIVE: CANST DROLE LOVIE OLIVE
OMBRE: CANST DROLE ROWIE OMBRE
OMEGA: CANST AREAL KEEMA OMEGA
ONION: CANST IRONE YOGIN ONION
ONSET: CANST SUINT ONSET
OPERA: CANST AREAL RUEDA OPERA
OPINE: CANST IRONE OPINE
OPIUM: CANST DROLE GOMBO OPIUM
OPTIC: CANST TRICE LOTIC OPTIC
ORBIT: CANST RELIT BRUIT ORBIT
ORDER: CANST DROLE ORBED ORDER
ORGAN: CANST ARGAN ORGAN
OTHER: CANST TORTE RETOX OTHER
OTTER: CANST TORTE OTTER
OUGHT: CANST RELIT BHOOT OUGHT
OUNCE: CANST OUNCE
OUTDO: CANST TORTE OUTDO
OUTER: CANST TORTE RETOX OFTER OPTER OUTER
OUTGO: CANST TORTE OUTDO OUTGO
OVARY: CANST AREAL MOIRA OVARY
OVATE: CANST REATA PLATE QUATE OVATE
OVERT: CANST RELIT GREET OVERT
OVINE: CANST IRONE OPINE OVINE
OVOID: CANST DROLE HOODY OVOID
OWING: CANST IRONE HOING OPING OWING
OWNER: CANST DINGE HONER OWNER
OXIDE: CANST DROLE PODGE OXIDE
OZONE: CANST IRONE OHONE OZONE
PADDY: CANST MARLE KADAI BADDY PADDY
PAGAN: CANST RAVEN LAGAN PAGAN
PAINT: CANST DAUNT FAINT PAINT
PALER: CANST MARLE WALER BALER PALER
PALSY: CANST SALSE PALSY
PANEL: CANST KANAE MANED GANEF PANEL
PANIC: CANST HANCE PANIC
PANSY: CANST HANSE PANSY
PAPAL: CANST MARLE HALVA GAZAL PAPAL
PAPER: CANST MARLE GAPER PAPER
PARER: CANST MARLE DARER PARER
PARKA: CANST MARLE BARDY PARKA
PARRY: CANST MARLE BARDY PARRY
PARSE: CANST SALSE PARSE
PARTY: CANST TALER YARTA WARTY PARTY
PASTA: CANST TATES HASTY BASTI PASTA
PASTE: CANST TATES HASTE WASTE PASTE
PASTY: CANST TATES HASTY MASTY VASTY PASTY
PATCH: CANST TACHO HATCH LATCH BATCH MATCH
PATIO: CANST TALER MATAI BATIK PATIO
PATSY: CANST TASSE PATSY
PATTY: CANST TALER MATAI BATTY PATTY
PAUSE: CANST SALSE PARSE PAUSE
PAYEE: CANST MARLE BADGE FAKIE PAYEE
PAYER: CANST MARLE GAPER PAYER
PEACE: CANST ARECA PLACE PEACE
PEACH: CANST ARECA PLACE PEACH
PEARL: CANST AREAL PEARL
PECAN: CANST PUCAN PECAN
PEDAL: CANST AREAL MEDAL DEDAL PEDAL
PENAL: CANST GENAL PENAL
PENCE: CANST OUNCE FENCE PENCE
PENNE: CANST DINGE BONNE PENNE
PENNY: CANST DINGE HONER PWNED PENNY
PERCH: CANST LOCIE DRECK MERCH PERCH
PERIL: CANST DROLE LIVER MERIL PERIL
PERKY: CANST DROLE REFER PERKY
PESKY: CANST LORES SPIDE PESKY
PESTO: CANST TIRES STYME PESTO
PETAL: CANST REATA FETAL PETAL
PETTY: CANST TORTE JETTY BETTY PETTY
PHASE: CANST SMASH PHASE
PHONE: CANST IRONE OHONE PHONE
PHONY: CANST IRONE PLONG PHONY
PHOTO: CANST TORTE PLUTO PHOTO
PIANO: CANST ARGAN LIANE PIANI PIANO
PICKY: CANST LOCIE PICKY
PIECE: CANST LOCIE DRICE PIECE
PIETY: CANST TORTE MELTY PIETY
PIGGY: CANST DROLE PIGMY PIGGY
PILOT: CANST RELIT PILOT
PINCH: CANST OUNCE GINCH PINCH
PINEY: CANST DINGE LINER WINEY PINEY
PINKY: CANST DINGE PINNY PINKY
PINTO: CANST TONEY PUNTO PINTO
PIPER: CANST DROLE REFER VIPER PIPER
PIQUE: CANST DROLE PUMIE PIQUE
PITCH: CANST TRICE HITCH PITCH
PITHY: CANST TORTE PITHY
PIVOT: CANST RELIT PITOT PIVOT
PIXEL: CANST DROLE GEMEL PUZEL PIXEL
PIXIE: CANST DROLE PUMIE PYXIE PIXIE
PIZZA: CANST AREAL PODIA PIZZA
PLACE: CANST ARECA PLACE
PLAID: CANST AREAL IDOLA PLAID
PLAIN: CANST ARGAN BLAWN ELAIN PLAIN
PLAIT: CANST ALERT PLAIT
PLANE: CANST ARGAN LIANE FLANE PLANE
PLANK: CANST ARGAN LIANE BLAND FLANK PLANK
PLANT: CANST RIANT ALANT PLANT
PLATE: CANST REATA PLATE
PLAZA: CANST AREAL PALLA PLAYA PLAZA
PLEAD: CANST AREAL FLEAM BLEAK PLEAD
PLEAT: CANST ALERT BLEAT PLEAT
PLIED: CANST DROLE BILED PLIED
PLIER: CANST DROLE LIVER FLIER PLIER
PLUCK: CANST LOCIE GULCH PLUCK
PLUMB: CANST DROLE FILMY PLUMP PLUMB
PLUME: CANST DROLE GLIME FLUME BLUME PLUME
PLUMP: CANST DROLE FILMY PLUMP
PLUNK: CANST IRONE BLUNK PLUNK
PLUSH: CANST SOUSE BRUSH PLUSH
POESY: CANST SOUSE POESY
POINT: CANST INEPT POINT
POISE: CANST SOUSE WORSE POISE
POKER: CANST DROLE PORER POKER
POLAR: CANST AREAL POLAR
POLKA: CANST AREAL IDOLA POLKA
POLYP: CANST DROLE POLIO POLYP
POOCH: CANST LOCIE COMPO POOCH
POPPY: CANST DROLE GOMBO PONZU POPPY
PORCH: CANST LOCIE COMPO PORCH
POSER: CANST LORES SOGER DOSER POSER
POSIT: CANST SPRIT POSIT
POSSE: CANST SOUSE GOSSE FOSSE POSSE
POUCH: CANST LOCIE COMPO PORCH POUCH
POUND: CANST IRONE POWNY POUND
POUTY: CANST TORTE FOOTY POUTY
POWER: CANST DROLE PORER POKER POWER
PRANK: CANST ARGAN DRANK FRANK PRANK
PRAWN: CANST ARGAN DRAIN PRAWN
PREEN: CANST IRONE GREEN PREEN
PRESS: CANST SOUSE DRESS PRESS
PRICE: CANST LOCIE DRICE GRICE PRICE
PRICK: CANST LOCIE WRICK BRICK PRICK
PRIDE: CANST DROLE PRIDE
PRIED: CANST DROLE PRIED
PRIME: CANST DROLE GRIME PRIME
PRIMO: CANST DROLE PRIOR PRIMO
PRINT: CANST INEPT POINT PRINT
PRIOR: CANST DROLE PRIOR
PRISM: CANST SOUSE GIRSH BRISK PRISM
PRIVY: CANST DROLE GRIMY PRIVY
PRIZE: CANST DROLE GRIME FRIZE BRIZE PRIZE
PROBE: CANST DROLE PROKE PRORE PROVE PROBE
PRONE: CANST IRONE DRONE PRONE
PRONG: CANST IRONE PRONG
PROOF: CANST DROLE GROOF PROOF
PROSE: CANST SOUSE BROSE EROSE PROSE
PROUD: CANST DROLE PROUD
PROVE: CANST DROLE PROKE PRORE PROVE
PROWL: CANST DROLE PROWL
PROXY: CANST DROLE GROOF PROXY
PRUDE: CANST DROLE PRIDE PRUDE
PRUNE: CANST IRONE PRUNE
PSALM: CANST REALS SHALM PSALM
PUBIC: CANST LOCIE MUCID PUBIC
PUDGY: CANST DROLE FUDGY JUDGY PUDGY
PUFFY: CANST DROLE PIGMY PUPPY PUFFY
PULPY: CANST DROLE FILMY BULGY HULKY PULPY
PULSE: CANST SOUSE PULSE
PUNCH: CANST OUNCE RUNCH BUNCH PUNCH
PUPAL: CANST AREAL PODAL PIPAL PUPAL
PUPIL: CANST DROLE FILMY PUPIL
PUPPY: CANST DROLE PIGMY PUPPY
PUREE: CANST DROLE RIEVE BERME PUREE
PURER: CANST DROLE REFER HIRER PURER
PURGE: CANST DROLE RIEVE GARRE PURGE
PURSE: CANST SOUSE PULSE PURSE
PUSHY: CANST LORES HUSKY MUSHY PUSHY
PUTTY: CANST TORTE BUTTY PUTTY
PYGMY: CANST DROLE PIGMY PYGMY
QUACK: CANST ARECA LOACH KYACK QUACK
QUAIL: CANST AREAL QUAIL
QUAKE: CANST AREAL HEADY QUAKE
QUALM: CANST AREAL IDOLA QUALM
QUARK: CANST AREAL MOIRA GUARD QUARK
QUART: CANST ALERT QUART
QUASH: CANST SMASH BLASH AWASH QUASH
QUASI: CANST SMASH LEASE BRAST QUASI
QUEEN: CANST IRONE LEBEN QUEEN
QUEER: CANST DROLE REFER EMMER PHEER QUEER
QUELL: CANST DROLE KVELL QUELL
QUERY: CANST DROLE REFER QUERY
QUEST: CANST REIST GOEST EWEST QUEST
QUEUE: CANST DROLE PUMIE FUGUE QUEUE
QUICK: CANST LOCIE WRICK QUICK
QUIET: CANST RELIT ZIBET QUIET
QUILL: CANST DROLE HILLY QUILL
QUILT: CANST RELIT GUILT BUILT QUILT
QUIRK: CANST DROLE MURRY QUIRK
QUITE: CANST TORTE ELITE QUITE
QUOTA: CANST REATA LOTTA BIOTA QUOTA
QUOTE: CANST TORTE FLOTE QUOTE
QUOTH: CANST TORTE PLUTO QUOTH
RABBI: CANST MARLE RAKIA RABBI
RABID: CANST MARLE RAKIA RADIO RAPID RABID
RACER: CANST RACHE RACER
RADAR: CANST MARLE RAKIA RAYAH RADAR
RADII: CANST MARLE RAKIA RADIO RADIX RADII
RADIO: CANST MARLE RAKIA RADIO
RAINY: CANST RAVEN RAINY
RAISE: CANST SALSE PARSE RAISE
RAJAH: CANST MARLE RAKIA RAYAH RAJAH
RALLY: CANST MARLE RALLY
RALPH: CANST MARLE LAVRA RALPH
RAMEN: CANST RAVEN RAMEN
RANCH: CANST HANCE RANCH
RANDY: CANST KANAE GANDY BANDY DANDY RANDY
RANGE: CANST KANAE RANGE
RAPID: CANST MARLE RAKIA RADIO RAPID
RARER: CANST MARLE DARER PARER RARER
RASPY: CANST EARLS SAVOR RASPY
RATIO: CANST TALER YARTA RATIO
RATTY: CANST TALER YARTA RATTY
RAVEN: CANST RAVEN
RAYON: CANST RAVEN RAYON
RAZOR: CANST MARLE RAKIA RAZOO RAZOR
REACH: CANST ARECA REACH
REACT: CANST REACT
READY: CANST AREAL DEARY READY
REALM: CANST AREAL GLARE REALM
REARM: CANST AREAL DEARY PEARE REARM
REBAR: CANST AREAL REBAR
REBEL: CANST DROLE LIVER RUBEL REBEL
REBUS: CANST LORES DEERS SEIRS REPPS REBUS
REBUT: CANST RELIT REMET REPOT REBUT
RECAP: CANST ARECA RECAP
RECUR: CANST LOCIE RUCHE RECUR
RECUT: CANST DICOT FECHT RECUT
REEDY: CANST DROLE REDID REEDY
REFER: CANST DROLE REFER
REFIT: CANST RELIT REMIT REBIT REFIT
REGAL: CANST AREAL REGAL
REHAB: CANST AREAL REBAR REHAB
REIGN: CANST IRONE REPIN REIGN
RELAX: CANST AREAL RELAY RELAX
RELAY: CANST AREAL RELAY
RELIC: CANST LOCIE MELIC RELIC
REMIT: CANST RELIT REMIT
RENAL: CANST GENAL PENAL RENAL
RENEW: CANST DINGE HONER RENEW
REPAY: CANST AREAL REBAR REMAP REPAY
REPEL: CANST DROLE LIVER RUBEL REPEL
REPLY: CANST DROLE REPLY
RERUN: CANST IRONE RUNED RERUN
RESET: CANST SPRIT ROSET RESET
RESIN: CANST REINS RESIN
RETCH: CANST TRICE RETCH
RETRO: CANST TORTE RETOX RETRO
RETRY: CANST TORTE PETRI RETRY
REUSE: CANST SOUSE MEUSE REUSE
REVEL: CANST DROLE LIVER REVEL
REVUE: CANST DROLE RIEVE REVUE
RHINO: CANST IRONE RHINO
RHYME: CANST DROLE RIEVE RHYME
RIDER: CANST DROLE REDID RIDER
RIDGE: CANST DROLE RUDIE RIDGE
RIFLE: CANST DROLE RIFLE
RIGHT: CANST RELIT RIGHT
RIGID: CANST DROLE MURID RIGID
RIGOR: CANST DROLE MORRO RIGOR
RINSE: CANST SENSE RINSE
RIPEN: CANST IRONE REPIN RIPEN
RIPER: CANST DROLE REFER RIPER
RISEN: CANST REINS RISEN
RISER: CANST LORES SKIER MISER RISER
RISKY: CANST LORES SHIRK RISKY
RIVAL: CANST AREAL ROMAL RIYAL RIVAL
RIVER: CANST DROLE REFER RIPER RIMER RIVER
RIVET: CANST RELIT RIVET
ROACH: CANST ARECA ROACH
ROAST: CANST LEAST ROAST
ROBIN: CANST IRONE ROBIN
ROBOT: CANST RELIT ROBOT
ROCKY: CANST LOCIE JOCKO ROCKY
RODEO: CANST DROLE ROPED RODEO
ROGER: CANST DROLE PORER ROGER
ROGUE: CANST DROLE ROWIE ROUGE ROGUE
ROOMY: CANST DROLE ROOKY ROOPY ROOFY ROOMY
ROOST: CANST REIST ROOST
ROTOR: CANST TORTE MOTOR ROTOR
ROUGE: CANST DROLE ROWIE ROUGE
ROUGH: CANST DROLE MORRO ROUPY ROUGH
ROUND: CANST IRONE HORNY ROUND
ROUSE: CANST SOUSE DOUSE ROUSE
ROUTE: CANST TORTE ROUTE
ROVER: CANST DROLE PORER ROGER ROVER
ROWDY: CANST DROLE ROWDY
ROWER: CANST DROLE PORER ROGER ROVER ROKER
ROYAL: CANST AREAL ROMAL RORAL ROYAL
RUDDY: CANST DROLE MURID RUDDY
RUDER: CANST DROLE REDID RUDER
RUGBY: CANST DROLE MURRY RUBBY RUGBY
RULER: CANST DROLE LIVER PULER RULER
RUMBA: CANST AREAL MOIRA RUMBA
RUMOR: CANST DROLE MORRO RUMOR
RUPEE: CANST DROLE RIEVE RUPEE
RURAL: CANST AREAL ROMAL RIYAL RUGAL RURAL
RUSTY: CANST TIRES STORK RUSTY
SADLY: CANST EARLS SADLY
SAFER: CANST EARLS BASER SAWER SAYER SAFER
SAINT: CANST SAINT
SALAD: CANST EARLS VASAL SALAD
SALLY: CANST EARLS SADLY SALLY
SALON: CANST NARIS SAMAN SALON
SALSA: CANST SALSE SALSA
SALTY: CANST TATES HASTY SALTY
SALVE: CANST EARLS SALUE SALVE
SALVO: CANST EARLS VASAL SALVO
SANDY: CANST DANKS SANED SANDY
SANER: CANST DANKS SANGA SANER
SAPPY: CANST EARLS PASHA SAMPI SAPPY
SASSY: CANST SALSE SASSY
SATIN: CANST TAINS SATIN
SATYR: CANST TATES SATYR
SAUCE: CANST SAICK SAUCE
SAUCY: CANST SAICK SAUCE SAUCH SAUCY
SAUNA: CANST NARIS SAMAN SAUNA
SAUTE: CANST TATES HASTE SAUTE
SAVOR: CANST EARLS SAVOR
SAVOY: CANST EARLS PASHA MAYOS SAVOY
SAVVY: CANST EARLS PASHA MAYOS SAGGY SAVVY
SCALD: CANST SCARP SCALD
SCALE: CANST SCARP SCALD SCALY SCALL SCALA
SCALP: CANST SCARP SCALP
SCALY: CANST SCARP SCALD SCALY
SCAMP: CANST SCARP SCALP SCAUP SCAMP
SCANT: CANST SCANT
SCARE: CANST SCARP SCARE
SCARF: CANST SCARP SCARE SCARF
SCARY: CANST SCARP SCARE SCARF SCARY
SCENE: CANST ONCES SCENE
SCENT: CANST SCENT
SCION: CANST ONCES SCION
SCOFF: CANST SOUCE SCOOP SCOLD SCOGS SCOFF
SCOLD: CANST SOUCE SCOOP SCOLD
SCONE: CANST ONCES SCONE
SCOOP: CANST SOUCE SCOOP
SCOPE: CANST SOUCE SCOPE
SCORE: CANST SOUCE SCOPE SCORE
SCORN: CANST ONCES SCION SCORN
SCOUR: CANST SOUCE SCOUR
SCOUT: CANST SOUCT SCOUT
SCOWL: CANST SOUCE SCOOP SCOLD SCOWL
SCRAM: CANST SCARP SCRAW SCRAY SCRAM
SCRAP: CANST SCARP SCRAP
SCREE: CANST SOUCE SYCEE SCREE
SCREW: CANST SOUCE SYCES SCREW
SCRUB: CANST SOUCE SCRUB
SCRUM: CANST SOUCE SCRUB SCRUM
SCUBA: CANST SCARP SCUBA
SEDAN: CANST SLANE SEDAN
SEEDY: CANST LORES SPIDE SEEDY
SEGUE: CANST LORES SPIDE SMEKE SEGUE
SEIZE: CANST LORES SPIDE SHIVE SEIZE
SEMEN: CANST REINS SENVY SEMEN
SENSE: CANST SENSE
SEPIA: CANST REALS SEPAD SEPIA
SERIF: CANST LORES SURGE SERRY SERIF
SERUM: CANST LORES SURGE SERUM
SERVE: CANST LORES SURGE SERVE
SETUP: CANST TIRES STYME SETUP
SEVEN: CANST REINS SENVY SEVEN
SEVER: CANST LORES SKIER SPEER SEXER SEDER
SEWER: CANST LORES SKIER SPEER SEXER SEDER
SHACK: CANST SCARP SHACK
SHADE: CANST REALS SHAME SHAVE SHAKE SHADE
SHADY: CANST REALS SHAMA SHAKO SHADY
SHAFT: CANST SPRAT SHALT SHAFT
SHAKE: CANST REALS SHAME SHAVE SHAKE
SHAKY: CANST REALS SHAMA SHAKO SHAKY
SHALE: CANST REALS SWALE SPALE SHALE
SHALL: CANST REALS SHALM SHALL
SHALT: CANST SPRAT SHALT
SHAME: CANST REALS SHAME
SHANK: CANST SLANE SPANK SWANK SHANK
SHAPE: CANST REALS SHAME SHAVE SHAKE SHADE
SHARD: CANST REALS SPARD SWARD SHARD
SHARE: CANST REALS SOARE SHARE
SHARK: CANST REALS SPARD SWARM SHARK
SHARP: CANST REALS SPARD SHARP
SHAVE: CANST REALS SHAME SHAVE
SHAWL: CANST REALS SPAWL SHAWL
SHEAR: CANST REALS ESKAR SMEAR SWEAR SPEAR
SHEEN: CANST REINS SOKEN SHEEN
SHEEP: CANST LORES SPEED SHEEP
SHEER: CANST LORES SKIER SPEER SHEER
SHEET: CANST SPRIT SMELT SWEET SHEET
SHEIK: CANST LORES SPIDE SMEIK SHEIK
SHELF: CANST LORES SPEIL SKELF SHELF
SHELL: CANST LORES SPEIL SWELL SMELL SKELL
SHIED: CANST LORES SPEED SKIED SHIED
SHIFT: CANST SPRIT SHIFT
SHINE: CANST REINS SPINE SHINE
SHINY: CANST REINS SWINK SLING SPINY SHINY
SHIRE: CANST LORES SPIRE SWIRE SHIRE
SHIRK: CANST LORES SHIRK
SHIRT: CANST SPRIT SKIRT SHIRT
SHOAL: CANST REALS SPIAL SKOAL SHOAL
SHOCK: CANST SOUCE SMOCK SHOCK
SHONE: CANST REINS SHEND SHONE
SHOOK: CANST LORES SMOKO SHOOK
SHOOT: CANST SPRIT SMELT STOUT SHOOT
SHORE: CANST LORES SWORE SPORE SMORE SHORE
SHORN: CANST REINS SWORN SHORN
SHORT: CANST SPRIT SKORT SHORT
SHOUT: CANST SPRIT SMELT STOUT SHOUT
SHOVE: CANST LORES SHOPE SHOVE
SHOWN: CANST REINS SOLON SHOWN
SHOWY: CANST LORES SMOKO SHOWY
SHREW: CANST LORES SERED SHREW
SHRUB: CANST LORES SHRUG SHRUB
SHRUG: CANST LORES SHRUG
SHUCK: CANST SOUCE SHUCK
SHUNT: CANST SUINT SHUNT
SHUSH: CANST SOUSE SLUSH SMUSH SHUSH
SHYLY: CANST LORES SILLY SHYLY
SIEGE: CANST LORES SPIDE SIEGE
SIEVE: CANST LORES SPIDE SIEGE SIEVE
SIGHT: CANST SPRIT SHIFT SIGHT
SIGMA: CANST REALS SIMAS SIGMA
SILKY: CANST LORES SILLY SILKY
SILLY: CANST LORES SILLY
SINCE: CANST CINES SINCE
SINEW: CANST SINED SINEW
SINGE: CANST SINED SINGE
SIREN: CANST REINS SIREN
SISSY: CANST SOUSE SHISH SISSY
SIXTH: CANST TIRES SILTY SIXTH
SIXTY: CANST TIRES SILTY SIXTY
SKATE: CANST TEARS SKATE
SKIER: CANST LORES SKIER
SKIFF: CANST LORES HUSKY SKIFF
SKILL: CANST LORES SILLY SHILL SPILL SKILL
SKIMP: CANST LORES HUSKY SKIFF SKIMP
SKIRT: CANST SPRIT SKIRT
SKULK: CANST LORES SILLY SKULK
SKULL: CANST LORES SILLY SKULL
SKUNK: CANST REINS SLUNK SKUNK
SLACK: CANST SCARP SHACK SWACK SLACK
SLAIN: CANST SLANE SLAIN
SLANG: CANST SLANE SLANK SLANG
SLANT: CANST SLANT
SLASH: CANST SMASH SLASH
SLATE: CANST TEARS SKATE SLATE
SLAVE: CANST REALS SLADE SLAKE SLAVE
SLEEK: CANST LORES SPEEL SLEEK
SLEEP: CANST LORES SPEEL SLEEP
SLEET: CANST SPRIT SMELT SLEET
SLEPT: CANST SPRIT SWEPT STEPT SLEPT
SLICE: CANST SOUCE SLICE
SLICK: CANST SOUCE SPICS SLICK
SLIDE: CANST LORES SPEIL SMILE SLIDE
SLIME: CANST LORES SPEIL SMILE SLIME
SLIMY: CANST LORES SILLY SLIMY
SLING: CANST REINS SWINK SLING
SLINK: CANST REINS SWINK SLINK
SLOOP: CANST LORES SLOOP
SLOPE: CANST LORES SLOPE
SLOSH: CANST SOUSE SKOSH SPOSH SLOSH
SLOTH: CANST TIRES STULM SLOTH
SLUMP: CANST LORES SILLY SLUFF SLUBB SLUMP
SLUNG: CANST REINS SLUNK SLUNG
SLUNK: CANST REINS SLUNK
SLURP: CANST LORES SWIRL SLURB SLURP
SLUSH: CANST SOUSE SLUSH
SLYLY: CANST LORES SILLY SLYLY
SMACK: CANST SCARP SHACK SWACK SLACK SMACK
SMALL: CANST REALS SHALM SMALL
SMART: CANST SPRAT SMART
SMASH: CANST SMASH
SMEAR: CANST REALS ESKAR SMEAR
SMELL: CANST LORES SPEIL SWELL SMELL
SMELT: CANST SPRIT SMELT
SMILE: CANST LORES SPEIL SMILE
SMIRK: CANST LORES SHIRK SMIRK
SMITE: CANST TIRES SPITE SMITE
SMITH: CANST TIRES STIMY SMITH
SMOCK: CANST SOUCE SMOCK
SMOKE: CANST LORES SHOPE SMOKE
SMOKY: CANST LORES SMOKO SMOKY
SMOTE: CANST TIRES STYME SMOTE
SNACK: CANST SCANS SNACK
SNAIL: CANST SLANE SNARL SNAIL
SNAKE: CANST SLANE SNARE SNAKE
SNAKY: CANST SLANE SNARY SNAKY
SNARE: CANST SLANE SNARE
SNARL: CANST SLANE SNARL
SNEAK: CANST SLANE SEDAN SNEAP SNEAK
SNEER: CANST REINS SNORE SNEER
SNIDE: CANST REINS SNIDE
SNIFF: CANST REINS PSION SNIFF
SNIPE: CANST REINS SNIDE SNIPE
SNOOP: CANST REINS SOLON SNOOK SNOOD SNOOP
SNORE: CANST REINS SNORE
SNORT: CANST SUINT SNOOT SNORT
SNOUT: CANST SUINT SNOUT
SNOWY: CANST REINS SOLON SNOWK SNOWY
SNUCK: CANST ONCES SNICK SNUCK
SNUFF: CANST REINS SOLON SNUFF
SOAPY: CANST REALS SHAMA SPADO SOAPY
SOBER: CANST LORES SOGER SOBER
SOGGY: CANST LORES SOPHY SOGGY
SOLAR: CANST REALS SURAL SOLAR
SOLID: CANST LORES SOLID
SOLVE: CANST LORES SOWLE SOLDE SOLVE
SONAR: CANST AUNES SONAR
SONIC: CANST CINES SONIC
SOOTH: CANST TIRES STULM SOOTY SOOTH
SOOTY: CANST TIRES STULM SOOTY
SORRY: CANST LORES SORGO SORRY
SOUND: CANST REINS SLUNK SOUND
SOUTH: CANST TIRES STULM SOUTH
SOWER: CANST LORES SOGER SOBER SOWER
SPACE: CANST SCARP SPACY SPACE
SPADE: CANST REALS SHAME SUAVE SPAKE SPADE
SPANK: CANST SLANE SPANK
SPARE: CANST REALS SOARE SHARE SWARE SPARE
SPARK: CANST REALS SPARD SPARK
SPASM: CANST SMASH SPASM
SPAWN: CANST SLANE SNARY SPAWN
SPEAK: CANST REALS ASKED SPEAK
SPEAR: CANST REALS ESKAR SMEAR SWEAR SPEAR
SPECK: CANST SOUCE SPECS SPECK
SPEED: CANST LORES SPEED
SPELL: CANST LORES SPEIL SPELL
SPELT: CANST SPRIT SPOUT SPELT
SPEND: CANST REINS SHEND SPEND
SPENT: CANST SUINT STENT SPENT
SPERM: CANST LORES SPIRE SPERM
SPICE: CANST SOUCE SLICE SPICE
SPICY: CANST SOUCE SPICS SPICY
SPIED: CANST LORES SPEED SPIED
SPIEL: CANST LORES SPEEL SPIEL
SPIKE: CANST LORES SPIDE SPIKE
SPIKY: CANST LORES HUSKY SPIKY
SPILL: CANST LORES SILLY SHILL SPILL
SPILT: CANST SPRIT SPILT
SPINE: CANST REINS SPINE
SPINY: CANST REINS SWINK SLING SPINY
SPIRE: CANST LORES SPIRE
SPITE: CANST TIRES SPITE
SPLAT: CANST SPRAT SPLAT
SPLIT: CANST SPRIT SPLIT
SPOIL: CANST LORES SLOOP SPOIL
SPOKE: CANST LORES SHOPE SPODE SPOKE
SPOOF: CANST LORES SMOKO SPOOF
SPOOK: CANST LORES SMOKO SHOOK SPOOK
SPOOL: CANST LORES SLOOP SPOOL
SPOON: CANST REINS SOLON SHOON SWOON SPOON
SPORE: CANST LORES SWORE SPORE
SPORT: CANST SPRIT SPORT
SPOUT: CANST SPRIT SPOUT
SPRAY: CANST REALS SURRA SYRAH SPRAY
SPREE: CANST LORES SERED SIREE SPREE
SPRIG: CANST LORES SHRUG SPRIG
SPUNK: CANST REINS SLUNK SKUNK SPUNK
SPURN: CANST REINS SWORN SPURN
SPURT: CANST SPRIT SPORT SPURT
SQUAD: CANST REALS SIMAS SUBAH SQUAW SQUAD
SQUAT: CANST SPRAT STOAT SQUAT
SQUIB: CANST LORES HUSKY BUNDS SQUIB
STACK: CANST SCATH STACK
STAFF: CANST TEARS PLATS STAIG STAFF
STAGE: CANST TEARS SKATE STAGE
STAID: CANST TEARS PLATS STAIG STAID
STAIN: CANST STANE STAUN STARN STAIN
STAIR: CANST TEARS STAIR
STAKE: CANST TEARS SKATE STAKE
STALE: CANST TEARS SKATE STAGE STAVE STADE
STALK: CANST TEARS PLATS STALL STALK
STALL: CANST TEARS PLATS STALL
STAMP: CANST TEARS PLATS STAMP
STAND: CANST STANE STANK STANG STAND
STANK: CANST STANE STANK
STARE: CANST TEARS STARE
STARK: CANST TEARS STARK
START: CANST SPRAT SMART SWART START
STASH: CANST TRASH STASH
STATE: CANST TEARS SKATE SLATE SPATE STATE
STAVE: CANST TEARS SKATE STAGE STAVE
STEAD: CANST TEARS STEAK STEAM STEAL STEAD
STEAK: CANST TEARS STEAK
STEAL: CANST TEARS STEAK STEAM STEAL
STEAM: CANST TEARS STEAK STEAM
STEED: CANST TIRES STEEP STEEL STEEK STEED
STEEL: CANST TIRES STEEP STEEL
STEEP: CANST TIRES STEEP
STEER: CANST TIRES ESTER STEER
STEIN: CANST TEINS STEIN
STERN: CANST TEINS STEEN STERN
STICK: CANST TICES STICH STICK
STIFF: CANST TIRES STIMY STILL STIFF
STILL: CANST TIRES STIMY STILL
STILT: CANST SPRIT SHIFT STILT
STING: CANST TEINS STING
STINK: CANST TEINS STING STINK
STINT: CANST SUINT SKINT STINT
STOCK: CANST TICES STOCK
STOIC: CANST TICES STICH STOIC
STOKE: CANST TIRES STYME STOLE STOKE
STOLE: CANST TIRES STYME STOLE
STOMP: CANST TIRES STULM STOMP
STONE: CANST TEINS STONE
STONY: CANST TEINS STUNG STONY
STOOD: CANST TIRES STULM STOOP STOOK STOOD
STOOL: CANST TIRES STULM STOOL
STOOP: CANST TIRES STULM STOOP
STORE: CANST TIRES STORE
STORK: CANST TIRES STORK
STORM: CANST TIRES STORK STORY STORM
STORY: CANST TIRES STORK STORY
STOUT: CANST SPRIT SMELT STOUT
STOVE: CANST TIRES STYME STOLE STOKE STOPE
STRAP: CANST TEARS STRAW STRAK STRAG STRAY
STRAW: CANST TEARS STRAW
STRAY: CANST TEARS STRAW STRAK STRAG STRAY
STRIP: CANST TIRES STRIG STRIM STRIP
STRUT: CANST SPRIT STRUT
STUCK: CANST TICES STOCK STUCK
STUDY: CANST TIRES STULM STUFF STUDY
STUFF: CANST TIRES STULM STUFF
STUMP: CANST TIRES STULM STUMP
STUNG: CANST TEINS STUNG
STUNK: CANST TEINS STUNG STUNK
STUNT: CANST SUINT SHUNT STUNT
STYLE: CANST TIRES STYME STYTE STYLE
SUAVE: CANST REALS SHAME SUAVE
SUGAR: CANST REALS SURRA SUGAR
SUING: CANST REINS SWINK SLING SUING
SUITE: CANST TIRES SPITE SMITE SKITE SUITE
SULKY: CANST LORES SILLY SULKY
SULLY: CANST LORES SILLY SULLY
SUMAC: CANST SCARP SUMAC
SUNNY: CANST SINED SUNNS SUNNY
SUPER: CANST LORES SKIER SPEER SUPER
SURER: CANST LORES SERED SHREW SURER
SURGE: CANST LORES SURGE
SURLY: CANST LORES SURLY
SUSHI: CANST LORES HUSKY WUSHU SUSHI
SWAMI: CANST REALS SHAMA SWAMP SWAMI
SWAMP: CANST REALS SHAMA SWAMP
SWARM: CANST REALS SPARD SWARM
SWASH: CANST SMASH SLASH SWASH
SWATH: CANST TEARS PLATS SWATH
SWEAR: CANST REALS ESKAR SMEAR SWEAR
SWEAT: CANST SPRAT STOAT SQUAT SWEAT
SWEEP: CANST LORES SPEED SHEEP SWEEP
SWEET: CANST SPRIT SMELT SWEET
SWELL: CANST LORES SPEIL SWELL
SWEPT: CANST SPRIT SWEPT
SWIFT: CANST SPRIT SHIFT SWIFT
SWILL: CANST LORES SILLY SHILL SPILL SKILL
SWINE: CANST REINS SPINE SHINE SWINE
SWING: CANST REINS SWINK SWING
SWIRL: CANST LORES SWIRL
SWISH: CANST SOUSE SHISH SLISH SWISH
SWOON: CANST REINS SOLON SHOON SWOON
SWOOP: CANST LORES SMOKO SPOOF SWOOP
SWORD: CANST LORES SPROD SWORD
SWORE: CANST LORES SWORE
SWORN: CANST REINS SWORN
SWUNG: CANST REINS SLUNK SOUND SWUNG
SYNOD: CANST SINED SYNOD
SYRUP: CANST LORES SHRUG SIRUP SYRUP
TABBY: CANST TALER TAIGA TABOO TABBY
TABLE: CANST TALER TABLE
TABOO: CANST TALER TAIGA TABOO
TACIT: CANST TACET TACIT
TACKY: CANST TACHO TACKY
TAFFY: CANST TALER TAIGA TABOO TAMMY TAFFY
TAINT: CANST DAUNT FAINT PAINT HAINT TAINT
TAKEN: CANST OATEN TAKEN
TAKER: CANST TALER TAPER TAVER TAKER
TALLY: CANST TALER TALAK TALLY
TALON: CANST OATEN TAUON TAXON TALON
TAMER: CANST TALER TAPER TAVER TAKER TAXER
TANGO: CANST TANGY TANGA TANGO
TANGY: CANST TANGY
TAPER: CANST TALER TAPER
TAPIR: CANST TALER TABOR TATAR TAPIR
TARDY: CANST TALER TARDY
TAROT: CANST GAMUT RABAT TAROT
TASTE: CANST TATES TASTE
TASTY: CANST TATES TASTY
TATTY: CANST TALER TAIGA TABOO TAMMY TAFFY
TAUNT: CANST DAUNT HAUNT VAUNT GAUNT TAUNT
TAWNY: CANST OATEN TAWNY
TEACH: CANST TRACE TEACH
TEARY: CANST REATA TEARY
TEASE: CANST TRASH TEASE
TEDDY: CANST TORTE TEWED TEDDY
TEETH: CANST TORTE TEETH
TEMPO: CANST TORTE TELOI TEMPO
TENET: CANST DENET GENET BENET TENET
TENOR: CANST TONEY TENOR
TENSE: CANST TENSE
TENTH: CANST TONEY TENUE TENTH
TEPEE: CANST TORTE TUPLE TEPEE
TEPID: CANST TORTE TEWED TEIID TEPID
TERRA: CANST REATA TERRA
TERSE: CANST TORSE TERSE
TESTY: CANST TIRES TESTY
THANK: CANST TRAIN THANK
THEFT: CANST RELIT MOTET DUETT THEFT
THEIR: CANST TORTE TWIER THEIR
THEME: CANST TORTE TUPLE THEME
THERE: CANST TORTE TRIBE THERE
THESE: CANST TORSE TEMSE THESE
THETA: CANST REATA PIETA THETA
THICK: CANST TRICE THICK
THIEF: CANST TORTE TEWED TUPEK THIEF
THIGH: CANST TORTE THUMP THILL THIGH
THING: CANST NOTER TYING THING
THINK: CANST NOTER TYING THINK
THIRD: CANST TORTE THIRL THIRD
THONG: CANST NOTER THONG
THORN: CANST NOTER THORN
THOSE: CANST TORSE THOSE
THREE: CANST TORTE THREE
THREW: CANST TORTE TIRED THREW
THROB: CANST TORTE TURBO THROB
THROW: CANST TORTE TURBO THROW
THRUM: CANST TORTE THRID THRUM
THUMB: CANST TORTE THUMP THUMB
THUMP: CANST TORTE THUMP
THYME: CANST TORTE TUPLE THEME THYME
TIARA: CANST REATA TIARA
TIBIA: CANST REATA HUTIA TIBIA
TIDAL: CANST REATA DOTAL TIDAL
TIGER: CANST TORTE TWIER TIGER
TIGHT: CANST RELIT PITOT TIGHT
TILDE: CANST TORTE TUPLE TILDE
TIMER: CANST TORTE TWIER TIGER TIMER
TIMID: CANST TORTE THUMP TIMID
TIPSY: CANST TORSE TULSI TIPSY
TITAN: CANST TRAIN TITAN
TITHE: CANST TORTE TITHE
TITLE: CANST TORTE TITHE TITLE
TOAST: CANST LEAST ROAST BOAST HOAST TOAST
TODAY: CANST REATA DOTAL TODAY
TODDY: CANST TORTE TOUZY TOFFY TODDY
TOKEN: CANST NOTER TOKEN
TONAL: CANST MENTA TONAL
TONGA: CANST MENTA TONGA
TONIC: CANST TUNIC TONIC
TOOTH: CANST TORTE TOOTH
TOPAZ: CANST REATA DOTAL TOPAZ
TOPIC: CANST TRICE TOXIC TOPIC
TORCH: CANST TRICE TORCH
TORSO: CANST TORSE TORSK TORSO
TORUS: CANST TIRES TORRS TORTS TOROS TORUS
TOTAL: CANST REATA DOTAL TOTAL
TOTEM: CANST TORTE TOTEM
TOUCH: CANST TRICE TOUCH
TOUGH: CANST TORTE TOUZY TOUGH
TOWEL: CANST TORTE TOWEL
TOWER: CANST TORTE TOWER
TOXIC: CANST TRICE TOXIC
TOXIN: CANST NOTER TOWNY TOXIN
TRACE: CANST TRACE
TRACK: CANST TRACE TRACK
TRACT: CANST REACT FRACT BRACT TRACT
TRADE: CANST REATA TRAPE TRAVE TRADE
TRAIL: CANST REATA TRAIL
TRAIN: CANST TRAIN
TRAIT: CANST ALERT PRATT TRAIT
TRAMP: CANST REATA TRAIL TRAMP
TRASH: CANST TRASH
TRAWL: CANST REATA TRAIL TRAWL
TREAD: CANST REATA ARTEL TREAD
TREAT: CANST ALERT GREAT TREAT
TREND: CANST NOTER TRINE TREND
TRIAD: CANST REATA TROAD TRIAD
TRIAL: CANST REATA TROAD TRIAL
TRIBE: CANST TORTE TRIBE
TRICE: CANST TRICE
TRICK: CANST TRICE TRICK
TRIED: CANST TORTE TWIER TRIED
TRIPE: CANST TORTE TRIBE TRIKE TRIPE
TRITE: CANST TORTE TRITE
TROLL: CANST TORTE TROOP TROLL
TROOP: CANST TORTE TROOP
TROPE: CANST TORTE TRODE TROVE TROPE
TROUT: CANST RELIT POORT TROUT
TROVE: CANST TORTE TRODE TROVE
TRUCE: CANST TRICE TRUCE
TRUCK: CANST TRICE TROCK TRUCK
TRUER: CANST TORTE TWIER TUYER TRUER
TRULY: CANST TORTE THIRL TRULY
TRUMP: CANST TORTE THIRL TRUMP
TRUNK: CANST NOTER TRUNK
TRUSS: CANST TORSE TRUSS
TRUST: CANST REIST BRUST FRUST TRUST
TRUTH: CANST TORTE TRUTH
TRYST: CANST REIST BRUST PROST TRYST
TUBAL: CANST REATA DOTAL TUBAL
TUBER: CANST TORTE TWIER TUYER TUBER
TULIP: CANST TORTE THUMP TULIP
TULLE: CANST TORTE TUPLE TULLE
TUMOR: CANST TORTE TROOP TUMOR
TUNIC: CANST TUNIC
TURBO: CANST TORTE TURBO
TUTOR: CANST TORTE TUTOR
TWANG: CANST TRAIN THANK TWANG
TWEAK: CANST REATA TOGAE TWEAK
TWEED: CANST TORTE TEWED TWEED
TWEET: CANST RELIT MOTET TWEET
TWICE: CANST TRICE TWICE
TWINE: CANST NOTER THINE TWINE
TWIRL: CANST TORTE THIRL TWIRL
TWIST: CANST REIST HOIST BUIST TWIST
TWIXT: CANST RELIT PITOT TWIXT
TYING: CANST NOTER TYING
UDDER: CANST DROLE REDID UDDER
ULCER: CANST LOCIE EXCEL ULCER
ULTRA: CANST REATA TUGRA ULTRA
UMBRA: CANST AREAL MOIRA UMBRA
UNCLE: CANST NICER UNCLE
UNCUT: CANST UNCUT
UNDER: CANST IRONE RUNED UNDER
UNDID: CANST IRONE LUPIN UNBID UNKID UNDID
UNDUE: CANST IRONE NEELE UNDUE
UNFED: CANST IRONE LEBEN UNWED UNFED
UNFIT: CANST INEPT UNLIT UNWIT UNFIT
UNIFY: CANST IRONE LUPIN UNIFY
UNION: CANST IRONE YOGIN ONION UNION
UNITE: CANST NOTER THINE UNITE
UNITY: CANST NOTER TYING UNITY
UNLIT: CANST INEPT UNLIT
UNMET: CANST INEPT KNELT UNMET
UNSET: CANST SUINT UNSET
UNTIE: CANST NOTER UNTIE
UNTIL: CANST NOTER UNTIN UNTIL
UNWED: CANST IRONE LEBEN UNWED
UNZIP: CANST IRONE LUPIN UNHIP UNZIP
UPPER: CANST DROLE REFER VIPER HYPER UPPER
UPSET: CANST SPRIT UPSET
URBAN: CANST ARGAN URBAN
URINE: CANST IRONE URINE
USAGE: CANST REALS SHAME USAGE
USHER: CANST LORES SKIER MUSER USHER
USING: CANST REINS SWINK USING
USUAL: CANST REALS SPIAL USUAL
USURP: CANST LORES SHIRK USURY USURP
UTILE: CANST TORTE LITHE UTILE
UTTER: CANST TORTE UTTER
VAGUE: CANST MARLE BADGE GAUZE VAGUE
VALET: CANST GAMUT RABAT VALET
VALID: CANST MARLE HALVA VALID
VALOR: CANST MARLE LAVRA VALOR
VALUE: CANST MARLE HALVE VALUE
VALVE: CANST MARLE HALVE VALVE
VAPID: CANST MARLE KADAI VAPID
VAPOR: CANST MARLE RAKIA VAPOR
VAULT: CANST GAMUT HAULT DAULT VAULT
VAUNT: CANST DAUNT HAUNT VAUNT
VEGAN: CANST ARGAN LIGAN BEGAN VEGAN
VENOM: CANST DINGE HONER XENON VENOM
VENUE: CANST DINGE BONNE VENUE
VERGE: CANST DROLE RIEVE VERGE
VERSE: CANST SOUSE PRESE VERSE
VERSO: CANST SOUSE VERSO
VERVE: CANST DROLE RIEVE KERVE VERVE
VICAR: CANST ARECA VICAR
VIDEO: CANST DROLE POHED VIDEO
VIGIL: CANST DROLE FILMY PIKUL VIGIL
VIGOR: CANST DROLE MORRO VIGOR
VILLA: CANST AREAL IDOLA VILLA
VINYL: CANST DINGE PINNY VINYL
VIOLA: CANST AREAL IDOLA VIOLA
VIPER: CANST DROLE REFER VIPER
VIRAL: CANST AREAL ROMAL JURAL GYRAL VIRAL
VIRUS: CANST LORES BIRDS MIRKS GIRRS VIRUS
VISIT: CANST SPRIT BESIT VISIT
VISOR: CANST LORES SPROD VISOR
VISTA: CANST TEARS STOAI VISTA
VITAL: CANST REATA DOTAL VITAL
VIVID: CANST DROLE FUDGY VIVID
VIXEN: CANST IRONE LEVIN VIXEN
VOCAL: CANST ARECA LOCAL FOCAL VOCAL
VODKA: CANST AREAL PODIA HODJA VODKA
VOGUE: CANST DROLE BOGIE POGGE YOGEE VOGUE
VOICE: CANST LOCIE VOICE
VOILA: CANST AREAL IDOLA VOILA
VOMIT: CANST RELIT OOBIT VOMIT
VOTER: CANST TORTE DOTER VOTER
VOUCH: CANST LOCIE COMPO GOUCH VOUCH
VOWEL: CANST DROLE HOLEY VOXEL VOWEL
VYING: CANST IRONE LYING VYING
WACKY: CANST RACHE YACCA JACKY WACKY
WAFER: CANST MARLE GAPER WAKER WAVER WAXER
WAGER: CANST MARLE GAPER EAGER WAGER
WAGON: CANST RAVEN LAGAN WAGON
WAIST: CANST MAIST WAIST
WAIVE: CANST MARLE BADGE FAKIE WAIVE
WALTZ: CANST TALER WALTY WALTZ
WARTY: CANST TALER YARTA WARTY
WASTE: CANST TATES HASTE WASTE
WATCH: CANST TACHO HATCH LATCH BATCH MATCH
WATER: CANST TALER GATER PATER WATER
WAVER: CANST MARLE GAPER WAKER WAVER
WAXEN: CANST RAVEN WAKEN WAXEN
WEARY: CANST AREAL DEARY WEARY
WEAVE: CANST AREAL HEADY PEAZE WEAVE
WEDGE: CANST DROLE GUIDE WEDGE
WEEDY: CANST DROLE EIKED WEEDY
WEIGH: CANST DROLE BEGEM WEIGH
WEIRD: CANST DROLE REDID WEIRD
WELCH: CANST LOCIE FELCH WELCH
WELSH: CANST SOUSE WELSH
WENCH: CANST OUNCE WENCH
WHACK: CANST ARECA LOACH WHACK
WHALE: CANST AREAL MEALY DWALE WHALE
WHARF: CANST AREAL MOIRA GUARD WHARF
WHEAT: CANST ALERT EXEAT WHEAT
WHEEL: CANST DROLE GEMEL WHEEL
WHELP: CANST DROLE KVELL WHELM WHELP
WHERE: CANST DROLE RIEVE WHERE
WHICH: CANST LOCIE WRICK WHICH
WHIFF: CANST DROLE PIGMY QUIFF WHIFF
WHILE: CANST DROLE UMBLE EXILE WHILE
WHINE: CANST IRONE DWINE WHINE
WHINY: CANST IRONE LYING WHINY
WHIRL: CANST DROLE LURRY WHIRL
WHISK: CANST SOUSE GIRSH WHISK
WHITE: CANST TORTE ELITE QUITE WHITE
WHOLE: CANST DROLE OBOLE WHOLE
WHOOP: CANST DROLE GOOPY WHOOP
WHOSE: CANST SOUSE BROSE WHOSE
WIDEN: CANST IRONE LEVIN MIZEN WIDEN
WIDER: CANST DROLE REDID WIDER
WIDOW: CANST DROLE IODID WIDOW
WIDTH: CANST TORTE MILTY WIDTH
WIELD: CANST DROLE FIELD YIELD WIELD
WIGHT: CANST RELIT PITOT BIDET KIGHT WIGHT
WILLY: CANST DROLE HILLY FILLY BILLY WILLY
WIMPY: CANST DROLE PIGMY JIMPY WIMPY
WINCE: CANST OUNCE FENCE MINCE YINCE WINCE
WINCH: CANST OUNCE GINCH PINCH FINCH WINCH
WINDY: CANST DINGE KINDY WINDY
WISER: CANST LORES SKIER MISER RISER WISER
WISPY: CANST LORES HUSKY WISPY
WITCH: CANST TRICE HITCH PITCH BITCH WITCH
WITTY: CANST TORTE BUTTY DITTY KITTY WITTY
WOKEN: CANST IRONE DEMON HOVEN WOXEN WOKEN
WOMAN: CANST ARGAN KULAN DEWAN WOMAN
WOMEN: CANST IRONE DEMON NOMEN WOMEN
WOODY: CANST DROLE HOODY FOODY BOODY MOODY
WOOER: CANST DROLE WOOER
WOOLY: CANST DROLE MOOLI GOOLY HOOLY WOOLY
WOOZY: CANST DROLE GOOPY BOOKY WOOFY WOOZY
WORDY: CANST DROLE ROWDY WORDY
WORLD: CANST DROLE WORLD
WORRY: CANST DROLE MORRO WORRY
WORSE: CANST SOUSE WORSE
WORST: CANST REIST BRUST WORST
WORTH: CANST TORTE FORTY WORTH
WOULD: CANST DROLE WOULD
WOUND: CANST IRONE POWNY WOUND
WOVEN: CANST IRONE DEMON HOVEN WOVEN
WRACK: CANST ARECA ORACH DRACK BRACK FRACK
WRATH: CANST REATA PRATY FRATI WRATH
WREAK: CANST AREAL BREAD FREAK WREAK
WRECK: CANST LOCIE DRECK WRECK
WREST: CANST REIST PREST DREST WREST
WRING: CANST IRONE BRING WRING
WRIST: CANST REIST FRIST TRIST GRIST WRIST
WRITE: CANST TORTE WRITE
WRONG: CANST IRONE PRONG WRONG
WROTE: CANST TORTE WROTE
WRUNG: CANST IRONE DRUNK WRUNG
WRYLY: CANST DROLE GRILL WRYLY
YACHT: CANST TACET YACHT
YEARN: CANST ARGAN YEARN
YEAST: CANST LEAST BEAST FEAST REAST HEAST
YIELD: CANST DROLE FIELD YIELD
YOUNG: CANST IRONE POWNY YOUNG
YOUTH: CANST TORTE FOOTY YOUTH
ZEBRA: CANST AREAL DEARY HEJRA VERRA ZEBRA
ZESTY: CANST TIRES STYME ZESTY
ZONAL: CANST GENAL VINAL ZONAL
Success: 2251
Fail: 64
Avg guess: 4.060
