ABACK: CLAST BRACE ABACK
ABASE: CLAST SMASH PEASE UKASE ABASE
ABATE: CLAST GRATE AMATE ABATE
ABBEY: CLAST MARAE ABUNE ABBEY
ABBOT: CLAST ARIOT ABBOT
ABHOR: CLAST MARAE ADORN ARBOR ABHOR
ABIDE: CLAST MARAE AZINE ABIDE
ABLED: CLAST PALEA ABLED
ABODE: CLAST MARAE AZINE ABODE
ABORT: CLAST ARIOT APORT ABORT
ABOUT: CLAST ARIOT ADBOT ABOUT
ABOVE: CLAST MARAE AZINE ABODE ABOVE
ABUSE: CLAST RASSE AVISE AMUSE ABUSE
ABYSS: CLAST RASSE ABYSS
ACORN: CLAST NACRE ACORN
ACRID: CLAST NACRE ACHAR ACRID
ACTOR: CLAST TACAN ARTIC ACTOR
ACUTE: CLAST TACAN ARTIC ACUTE
ADAGE: CLAST DEARN MAAED ADAGE
ADAPT: CLAST TRANT ABAFT AWAIT ADAPT
ADEPT: CLAST ARIOT ANGST ADEPT
ADMIN: CLAST MARAE AMONG ADMIN
ADMIT: CLAST ARIOT AMBIT ADMIT
ADOBE: CLAST MARAE AZINE ABODE ADOBE
ADOPT: CLAST ARIOT ADBOT ADOPT
ADORE: CLAST MARAE AREDE ADORE
ADORN: CLAST MARAE ADORN
ADULT: CLAST GALUT ADULT
AFFIX: CLAST MARAE GONIA AFFIX
AFIRE: CLAST MARAE AREDE AFORE AFIRE
AFOOT: CLAST ARIOT ABBOT AFOOT
AFOUL: CLAST PALEA LORAN AIOLI AFOUL
AFTER: CLAST TATER APTER AFTER
AGAIN: CLAST DEARN GNAWN AGAIN
AGAPE: CLAST DEARN AGAZE AGAVE AGAPE
AGATE: CLAST GRATE AGATE
AGENT: CLAST ARIOT ANGST AGENT
AGILE: CLAST PALEA GLEAN AGILE
AGING: CLAST MARAE GONIA AXING AHING AWING
AGLOW: CLAST PALEA ONLAY AGLOW
AGONY: CLAST MARAE GONIA AGONY
AGORA: CLAST MARAE AROBA AGORA
AGREE: CLAST MARAE AYRIE AGREE
AHEAD: CLAST MARAE AHEAD
AIDER: CLAST MARAE URENA AIDER
AISLE: CLAST SALLE AISLE
ALARM: CLAST FLANE ALARM
ALBUM: CLAST ILEAL ALMUG ALBUM
ALERT: CLAST PLOAT ALERT
ALGAE: CLAST ILEAL GLEAN ALGAE
ALIBI: CLAST ILEAL ALGIN ALIBI
ALIEN: CLAST ILEAL ALIKE ALIEN
ALIGN: CLAST ILEAL ALGIN ALIGN
ALIKE: CLAST ILEAL ALIKE
ALIVE: CLAST ILEAL ALIKE ALINE ALIVE
ALLAY: CLAST ILEAL ALLAY
ALLEY: CLAST ILEAL ALLEY
ALLOT: CLAST PLOAT ALLOT
ALLOW: CLAST ILEAL ALLOW
ALLOY: CLAST ILEAL ALLOW ALLOY
ALOFT: CLAST PLOAT ALOFT
ALONE: CLAST ILEAL ALDER ALONE
ALONG: CLAST ILEAL ALMUG ALONG
ALOOF: CLAST ILEAL ALMUG ALOHA ALOOF
ALOUD: CLAST ILEAL ALMUG ALOUD
ALPHA: CLAST ILEAL ALMUG ALOHA ALPHA
ALTAR: CLAST ALTER ALTAR
ALTER: CLAST ALTER
AMASS: CLAST SMASH AMASS
AMAZE: CLAST DEARN AGAZE AMAZE
AMBER: CLAST MARAE AIMER AMEER AMBER
AMBLE: CLAST PALEA GLEAN MAILE AMBLE
AMEND: CLAST MARAE EDEMA AMEND
AMISS: CLAST RASSE ABYSS AMISS
AMITY: CLAST TATER DIOTA AGUTI AMITY
AMONG: CLAST MARAE AMONG
AMPLE: CLAST PALEA AMPLE
AMPLY: CLAST PALEA AMPLY
AMUSE: CLAST RASSE AVISE AMUSE
ANGEL: CLAST PALEA WALER ANGEL
ANGER: CLAST MARAE URENA ANKER ANGER
ANGLE: CLAST PALEA GLEAN ANGLE
ANGRY: CLAST MARAE ADORN ANGRY
ANGST: CLAST SAIST ADUST ANGST
ANIME: CLAST MARAE AMINE ANIME
ANKLE: CLAST PALEA GLEAN ANOLE ANKLE
ANNEX: CLAST MARAE ABUNE AWNED ANNEX
ANNOY: CLAST MARAE GONIA ANNOY
ANNUL: CLAST PALEA LORAN ANVIL ANNUL
ANODE: CLAST MARAE AZINE ANODE
ANTIC: CLAST TACAN ANTIC
ANVIL: CLAST PALEA LORAN ANVIL
AORTA: CLAST TATER KURTA AORTA
APART: CLAST TRANT PEART APART
APHID: CLAST MARAE GONIA AFFIX APHID
APING: CLAST MARAE GONIA AXING AHING AWING
APNEA: CLAST MARAE APNEA
APPLE: CLAST PALEA AMPLE APPLE
APPLY: CLAST PALEA AMPLY APPLY
APRON: CLAST MARAE DORBA ARROZ APRON
APTLY: CLAST TALEA DOTAL APTLY
ARBOR: CLAST MARAE ADORN ARBOR
ARDOR: CLAST MARAE ADORN ARDOR
ARENA: CLAST MARAE AREPA ARENA
ARGUE: CLAST MARAE AREDE ARUHE ARGUE
ARISE: CLAST RASSE AROSE ARISE
ARMOR: CLAST MARAE ARMOR
AROMA: CLAST MARAE AROMA
AROSE: CLAST RASSE AROSE
ARRAY: CLAST MARAE ARRAY
ARROW: CLAST MARAE DORBA ARROZ ARROW
ARSON: CLAST NARES SONAR ARSON
ARTSY: CLAST TASSE ANTSY ARTSY
ASCOT: CLAST SCEAT ASCOT
ASHEN: CLAST NARES ASPEN ASHEN
ASIDE: CLAST NARES SEPAD ASIDE
ASKEW: CLAST NARES ASKED ASKEW
ASSAY: CLAST NARES SIMAS ASSAY
ASSET: CLAST RESAT ASSET
ATOLL: CLAST TALEA DOTAL ATOLL
ATONE: CLAST TATER ATONE
ATTIC: CLAST TACAN ARTIC ATTIC
AUDIO: CLAST MARAE GONIA AXOID AUDIO
AUDIT: CLAST ARIOT AMBIT AUDIT
AUGUR: CLAST MARAE ADORN AUGUR
AUNTY: CLAST TATER DIOTA AUNTY
AVAIL: CLAST LEARY DUALS AVAIL
AVERT: CLAST ARIOT AVERT
AVIAN: CLAST MARAE NAIAD AVIAN
AVOID: CLAST MARAE GONIA AXOID AVOID
AWAIT: CLAST TRANT ABAFT AWAIT
AWAKE: CLAST DEARN AGAZE AWAKE
AWARD: CLAST DEARN HOARD IZARD GUARD AWARD
AWARE: CLAST DEARN WHARE AWARE
AWASH: CLAST SMASH ABASH AWASH
AWFUL: CLAST PALEA LORAN HALID AWFUL
AWOKE: CLAST MARAE AZINE ABODE AWOKE
AXIAL: CLAST PALEA ARGAL ANNAL AXIAL
AXIOM: CLAST MARAE AMONG ABMHO AXIOM
AXION: CLAST MARAE GONIA AVION ANION AXION
AZURE: CLAST MARAE AREDE AFORE AZURE
BACON: CLAST NACRE BACON
BADGE: CLAST MARAE DAINE WADGE FADGE GADGE
BADLY: CLAST PALEA LARDY BADLY
BAGEL: CLAST PALEA LAVER BABEL BAGEL
BAGGY: CLAST MARAE GANDY BAGGY
BAKER: CLAST MARAE GAPER WAKER RAKER JAKER
BALER: CLAST PALEA WALER BALER
BALMY: CLAST PALEA BALDY BALLY BALMY
BANAL: CLAST PALEA NAHAL BANAL
BANJO: CLAST MARAE GANDY KANJI BANJO
BARGE: CLAST MARAE GARBE BARGE
BARON: CLAST MARAE BARDY BARON
BASAL: CLAST SALLE LAIKS NASAL VASAL BASAL
BASIC: CLAST RACES SAUCY BASIC
BASIL: CLAST SALLE LAIKS BASIL
BASIN: CLAST NARES BASON BASIN
BASIS: CLAST NARES MAIKS SADIS BASIS
BASTE: CLAST TATES HASTE PASTE WASTE BASTE
BATCH: CLAST TACAN PATCH WATCH HATCH RATCH
BATHE: CLAST TATER BATHE
BATON: CLAST TATER MATAI BATON
BATTY: CLAST TATER BATTY
BAWDY: CLAST MARAE GANDY WADDY BAWDY
BAYOU: CLAST MARAE GANDY YAPOK BAYOU
BEACH: CLAST BRACE BEACH
BEADY: CLAST DEARN BEADY
BEARD: CLAST DEARN HEARD YEARD BEARD
BEAST: CLAST REAST FEAST BEAST
BEECH: CLAST YINCE PERCE BEECH
BEEFY: CLAST RONDE BEGEM BEEFY
BEFIT: CLAST REBIT BEFIT
BEGAN: CLAST MARAE BEGAD BEGAN
BEGAT: CLAST ARIOT GAUNT BEGAT
BEGET: CLAST REBIT BENET BEGET
BEGIN: CLAST RONDE HEMIN PEKIN BEGIN
BEGUN: CLAST RONDE HEMIN EEVEN BEGUN
BEING: CLAST RONDE HEMIN VEINY BEING
BELCH: CLAST LOCIE WELCH BELCH
BELIE: CLAST OILED KYLIE RELIE BELIE
BELLE: CLAST OILED BULGE BELLE
BELLY: CLAST OILED BULGE BELLY
BELOW: CLAST OILED PELON BELOW
BENCH: CLAST YINCE BENCH
BERET: CLAST REBIT BERET
BERRY: CLAST RONDE FERER BERRY
BERTH: CLAST TORTE BERTH
BESET: CLAST SUINT ROSET BESET
BETEL: CLAST TOILE LEFTY BETEL
BEVEL: CLAST OILED REBEL BEZEL BEVEL
BEZEL: CLAST OILED REBEL BEZEL
BIBLE: CLAST OILED RIELS BIBLE
BICEP: CLAST YINCE DICER BICEP
BIDDY: CLAST RONDE DIDDY GIDDY WIDDY BIDDY
BIGOT: CLAST REBIT BIGHT BIGOT
BILGE: CLAST OILED RILLE BILGE
BILLY: CLAST OILED FILMY GILLY BILLY
BINGE: CLAST RONDE GENIE MINGE WINGE HINGE
BINGO: CLAST RONDE PINGO JINGO BINGO
BIOME: CLAST RONDE EXOME BIOME
BIRCH: CLAST YINCE BIRCH
BIRTH: CLAST TORTE YIRTH GIRTH MIRTH BIRTH
BISON: CLAST DORES HYSON VISON BISON
BITTY: CLAST TORTE BUTTY BITTY
BLACK: CLAST PLACK BLACK
BLADE: CLAST FLANE GLAZE BLADE
BLAME: CLAST FLANE GLAZE BLADE BLAME
BLAND: CLAST FLANE KLANG ALAND BLAND
BLANK: CLAST FLANE KLANG PLANK BLANK
BLARE: CLAST FLANE GLAZE BLADE BLAME BLARE
BLAST: CLAST BLAST
BLAZE: CLAST FLANE GLAZE BLAZE
BLEAK: CLAST ILEAL GLEAM BLEAR BLEAK
BLEAT: CLAST PLOAT BLEAT
BLEED: CLAST GLOBE BLEED
BLEEP: CLAST GLOBE BLEED BLEEP
BLEND: CLAST GLOBE BLEED BLEND
BLESS: CLAST SLUSE BLESS
BLIMP: CLAST GLOBE BLINY BLIMP
BLIND: CLAST GLOBE BLINY BLIND
BLINK: CLAST GLOBE BLINY BLIND BLINI BLINK
BLISS: CLAST SLUSE FLOSS BLISS
BLITZ: CLAST FLITE BLITZ
BLOAT: CLAST PLOAT BLOAT
BLOCK: CLAST OLEIC BLOCK
BLOKE: CLAST GLOBE BLOKE
BLOND: CLAST GLOBE BLOOD BLOND
BLOOD: CLAST GLOBE BLOOD
BLOOM: CLAST GLOBE BLOOD BLOOP BLOOK BLOOM
BLOWN: CLAST GLOBE BLOOD BLOWN
BLUER: CLAST GLOBE BLEED BLUER
BLUFF: CLAST GLOBE BLINY BLUFF
BLUNT: CLAST GLENT FLINT BLUNT
BLURB: CLAST GLOBE BLINY BLUFF BLURB
BLURT: CLAST GLENT FLIRT BLURT
BLUSH: CLAST SLUSE BLUSH
BOARD: CLAST DEARN HOARD BOARD
BOAST: CLAST REAST HOAST BOAST
BOBBY: CLAST RONDE GOMBO BOBBY
BONEY: CLAST RONDE HONEY MONEY BONEY
BONGO: CLAST RONDE BONGO
BONUS: CLAST DORES GOONS YONKS NONIS BONUS
BOOBY: CLAST RONDE GOMBO BOOBY
BOOST: CLAST REIST MOUST BOOST
BOOTH: CLAST TORTE BOOTY BOOTH
BOOTY: CLAST TORTE BOOTY
BOOZE: CLAST RONDE BOGIE BOOZE
BOOZY: CLAST RONDE GOMBO BOOZY
BORAX: CLAST MARAE PYRAN BORAK BORAX
BORNE: CLAST RONDE BORNE
BOSOM: CLAST DORES SOUPY BOSOM
BOSSY: CLAST SOUSE MOSSO BOSSY
BOTCH: CLAST TRICE KOTCH BOTCH
BOUGH: CLAST RONDE GOMBO BOGGY BOUGH
BOULE: CLAST OILED BOGLE BOULE
BOUND: CLAST RONDE WOUND MOUND FOUND POUND
BOWEL: CLAST OILED LOVER HOLEY BOWEL
BOXER: CLAST RONDE MOWER POKER GOFER BORER
BRACE: CLAST BRACE
BRAID: CLAST DEARN BRAID
BRAIN: CLAST DEARN BRAWN BRAIN
BRAKE: CLAST DEARN GRAME BRAVE BRAZE BRAKE
BRAND: CLAST DEARN BRAND
BRASH: CLAST SMASH ABASH BRASH
BRASS: CLAST SMASH GRASS FRASS BRASS
BRAVE: CLAST DEARN GRAME BRAVE
BRAVO: CLAST DEARN BRAAI BRAKY BRAVO
BRAWL: CLAST LEARY DRAIL GRAAL BRAWL
BRAWN: CLAST DEARN BRAWN
BREAD: CLAST MARAE DEBAR BREAD
BREAK: CLAST MARAE DEBAR BREAK
BREED: CLAST RONDE DRIER URPED BREED
BRIAR: CLAST MARAE BROAD BRIAR
BRIBE: CLAST RONDE GERBE BRIBE
BRICK: CLAST YINCE WRICK PRICK BRICK
BRIDE: CLAST RONDE PRIDE GRIDE BRIDE
BRIEF: CLAST RONDE FERER BRIEF
BRINE: CLAST RONDE URINE BRINE
BRING: CLAST RONDE BRUIN BRINK BRING
BRINK: CLAST RONDE BRUIN BRINK
BRINY: CLAST RONDE BRUIN BRINK BRING BRINY
BRISK: CLAST SOUSE BRISK
BROAD: CLAST MARAE BROAD
BROIL: CLAST OILED ROILY BROIL
BROKE: CLAST RONDE PROBE BROME BROKE
BROOD: CLAST RONDE DROOK BROOD
BROOK: CLAST RONDE GROOM PROOF BROOK
BROOM: CLAST RONDE GROOM BROOM
BROTH: CLAST TORTE WROTH FROTH BROTH
BROWN: CLAST RONDE PRION FROWN GROWN BROWN
BRUNT: CLAST REBIT BRUNT
BRUSH: CLAST SOUSE BRUSH
BRUTE: CLAST TORTE WRITE BRUTE
BUDDY: CLAST RONDE DIDDY WUDDY PUDDY BUDDY
BUDGE: CLAST RONDE MIDGE JUDGE BUDGE
BUGGY: CLAST RONDE PIGMY VUGHY FUGGY BUGGY
BUGLE: CLAST OILED GERLE BUGLE
BUILD: CLAST OILED BUILD
BUILT: CLAST GILET BUILT
BULGE: CLAST OILED BULGE
BULKY: CLAST OILED GULPH BULLY BULKY
BULLY: CLAST OILED GULPH BULLY
BUNCH: CLAST YINCE BUNCH
BUNNY: CLAST RONDE GUNNY BUNNY
BURLY: CLAST OILED RUMLY BURLY
BURNT: CLAST REBIT BRUNT BURNT
BURST: CLAST REIST BURST
BUSED: CLAST DORES SIPED FUSED MUSED BUSED
BUSHY: CLAST DORES SPUNK HUMUS GUSHY BUSHY
BUTCH: CLAST TRICE KOTCH MUTCH HUTCH BUTCH
BUTTE: CLAST TORTE BITTE BUTTE
BUXOM: CLAST RONDE HIMBO BUXOM
BUYER: CLAST RONDE FERER VIPER HUGER BUYER
BYLAW: CLAST PALEA ONLAY MYLAR BYLAW
CABAL: CLAST CAPLE CALIX CABAL
CABBY: CLAST CARED CAPON CACKY CABBY
CABIN: CLAST CARED CAPON CAMAN CABIN
CABLE: CLAST CAPLE CABLE
CACAO: CLAST CARED CAPON CACAO
CACHE: CLAST CARED CANOE CAVIE CACHE
CACTI: CLAST COTTA CANTY CACTI
CADDY: CLAST CARED CADDY
CADET: CLAST CARET CADET
CAGEY: CLAST CARED CAGEY
CAIRN: CLAST CARED CAURI CAIRN
CAMEL: CLAST CAPLE CAMEL
CAMEO: CLAST CARED CAGEY CAMEO
CANAL: CLAST CAPLE CALIX CABAL CANAL
CANDY: CLAST CARED CADDY CANDY
CANNY: CLAST CARED CAPON CANNY
CANOE: CLAST CARED CANOE
CANON: CLAST CARED CAPON CANON
CAPER: CLAST CARED CAVER CAPER
CAPUT: CLAST CARET CAPOT CAPUT
CARAT: CLAST CARET CARAT
CARGO: CLAST CARED CARBO CARGO
CAROL: CLAST CAPLE CALIX CABAL CAROL
CARRY: CLAST CARED CARBO CARVY CARRY
CARVE: CLAST CARED CARVE
CASTE: CLAST CASTE
CATCH: CLAST COTTA CATER CATCH
CATER: CLAST COTTA CATER
CATTY: CLAST COTTA CATTY
CAULK: CLAST CAPLE CAULD CAULK
CAUSE: CLAST CAUSE
CAVIL: CLAST CAPLE CALIX CAVIL
CEASE: CLAST CHASE CEASE
CEDAR: CLAST CARED CEDAR
CELLO: CLAST CELLO
CHAFE: CLAST CHARE CHAVE CHACE CHAFE
CHAFF: CLAST CHARE CHANK CHADO CHAFF
CHAIN: CLAST CHARE CHANK CHAIN
CHAIR: CLAST CHARE CHAIR
CHALK: CLAST COALA CHALK
CHAMP: CLAST CHARE CHANK CHADO CHAFF CHAMP
CHANT: CLAST CHAPT CHANT
CHAOS: CLAST CRAYS CHAVS CHAOS
CHARD: CLAST CHARE CHARK CHARA CHARR CHARY
CHARM: CLAST CHARE CHARK CHARA CHARR CHARY
CHART: CLAST CHAPT CHANT CHAFT CHART
CHASE: CLAST CHASE
CHASM: CLAST CHASE CHASM
CHEAP: CLAST CARED COXAE CHEAP
CHEAT: CLAST CARET CHEAT
CHECK: CLAST CRONE CEDED CHEWY CHECK
CHEEK: CLAST CRONE CEDED CHEEK
CHEER: CLAST CRONE CERED CHEER
CHESS: CLAST CORSE CHESS
CHEST: CLAST CROST CHEST
CHICK: CLAST CRONE CIVIC CHICK
CHIDE: CLAST CRONE CIVIE CHIDE
CHIEF: CLAST CRONE CEDED CUMEC CHIEF
CHILD: CLAST CELLO CHILI CHILD
CHILI: CLAST CELLO CHILI
CHILL: CLAST CELLO CHILL
CHIME: CLAST CRONE CIVIE CHIDE CHIME
CHINA: CLAST CARED CHINA
CHIRP: CLAST CRONE CHURR CHIRM CHIRP
CHOCK: CLAST CRONE CHOKO CHOWK CHOCK
CHOIR: CLAST CRONE CHOIR
CHOKE: CLAST CRONE CHODE CHOKE
CHORD: CLAST CRONE CHOIR CHORD
CHORE: CLAST CRONE CHORE
CHOSE: CLAST CORSE CHOSE
CHUCK: CLAST CRONE CIVIC CHUCK
CHUMP: CLAST CRONE CIVIC CUPID CHUMP
CHUNK: CLAST CRONE CUING CHUNK
CHURN: CLAST CRONE CHURN
CHUTE: CLAST CHUTE
CIDER: CLAST CRONE CERED CYDER CIDER
CIGAR: CLAST CARED CREAM CIGAR
CINCH: CLAST CRONE CYNIC CINCH
CIRCA: CLAST CARED CORIA CIRCA
CIVIC: CLAST CRONE CIVIC
CIVIL: CLAST CELLO CHURL CIVIL
CLACK: CLAST CLAME CLANK CLACK
CLAIM: CLAST CLAME CLAIM
CLAMP: CLAST CLAME CLAMP
CLANG: CLAST CLAME CLANK CLANG
CLANK: CLAST CLAME CLANK
CLASH: CLAST CLASH
CLASP: CLAST CLASH CLASP
CLASS: CLAST CLASH CLASP CLASS
CLEAN: CLAST CLEAN
CLEAR: CLAST CLEAN CLEAR
CLEAT: CLAST CLEAT
CLEFT: CLAST CLIFT CLEFT
CLERK: CLAST CLINE CLERK
CLICK: CLAST CLINE CLIFF CLIMB CLICK
CLIFF: CLAST CLINE CLIFF
CLIMB: CLAST CLINE CLIFF CLIMB
CLING: CLAST CLINE CLING
CLINK: CLAST CLINE CLING CLINK
CLOAK: CLAST CLEAN CLOAK
CLOCK: CLAST CLINE CLUMP CLOFF CLOCK
CLONE: CLAST CLINE CLONE
CLOSE: CLAST CLOSE
CLOTH: CLAST CLOTE CLOTH
CLOUD: CLAST CLINE CLUMP CLOUD
CLOUT: CLAST CLIFT CLOUT
CLOVE: CLAST CLINE CLOYE CLOKE CLOZE CLOVE
CLOWN: CLAST CLINE CLOWN
CLUCK: CLAST CLINE CLUMP CLUCK
CLUED: CLAST CLINE CLERK CLUED
CLUMP: CLAST CLINE CLUMP
CLUNG: CLAST CLINE CLUNK CLUNG
COACH: CLAST CHARE COACH
COAST: CLAST COAST
COBRA: CLAST CARED CREAM COPRA COBRA
COCOA: CLAST CARED CHINA COCOA
COLON: CLAST CELLO COLON
COLOR: CLAST CELLO COLON COLOR
COMET: CLAST CROUT COVET COMET
COMFY: CLAST CRONE CHIMO COMBY COMFY
COMIC: CLAST CRONE CHIMO COMIC
COMMA: CLAST CARED CHINA COCOA COMMA
CONCH: CLAST CRONE COGON CONCH
CONDO: CLAST CRONE COGON CONVO CONDO
CONIC: CLAST CRONE COGON CONCH CONIC
COPSE: CLAST CORSE COPSE
CORAL: CLAST CAPLE CRAWL CORAL
CORER: CLAST CRONE COREY CORER
CORNY: CLAST CRONE CORNU CORNO CORNY
COUCH: CLAST CRONE CHIMO COUGH COUCH
COUGH: CLAST CRONE CHIMO COUGH
COULD: CLAST CELLO COYLY COULD
COUNT: CLAST CROUT COUNT
COUPE: CLAST CRONE COGUE COUDE COUPE
COURT: CLAST CROUT COURT
COVEN: CLAST CRONE CONED COVEN
COVER: CLAST CRONE COREY COVER
COVET: CLAST CROUT COVET
COVEY: CLAST CRONE CODEX COVEY
COWER: CLAST CRONE COREY COVER COWER
COYLY: CLAST CELLO COYLY
CRACK: CLAST CHARE CRAIC CRACK
CRAFT: CLAST CHAPT COACT CRAFT
CRAMP: CLAST CHARE CRAIC CRAPY CRAMP
CRANE: CLAST CHARE CRAPE CRAZE CRAVE CRAKE
CRANK: CLAST CHARE CRAIC CRAPY CRANK
CRASH: CLAST CHASE CRASH
CRASS: CLAST CHASE CRASS
CRATE: CLAST COATE CRATE
CRAVE: CLAST CHARE CRAPE CRAZE CRAVE
CRAWL: CLAST COALA CRAWL
CRAZE: CLAST CHARE CRAPE CRAZE
CRAZY: CLAST CHARE CRAIC CRAPY CRAZY
CREAK: CLAST CARED CREAM CREAK
CREAM: CLAST CARED CREAM
CREDO: CLAST CRONE CREDO
CREED: CLAST CRONE CREPY CREEK CREED
CREEK: CLAST CRONE CREPY CREEK
CREEP: CLAST CRONE CREPY CREEP
CREME: CLAST CRONE CREPE CREME
CREPE: CLAST CRONE CREPE
CREPT: CLAST CROUT CREPT
CRESS: CLAST CORSE CRESS
CREST: CLAST CROST CREST
CRICK: CLAST CRONE CRUMP CRICK
CRIED: CLAST CRONE CREPY CRIER CRIED
CRIER: CLAST CRONE CREPY CRIER
CRIME: CLAST CRONE CREPE CRUVE CRIME
CRIMP: CLAST CRONE CRUMP CRIMP
CRISP: CLAST CORSE CRUSY CRISP
CROAK: CLAST CARED CREAM CROAK
CROCK: CLAST CRONE CROCK
CRONE: CLAST CRONE
CRONY: CLAST CRONE CRONK CRONY
CROOK: CLAST CRONE CROCK CROOK
CROSS: CLAST CORSE CROSS
CROUP: CLAST CRONE CROCK CROMB CROWD CROUP
CROWD: CLAST CRONE CROCK CROMB CROWD
CROWN: CLAST CRONE CROWN
CRUDE: CLAST CRONE CREPE CRUVE CRUDE
CRUEL: CLAST CELLO CRUEL
CRUMB: CLAST CRONE CRUMP CRUMB
CRUMP: CLAST CRONE CRUMP
CRUSH: CLAST CORSE CRUSY CRUSH
CRUST: CLAST CROST CREST CRUST
CRYPT: CLAST CROUT CREPT CRYPT
CUBIC: CLAST CRONE CIVIC CUBIC
CUMIN: CLAST CRONE CYNIC CUMIN
CURIO: CLAST CRONE CORBY CURIO
CURLY: CLAST CELLO CHILI CURLY
CURRY: CLAST CRONE CHURR CURRY
CURSE: CLAST CORSE CURSE
CURVE: CLAST CRONE CURIE CURVE
CURVY: CLAST CRONE CHURR CURVY
CUTIE: CLAST CHUTE CUTIE
CYBER: CLAST CRONE CERED CYBER
CYCLE: CLAST CELLO CHILE CYCLE
CYNIC: CLAST CRONE CYNIC
DADDY: CLAST MARAE GANDY WADDY BADDY DADDY
DAILY: CLAST PALEA LARDY BADLY DAILY
DAIRY: CLAST MARAE RANID DAIRY
DAISY: CLAST RASSE PAYSD DAISY
DALLY: CLAST PALEA BALDY DALLY
DANCE: CLAST NACRE PANCE DANCE
DANDY: CLAST MARAE GANDY DANDY
DATUM: CLAST TATER MATAI DATUM
DAUNT: CLAST ARIOT GAUNT DAUNT
DEALT: CLAST LEANT DEALT
DEATH: CLAST GRATE MEATY DEATH
DEBAR: CLAST MARAE DEBAR
DEBIT: CLAST REBIT DEBIT
DEBUG: CLAST RONDE DEIFY DEWED DEGUM DEBUG
DEBUT: CLAST REBIT DEBUT
DECAL: CLAST LACED DECAL
DECAY: CLAST NACRE DECAY
DECOR: CLAST YINCE OCHER DECOR
DECOY: CLAST YINCE DECOY
DECRY: CLAST YINCE DECOY DECRY
DEFER: CLAST RONDE DRIER DUPER DEFER
DEIGN: CLAST RONDE INDEW PIEND DEIGN
DEITY: CLAST TORTE DEPTH DEITY
DELAY: CLAST PALEA BELAR DELAY
DELTA: CLAST TALEA PELTA DELTA
DELVE: CLAST OILED DALLE DELVE
DEMON: CLAST RONDE DEMON
DEMUR: CLAST RONDE DRIER DEBUR DEMUR
DENIM: CLAST RONDE DENIM
DENSE: CLAST SOUSE PRESE DENSE
DEPOT: CLAST REBIT DEMPT DEPOT
DEPTH: CLAST TORTE DEPTH
DERBY: CLAST RONDE DRIER DERBY
DETER: CLAST TORTE RETEM PETER DETER
DETOX: CLAST TORTE BETON DETOX
DEUCE: CLAST YINCE RECCE PEECE DEUCE
DEVIL: CLAST OILED DEVIL
DIARY: CLAST DEARN DIARY
DICEY: CLAST YINCE RICEY DICEY
DIGIT: CLAST REBIT INWIT DIXIT DIGIT
DILLY: CLAST OILED DILLY
DIMLY: CLAST OILED LINDY DIMLY
DINER: CLAST RONDE URNED DINER
DINGO: CLAST RONDE DUNNO DINGO
DINGY: CLAST RONDE DUNGY DINGY
DIODE: CLAST RONDE EXODE DIODE
DIRGE: CLAST RONDE URDEE DIRKE DIRGE
DIRTY: CLAST TORTE YIRTH DIRTY
DISCO: CLAST SOUCE DISCO
DITCH: CLAST TRICE BITCH PITCH HITCH FITCH
DITTO: CLAST TORTE DITTO
DITTY: CLAST TORTE BUTTY KITTY NITTY DITTY
DIVER: CLAST RONDE DRIER DIVER
DIZZY: CLAST RONDE DIPPY DIVVY DIZZY
DODGE: CLAST RONDE WODGE DODGE
DODGY: CLAST RONDE DOODY DODGY
DOGMA: CLAST MARAE AMONG DOGMA
DOING: CLAST RONDE WOUND DOING
DOLLY: CLAST OILED MOLDY DOLLY
DONOR: CLAST RONDE DONOR
DONUT: CLAST REBIT FOUNT DONUT
DOPEY: CLAST RONDE POHED DOPEY
DOUBT: CLAST REBIT BUTUT DOUBT
DOUGH: CLAST RONDE DOODY DOUGH
DOWDY: CLAST RONDE DOWDY
DOWEL: CLAST OILED MODEL DOWEL
DOWNY: CLAST RONDE WOUND DOWNY
DOWRY: CLAST RONDE DOBRO DOWRY
DOZEN: CLAST RONDE DOYEN DOZEN
DRAFT: CLAST TRANT KRAFT GRAFT DRAFT
DRAIN: CLAST DEARN DRAIN
DRAKE: CLAST DEARN DRAPE DRAKE
DRAMA: CLAST DEARN DRAFF DRAMA
DRANK: CLAST DEARN DRANK
DRAPE: CLAST DEARN DRAPE
DRAWL: CLAST LEARY DRAIL DRAWL
DRAWN: CLAST DEARN DRAIN DRAWN
DREAD: CLAST MARAE DEBAR DREAD
DREAM: CLAST MARAE BREAM DREAM
DRESS: CLAST SOUSE PRESS DRESS
DRIED: CLAST RONDE DRIER DRIED
DRIER: CLAST RONDE DRIER
DRIFT: CLAST REBIT GRIPT DRIFT
DRILL: CLAST OILED DRILL
DRINK: CLAST RONDE GRUND DRINK
DRIVE: CLAST RONDE URDEE DRIVE
DROIT: CLAST REBIT FRUIT DROIT
DROLL: CLAST OILED DROOL DROLL
DRONE: CLAST RONDE DRONE
DROOL: CLAST OILED DROOL
DROOP: CLAST RONDE DROOK DROOP
DROSS: CLAST SOUSE GROSS PROSS DROSS
DROVE: CLAST RONDE DROME DROVE
DROWN: CLAST RONDE BROND DROWN
DRUID: CLAST RONDE MUDIR DRUID
DRUNK: CLAST RONDE GRUND DRUNK
DRYER: CLAST RONDE DRIER DRYER
DRYLY: CLAST OILED DRYLY
DUCHY: CLAST YINCE GUCKY DUCHY
DULLY: CLAST OILED DULLY
DUMMY: CLAST RONDE DIPPY DUMKY DUMMY
DUMPY: CLAST RONDE DIPPY DUMPY
DUNCE: CLAST YINCE PONCE HENCE DUNCE
DUSKY: CLAST DORES DISHY DUSKY
DUSTY: CLAST TIRES STONY BUSTY FUSTY GUSTY
DUTCH: CLAST TRICE KOTCH MUTCH HUTCH BUTCH
DUVET: CLAST REBIT UNMET FOUET DUVET
DWARF: CLAST DEARN DIARY DWARF
DWELL: CLAST OILED MEDLE DWELL
DWELT: CLAST GILET DWELT
DYING: CLAST RONDE UNDUG DYING
EAGER: CLAST MARAE GAPER EAGER
EAGLE: CLAST PALEA EARLY EAGLE
EARLY: CLAST PALEA EARLY
EARTH: CLAST TATER EARTH
EASEL: CLAST SALLE LASED EASEL
EATEN: CLAST TATER PATED EATEN
EATER: CLAST TATER WATER EATER
EBONY: CLAST RONDE ENVOY EBONY
ECLAT: CLAST LACET ECLAT
EDICT: CLAST DICOT EDICT
EDIFY: CLAST RONDE DEIFY EDIFY
EERIE: CLAST RONDE GERBE KERVE HERYE EERIE
EGRET: CLAST REBIT GREET EGRET
EIGHT: CLAST REBIT PIERT EIGHT
EJECT: CLAST DICOT EJECT
EKING: CLAST RONDE HEMIN EYING EKING
ELATE: CLAST ELATE
ELBOW: CLAST GLOBE ELBOW
ELDER: CLAST GLOBE FLEER ELDER
ELECT: CLAST ELECT
ELEGY: CLAST GLOBE KLIEG ELEGY
ELFIN: CLAST GLOBE FLEER ELFIN
ELIDE: CLAST GLOBE FLUME ELIDE
ELITE: CLAST FLITE BLITE ELITE
ELOPE: CLAST GLOBE PLOYE ELOPE
ELUDE: CLAST GLOBE FLUME ELUDE
EMAIL: CLAST LEARY DWALE EMAIL
EMBED: CLAST RONDE DEIFY UMPED EMBED
EMBER: CLAST RONDE FERER EMBER
EMCEE: CLAST YINCE BECKE EMCEE
EMPTY: CLAST TORTE DEPTH EMPTY
ENACT: CLAST REACT EPACT ENACT
ENDOW: CLAST RONDE DEMON ENDOW
ENEMA: CLAST MARAE EDEMA ENEMA
ENEMY: CLAST RONDE HEMIN ENEMY
ENJOY: CLAST RONDE ENVOY ENJOY
ENNUI: CLAST RONDE PENNY ENNUI
ENSUE: CLAST DORES SEINE ENSUE
ENTER: CLAST TORTE RETEM ENTER
ENTRY: CLAST TORTE RETEM ENTRY
ENVOY: CLAST RONDE ENVOY
EPOCH: CLAST YINCE PERCE EPOCH
EPOXY: CLAST RONDE EMBOG EPOXY
EQUAL: CLAST PALEA GLEAN FEMAL EQUAL
EQUIP: CLAST RONDE BEGEM VIEWY EQUIP
ERASE: CLAST SMASH PEASE ERASE
ERECT: CLAST DICOT EJECT ERECT
ERODE: CLAST RONDE ERODE
ERROR: CLAST RONDE BEVOR EPHOR ERROR
ERUPT: CLAST REBIT GREET ERUPT
ESSAY: CLAST NARES SEPAD ESSAY
ESTER: CLAST TIRES STEER ESTER
ETHER: CLAST TORTE RETEM ETHER
ETHIC: CLAST TRICE METIC ETHIC
ETHOS: CLAST TIRES NESTS ETHOS
ETUDE: CLAST TORTE HYTHE ETWEE ETUDE
EVADE: CLAST DEARN MAAED EVADE
EVENT: CLAST REBIT UNMET EVENT
EVERY: CLAST RONDE FERER EMERY EVERY
EVICT: CLAST DICOT EVICT
EVOKE: CLAST RONDE EXOME EVOKE
EXACT: CLAST REACT EPACT ENACT EXACT
EXALT: CLAST LEANT EXALT
EXCEL: CLAST LOCIE EXCEL
EXERT: CLAST REBIT GREET EXERT
EXILE: CLAST OILED ERVIL EXILE
EXIST: CLAST REIST EXIST
EXPEL: CLAST OILED REBEL KNEEL EXPEL
EXTOL: CLAST TOILE METOL EXTOL
EXTRA: CLAST TATER EXTRA
EXULT: CLAST GILET DWELT EXULT
EYING: CLAST RONDE HEMIN EYING
FABLE: CLAST PALEA EARLY HABLE FABLE
FACET: CLAST TACET FACET
FAINT: CLAST ARIOT TAINT HAINT DAINT PAINT
FAIRY: CLAST MARAE RANID BARFI FAIRY
FAITH: CLAST TATER BANTY HAITH FAITH
FALSE: CLAST LYSSA FLASH FALSE
FANCY: CLAST NACRE GANCH DANCY FANCY
FANNY: CLAST MARAE GANDY JANNY FANNY
FARCE: CLAST NACRE FARCE
FATAL: CLAST TALEA RATAL KATAL DATAL NATAL
FATTY: CLAST TATER BATTY PATTY NATTY FATTY
FAULT: CLAST GALUT FAULT
FAUNA: CLAST MARAE KANGA NAPPA FAUNA
FAVOR: CLAST MARAE RANID PAYOR FAVOR
FEAST: CLAST REAST FEAST
FECAL: CLAST LACED RECAL FECAL
FEIGN: CLAST RONDE HEMIN FEIGN
FELLA: CLAST PALEA BELGA FELLA
FELON: CLAST OILED PELON BELON MELON FELON
FEMME: CLAST RONDE PUMIE FEMME
FEMUR: CLAST RONDE FERER FEMUR
FENCE: CLAST YINCE PONCE HENCE FENCE
FERAL: CLAST PALEA GLEAN FEMAL FERAL
FERRY: CLAST RONDE FERER FERRY
FETAL: CLAST TALEA FETAL
FETCH: CLAST TRICE KETCH VETCH FETCH
FETID: CLAST TORTE DEMIT FETID
FETUS: CLAST TIRES NESTS HETHS FETUS
FEVER: CLAST RONDE FERER FEYER FEVER
FEWER: CLAST RONDE FERER FEYER FEVER FEWER
FIBER: CLAST RONDE FERER FIVER FIBER
FIBRE: CLAST RONDE GERBE UMBRE FIBRE
FICUS: CLAST SOUCE FUCUS FICUS
FIELD: CLAST OILED WIELD BIELD YIELD FIELD
FIEND: CLAST RONDE INDEW PIEND FIEND
FIERY: CLAST RONDE FERER FIERY
FIFTH: CLAST TORTE MINTY FIFTH
FIFTY: CLAST TORTE MINTY FIFTY
FIGHT: CLAST REBIT PINOT MIDST HIGHT FIGHT
FILER: CLAST OILED PILER VILER MILER FILER
FILET: CLAST GILET FILET
FILLY: CLAST OILED FILMY FILLY
FILMY: CLAST OILED FILMY
FILTH: CLAST TOILE MILTY FILTH
FINAL: CLAST PALEA LORAN NIVAL FINAL
FINCH: CLAST YINCE GINCH FINCH
FINER: CLAST RONDE INNER FINER
FIRST: CLAST REIST FIRST
FISHY: CLAST DORES SPUNK FISHY
FIXER: CLAST RONDE FERER FIVER FIBER FIXER
FIZZY: CLAST RONDE PIGMY FIZZY
FJORD: CLAST RONDE DROOK FIORD FJORD
FLACK: CLAST PLACK BLACK FLACK
FLAIL: CLAST FLANE FLAMY FLAIL
FLAIR: CLAST FLANE FLAMY FLAIL FLAIR
FLAKE: CLAST FLANE FLAME FLARE FLAKE
FLAKY: CLAST FLANE FLAMY FLAKY
FLAME: CLAST FLANE FLAME
FLANK: CLAST FLANE FLANK
FLARE: CLAST FLANE FLAME FLARE
FLASH: CLAST SLASH PLASH FLASH
FLASK: CLAST SLASH PLASM BLASE FLASK
FLECK: CLAST OLEIC BLECH FLECK
FLEET: CLAST GLENT FLEET
FLESH: CLAST SLUSE PLESH FLESH
FLICK: CLAST OLEIC KLICK FLICK
FLIER: CLAST GLOBE FLEER FLIER
FLING: CLAST GLOBE PLING FLING
FLINT: CLAST GLENT FLINT
FLIRT: CLAST GLENT FLIRT
FLOAT: CLAST PLOAT BLOAT FLOAT
FLOCK: CLAST OLEIC BLOCK FLOCK
FLOOD: CLAST GLOBE FLOOR FLOOD
FLOOR: CLAST GLOBE FLOOR
FLORA: CLAST ILEAL ALMUG FLORA
FLOSS: CLAST SLUSE FLOSS
FLOUR: CLAST GLOBE FLOOR FLOUR
FLOUT: CLAST GLENT FLIRT FLUYT FLOUT
FLOWN: CLAST GLOBE FLOOR FLOWN
FLUFF: CLAST GLOBE PLINK FLUFF
FLUID: CLAST GLOBE PLINK FLUID
FLUKE: CLAST GLOBE FLUME FLUKE
FLUME: CLAST GLOBE FLUME
FLUNG: CLAST GLOBE PLING FLUNG
FLUNK: CLAST GLOBE PLINK FLUNK
FLUSH: CLAST SLUSE BLUSH FLUSH
FLUTE: CLAST FLITE FLUTE
FLYER: CLAST GLOBE FLEER FLIER FLYER
FOAMY: CLAST DEARN AGAMI FOAMY
FOCAL: CLAST LACED VOCAL FOCAL
FOCUS: CLAST SOUCE DOCUS FOCUS
FOGGY: CLAST RONDE GOMBO FOGGY
FOIST: CLAST REIST HOIST FOIST
FOLIO: CLAST OILED FOLIO
FOLLY: CLAST OILED POLLY HOLLY GOLLY FOLLY
FORAY: CLAST MARAE PYRAN YDRAD FORAY
FORCE: CLAST YINCE RECCE FORCE
FORGE: CLAST RONDE FORME FORZE FORGE
FORGO: CLAST RONDE MOORY FORGO
FORTE: CLAST TORTE FORTE
FORTH: CLAST TORTE FORTY FORTH
FORTY: CLAST TORTE FORTY
FORUM: CLAST RONDE MOORY FORUM
FOUND: CLAST RONDE WOUND MOUND FOUND
FOYER: CLAST RONDE MOWER POKER GOFER FOYER
FRAIL: CLAST LEARY DRAIL FRAIL
FRAME: CLAST DEARN GRAME ARAME BRAME FRAME
FRANK: CLAST DEARN KRANG PRANK FRANK
FRAUD: CLAST DEARN BRAID FRAUD
FREAK: CLAST MARAE DEBAR WREAK FREAK
FREED: CLAST RONDE DRIER URPED BREED FREED
FREER: CLAST RONDE FERER FREER
FRESH: CLAST SOUSE MENSH FRESH
FRIAR: CLAST MARAE BROAD FRIAR
FRIED: CLAST RONDE DRIER WRIED FRIED
FRILL: CLAST OILED GRILL PRILL BRILL KRILL
FRISK: CLAST SOUSE BRISK FRISK
FRITZ: CLAST TORTE BRITH FRITZ
FROCK: CLAST YINCE POOCH FROCK
FROND: CLAST RONDE BROND FROND
FRONT: CLAST REBIT PRUNT FRONT
FROST: CLAST REIST BURST FROST
FROTH: CLAST TORTE WROTH FROTH
FROWN: CLAST RONDE PRION FROWN
FROZE: CLAST RONDE PROBE FROZE
FRUIT: CLAST REBIT FRUIT
FUDGE: CLAST RONDE MIDGE JUDGE BUDGE FUDGE
FUGUE: CLAST RONDE PUMIE FUZEE FUGUE
FULLY: CLAST OILED GULPH BULLY FULLY
FUNGI: CLAST RONDE GUNNY FUNGI
FUNKY: CLAST RONDE GUNNY HUNKY FUNKY
FUNNY: CLAST RONDE GUNNY BUNNY FUNNY
FUROR: CLAST RONDE GROOM FUROR
FURRY: CLAST RONDE GRIMY FURRY
FUSSY: CLAST SOUSE GUSSY WUSSY PUSSY FUSSY
FUZZY: CLAST RONDE PIGMY FLYBY FUFFY FUZZY
GAFFE: CLAST MARAE DAINE GAUJE GAFFE
GAILY: CLAST PALEA LARDY GAILY
GAMER: CLAST MARAE RAMEN GAMER
GAMMA: CLAST MARAE HAMBA GAMMA
GAMUT: CLAST ARIOT GAUNT GAMUT
GASSY: CLAST RASSE MASSY SASSY GASSY
GAUDY: CLAST MARAE GANDY GAUDY
GAUGE: CLAST MARAE DAINE GAUJE GAUGE
GAUNT: CLAST ARIOT GAUNT
GAUZE: CLAST MARAE DAINE GAUJE GAUGE GAUZE
GAVEL: CLAST PALEA LAVER JAVEL NAVEL GAVEL
GAWKY: CLAST MARAE GANDY GAUZY GAPPY GAWKY
GAYER: CLAST MARAE GAPER GAZER GAGER GAYER
GAYLY: CLAST PALEA LARDY GAILY GAYLY
GAZER: CLAST MARAE GAPER GAZER
GECKO: CLAST YINCE OCHER DECKO GECKO
GEEKY: CLAST RONDE BEGEM GEEKY
GEESE: CLAST SOUSE PRESE FEESE NEESE GEESE
GENIE: CLAST RONDE GENIE
GENRE: CLAST RONDE GENRE
GHOST: CLAST REIST MOUST GHOST
GHOUL: CLAST OILED WOOLY GHOUL
GIANT: CLAST TRANT HIANT GIANT
GIDDY: CLAST RONDE DIDDY GIDDY
GIPSY: CLAST SOUSE BRISK MIMSY GIPSY
GIRLY: CLAST OILED LINGY BIGLY GIRLY
GIRTH: CLAST TORTE YIRTH GIRTH
GIVEN: CLAST RONDE HEMIN VIXEN GIVEN
GIVER: CLAST RONDE FERER VIPER WIVER HIVER
GLADE: CLAST FLANE GLAZE GLARE GLADE
GLAND: CLAST FLANE KLANG GLAND
GLARE: CLAST FLANE GLAZE GLARE
GLASS: CLAST SLASH GLASS
GLAZE: CLAST FLANE GLAZE
GLEAM: CLAST ILEAL GLEAM
GLEAN: CLAST ILEAL GLEAM GLEAN
GLIDE: CLAST GLOBE GLIME GLIKE GLIDE
GLINT: CLAST GLENT GLINT
GLOAT: CLAST PLOAT BLOAT FLOAT GLOAT
GLOBE: CLAST GLOBE
GLOOM: CLAST GLOBE GLOOM
GLORY: CLAST GLOBE GLOOM GLORY
GLOSS: CLAST SLUSE FLOSS GLOSS
GLOVE: CLAST GLOBE GLOZE GLODE GLOVE
GLYPH: CLAST GLOBE GLYPH
GNASH: CLAST SMASH ABASH GNASH
GNOME: CLAST RONDE PHONE KNOWE GNOME
GODLY: CLAST OILED DROOL GODLY
GOING: CLAST RONDE MOONY GOING
GOLEM: CLAST OILED POLEY GOLEM
GOLLY: CLAST OILED POLLY HOLLY GOLLY
GONAD: CLAST MARAE GOBAN GONAD
GONER: CLAST RONDE BONER HONER GONER
GOODY: CLAST RONDE DOWDY MOODY GOODY
GOOEY: CLAST RONDE BOKEH POGEY GOOEY
GOOFY: CLAST RONDE GOMBO GOOFY
GOOSE: CLAST SOUSE WORSE NOOSE BOOSE GOOSE
GORGE: CLAST RONDE FORME GORGE
GOUGE: CLAST RONDE BOGIE VOUGE GOUGE
GOURD: CLAST RONDE DOBRO GOURD
GRACE: CLAST BRACE GRACE
GRADE: CLAST DEARN IRADE GRADE
GRAFT: CLAST TRANT KRAFT GRAFT
GRAIL: CLAST LEARY DRAIL FRAIL BRAIL GRAIL
GRAIN: CLAST DEARN BRAWN GRAIN
GRAND: CLAST DEARN BRAND GRAND
GRANT: CLAST TRANT ORANT BRANT DRANT GRANT
GRAPE: CLAST DEARN GRAME GRAVE GRAZE GRAPE
GRAPH: CLAST DEARN BRAAI GRAPY GRAPH
GRASP: CLAST SMASH PEASE GRASP
GRASS: CLAST SMASH GRASS
GRATE: CLAST GRATE
GRAVE: CLAST DEARN GRAME GRAVE
GRAVY: CLAST DEARN BRAAI GRAPY GRAVY
GRAZE: CLAST DEARN GRAME GRAVE GRAZE
GREAT: CLAST ARIOT GREAT
GREED: CLAST RONDE DRIER URPED BREED FREED
GREEN: CLAST RONDE GREEN
GREET: CLAST REBIT GREET
GRIEF: CLAST RONDE FERER BRIEF GRIEF
GRILL: CLAST OILED GRILL
GRIME: CLAST RONDE GERBE GRIKE GRIZE GRIPE
GRIMY: CLAST RONDE GRIMY
GRIND: CLAST RONDE GRUND GRIND
GRIPE: CLAST RONDE GERBE GRIKE GRIZE GRIPE
GROAN: CLAST MARAE BROAD GROAN
GROIN: CLAST RONDE PRION GROIN
GROOM: CLAST RONDE GROOM
GROPE: CLAST RONDE PROBE GROPE
GROSS: CLAST SOUSE GROSS
GROUP: CLAST RONDE GROOM GROUF GROUP
GROUT: CLAST REBIT PRUNT TROUT GROUT
GROVE: CLAST RONDE PROBE FROZE WROKE GROVE
GROWL: CLAST OILED WOOLY PROWL GROWL
GROWN: CLAST RONDE PRION FROWN GROWN
GRUEL: CLAST OILED REBEL GRUEL
GRUFF: CLAST RONDE GRIMY GRUFF
GRUNT: CLAST REBIT PRUNT GRUNT
GUARD: CLAST DEARN HOARD IZARD GUARD
GUAVA: CLAST DEARN AGAMI GUAVA
GUESS: CLAST SOUSE GUESS
GUEST: CLAST REIST GOEST GHEST GUEST
GUIDE: CLAST RONDE EMYDE GUIDE
GUILD: CLAST OILED BUILD GUILD
GUILE: CLAST OILED ERVIL GUILE
GUILT: CLAST GILET GUILT
GUISE: CLAST SOUSE BURSE GUYSE GUISE
GULCH: CLAST LOCIE MULCH GULCH
GULLY: CLAST OILED GULPH GULLY
GUMBO: CLAST RONDE HIMBO BUMBO GUMBO
GUMMY: CLAST RONDE PIGMY GUMMY
GUPPY: CLAST RONDE PIGMY GUPPY
GUSTO: CLAST TIRES STONY GUSTO
GUSTY: CLAST TIRES STONY BUSTY FUSTY GUSTY
GYPSY: CLAST SOUSE BRISK GYPSY
HABIT: CLAST ARIOT DAVIT HABIT
HAIRY: CLAST MARAE RANID BARFI HAIRY
HALVE: CLAST PALEA HALVE
HANDY: CLAST MARAE GANDY DANDY HANDY
HAPPY: CLAST MARAE GANDY ZAPPY HAPPY
HARDY: CLAST MARAE BARDY PARDY HARDY
HAREM: CLAST MARAE HAREM
HARPY: CLAST MARAE BARDY PARKY HARPY
HARRY: CLAST MARAE BARDY PARKY HARRY
HARSH: CLAST RASSE MARSH HARSH
HASTE: CLAST TATES HASTE
HASTY: CLAST TATES HASTY
HATCH: CLAST TACAN PATCH WATCH HATCH
HATER: CLAST TATER WATER EATER MATER RATER
HAUNT: CLAST ARIOT GAUNT DAUNT HAUNT
HAUTE: CLAST TATER VAWTE ZANTE HAUTE
HAVEN: CLAST MARAE DAWEN PAVEN HAVEN
HAVOC: CLAST NACRE GAUCH HAVOC
HAZEL: CLAST PALEA LAVER BABEL HAZEL
HEADY: CLAST DEARN BEADY HEADY
HEARD: CLAST DEARN HEARD
HEART: CLAST TRANT PEART HEART
HEATH: CLAST GRATE MEATY DEATH HEATH
HEAVE: CLAST DEARN PEAVY HEAVE
HEAVY: CLAST DEARN PEAVY HEAVY
HEDGE: CLAST RONDE MIDGE JUDGE WEDGE KEDGE
HEFTY: CLAST TORTE DEPTH HEFTY
HEIST: CLAST REIST FEIST NEIST GEIST DEIST
HELIX: CLAST OILED KYLIE HELIX
HELLO: CLAST OILED PELON RELLO HELLO
HENCE: CLAST YINCE PONCE HENCE
HERON: CLAST RONDE PREON HERON
HILLY: CLAST OILED FILMY GILLY BILLY HILLY
HINGE: CLAST RONDE GENIE MINGE WINGE HINGE
HIPPO: CLAST RONDE HIMBO HIPPO
HIPPY: CLAST RONDE PIGMY ZIPPY YIPPY HIPPY
HITCH: CLAST TRICE BITCH PITCH HITCH
HOARD: CLAST DEARN HOARD
HOBBY: CLAST RONDE GOMBO BOBBY HOBBY
HOIST: CLAST REIST HOIST
HOLLY: CLAST OILED POLLY HOLLY
HOMER: CLAST RONDE MOWER HOMER
HONEY: CLAST RONDE HONEY
HONOR: CLAST RONDE HONOR
HORDE: CLAST RONDE HORDE
HORNY: CLAST RONDE MORON PORNY HORNY
HORSE: CLAST SOUSE WORSE MORSE DORSE HORSE
HOTEL: CLAST TOILE HOTEL
HOTLY: CLAST TOILE HOTLY
HOUND: CLAST RONDE WOUND MOUND FOUND POUND
HOUSE: CLAST SOUSE ROUSE YOUSE MOUSE HOUSE
HOVEL: CLAST OILED LOVER NOVEL HOVEL
HOVER: CLAST RONDE MOWER POKER GOFER BORER
HOWDY: CLAST RONDE DOWDY HOWDY
HUMAN: CLAST MARAE HUMAN
HUMID: CLAST RONDE DIPPY HUMID
HUMOR: CLAST RONDE GROOM HUMOR
HUMPH: CLAST RONDE PIGMY BUMPH HUMPH
HUMUS: CLAST DORES MINKS GYMPS BUMFS HUMUS
HUNCH: CLAST YINCE BUNCH HUNCH
HUNKY: CLAST RONDE GUNNY HUNKY
HURRY: CLAST RONDE GRIMY FURRY BURRY HURRY
HUSKY: CLAST DORES SPUNK BUSKY MUSKY HUSKY
HUSSY: CLAST SOUSE GUSSY WUSSY PUSSY FUSSY
HUTCH: CLAST TRICE KOTCH MUTCH HUTCH
HYDRO: CLAST RONDE DROOK HYDRO
HYENA: CLAST MARAE ABUNE HYENA
HYMEN: CLAST RONDE HEMIN HYMEN
HYPER: CLAST RONDE FERER VIPER UPPER HYPER
ICILY: CLAST LOCIE FILCH ICILY
ICING: CLAST YINCE ORCIN ICING
IDEAL: CLAST PALEA GLEAN UVEAL IDEAL
IDIOM: CLAST RONDE DUOMO IDIOM
IDIOT: CLAST REBIT PINOT IDIOT
IDLER: CLAST OILED IDLER
IDYLL: CLAST OILED DRILL IDYLL
IGLOO: CLAST OILED FOLIO IGLOO
ILIAC: CLAST ALECK ILIAC
IMAGE: CLAST DEARN AGAZE PHAGE IMAGE
IMBUE: CLAST RONDE PUMIE IMBUE
IMPEL: CLAST OILED IMPEL
IMPLY: CLAST OILED GRILL IMPLY
INANE: CLAST DEARN KNAVE INANE
INBOX: CLAST RONDE GIPON INBOX
INCUR: CLAST YINCE ORCIN INCUR
INDEX: CLAST RONDE INDEW INDEX
INEPT: CLAST REBIT PIERT INEPT
INERT: CLAST REBIT INERT
INFER: CLAST RONDE GREEN INKER INFER
INGOT: CLAST REBIT PINOT INGOT
INLAY: CLAST PALEA ONLAY INLAY
INLET: CLAST GILET INLET
INNER: CLAST RONDE INNER
INPUT: CLAST REBIT PINOT INPUT
INTER: CLAST TORTE RETEM INTER
INTRO: CLAST TORTE INTRO
IONIC: CLAST YINCE IONIC
IRATE: CLAST GRATE PRATE FRATE URATE WRATE
IRONY: CLAST RONDE PRION IRONY
ISLET: CLAST SPELT ISLET
ISSUE: CLAST DORES SEINE ISSUE
ITCHY: CLAST TRICE INCUT ITCHY
IVORY: CLAST RONDE GROOM IVORY
JAUNT: CLAST ARIOT GAUNT DAUNT HAUNT TAUNT
JAZZY: CLAST MARAE GANDY ZAPPY JAZZY
JELLY: CLAST OILED BULGE WELKE FELON JELLY
JERKY: CLAST RONDE FERER PERKY JERKY
JETTY: CLAST TORTE BETTY JETTY
JEWEL: CLAST OILED REBEL LEVEL JEWEL
JIFFY: CLAST RONDE PIGMY FIZZY BIFFY JIFFY
JOINT: CLAST REBIT PINOT NOINT JOINT
JOIST: CLAST REIST HOIST FOIST MOIST JOIST
JOKER: CLAST RONDE MOWER POKER YOKER JOKER
JOLLY: CLAST OILED POLLY HOLLY GOLLY FOLLY
JOUST: CLAST REIST MOUST JOUST
JUDGE: CLAST RONDE MIDGE JUDGE
JUICE: CLAST YINCE DRICE JUICE
JUICY: CLAST YINCE PRICY JUICY
JUMBO: CLAST RONDE HIMBO BUMBO GUMBO JUMBO
JUMPY: CLAST RONDE PIGMY JUMPY
JUNTA: CLAST TATER DIOTA JUNTA
JUNTO: CLAST TORTE JUNTO
JUROR: CLAST RONDE GROOM FUROR JUROR
KAPPA: CLAST MARAE KANGA KAIKA KAPPA
KARMA: CLAST MARAE KARMA
KAYAK: CLAST MARAE JAPAN KAIAK KAYAK
KEBAB: CLAST MARAE BEGAD KEBAB
KHAKI: CLAST DEARN AGAMI KHAZI KHAKI
KINKY: CLAST RONDE GUNNY PINKY HINKY KINKY
KIOSK: CLAST SOUSE DIPSO KIOSK
KITTY: CLAST TORTE BUTTY KITTY
KNACK: CLAST BRACE KIACK KNACK
KNAVE: CLAST DEARN KNAVE
KNEAD: CLAST MARAE BEGAD EUPAD KNEAD
KNEED: CLAST RONDE INDEW UNFED KNEED
KNEEL: CLAST OILED REBEL KNEEL
KNELT: CLAST GILET DWELT KNELT
KNIFE: CLAST RONDE NEIVE WHINE KNIFE
KNOCK: CLAST YINCE KNOCK
KNOLL: CLAST OILED WOOLY KNOLL
KNOWN: CLAST RONDE GIPON KNOWN
KOALA: CLAST LEARY DUALS JHALA KOALA
KRILL: CLAST OILED GRILL PRILL BRILL KRILL
LABEL: CLAST PALEA LAVER LAZED LABEL
LABOR: CLAST PALEA LARDY LABOR
LADEN: CLAST PALEA LAVER LAZED LADEN
LADLE: CLAST PALEA EARLY HABLE LADLE
LAGER: CLAST PALEA LAVER LAWER LAMER LAYER
LANCE: CLAST LACED LANCE
LANKY: CLAST PALEA LARDY LANKY
LAPEL: CLAST PALEA LAPEL
LAPSE: CLAST LYSSA LAPSE
LARGE: CLAST PALEA EARLY LARGE
LARVA: CLAST PALEA LABRA LARVA
LASSO: CLAST LYSSA LASSO
LATCH: CLAST ICTAL LATCH
LATER: CLAST TALEA LATEX LATED LATEN LATER
LATHE: CLAST TALEA LATKE LATHE
LATTE: CLAST TALEA LATKE LATHE LATTE
LAUGH: CLAST PALEA LARDY LATHI LAUGH
LAYER: CLAST PALEA LAVER LAWER LAMER LAYER
LEACH: CLAST LEACH
LEAFY: CLAST LEARY LEANY LEADY LEAFY
LEAKY: CLAST LEARY LEANY LEADY LEAFY LEAKY
LEANT: CLAST LEANT
LEAPT: CLAST LEANT LEAPT
LEARN: CLAST LEARY LEARN
LEASE: CLAST LEASH LEASE
LEASH: CLAST LEASH
LEAST: CLAST LOAST LEAST
LEAVE: CLAST LEARY LEAVE
LEDGE: CLAST OILED MEDLE LEDGE
LEECH: CLAST LOCIE LEECH
LEERY: CLAST OILED GERLE LEERY
LEFTY: CLAST TOILE LEFTY
LEGAL: CLAST PALEA GLEAN LEGAL
LEGGY: CLAST OILED GERLE LEUGH LEGGY
LEMON: CLAST OILED BOGLE NEROL LEMON
LEMUR: CLAST OILED GERLE LEMUR
LEPER: CLAST OILED REBEL LEGER LEVER LEPER
LEVEL: CLAST OILED REBEL LEVEL
LEVER: CLAST OILED REBEL LEGER LEVER
LIBEL: CLAST OILED LINER LIMEY LIBEL
LIEGE: CLAST OILED RIELS LIEVE LIEGE
LIGHT: CLAST GILET LIGHT
LIKEN: CLAST OILED LINER LIMEN LIKEN
LILAC: CLAST LACED LINAC LILAC
LIMBO: CLAST OILED LINGO LIMBO
LIMIT: CLAST GILET LIMIT
LINEN: CLAST OILED LINER LINEN
LINER: CLAST OILED LINER
LINGO: CLAST OILED LINGO
LIPID: CLAST OILED LIPID
LITHE: CLAST TOILE LITHE
LIVER: CLAST OILED LINER LIKER LIVER
LIVID: CLAST OILED LIPID LIVID
LLAMA: CLAST FLANE ALARM LLAMA
LOAMY: CLAST LEARY LOAMY
LOATH: CLAST TRAIL LOATH
LOBBY: CLAST OILED WOOLY LORRY LOPPY LOBBY
LOCAL: CLAST LACED LOCAL
LOCUS: CLAST SCULK LUCES LOCUS
LODGE: CLAST OILED DOWLE LODGE
LOFTY: CLAST TOILE JOLTY LOFTY
LOGIC: CLAST LOCIE LOGIC
LOGIN: CLAST OILED ROILY LOGOI LOGIN
LOOPY: CLAST OILED WOOLY LOOPY
LOOSE: CLAST LOUSE LOOSE
LORRY: CLAST OILED WOOLY LORRY
LOSER: CLAST SOLEI LOSER
LOUSE: CLAST LOUSE
LOUSY: CLAST LOUSE LOUSY
LOVER: CLAST OILED LOVER
LOWER: CLAST OILED LOVER LOWER
LOWLY: CLAST OILED WOOLY JOWLY LOWLY
LOYAL: CLAST PALEA LORAN LOYAL
LUCID: CLAST LOCIE LUCID
LUCKY: CLAST LOCIE LUCKY
LUMEN: CLAST OILED REBEL LUMEN
LUMPY: CLAST OILED RUMLY LUMPY
LUNAR: CLAST PALEA LORAN LUNAR
LUNCH: CLAST LOCIE LURCH LUNCH
LUNGE: CLAST OILED GERLE LUNGE
LUPUS: CLAST SOLEI GURLS LUSUS LUPUS
LURCH: CLAST LOCIE LURCH
LURID: CLAST OILED BUILD LURID
LUSTY: CLAST TELOS STILL LUSTY
LYING: CLAST OILED GRILL LYING
LYMPH: CLAST OILED RUMLY LYMPH
LYNCH: CLAST LOCIE LURCH LYNCH
LYRIC: CLAST LOCIE LUDIC LYRIC
MACAW: CLAST NACRE BACHA MACAW
MACHO: CLAST NACRE BACHA MACHO
MACRO: CLAST NACRE MACRO
MADAM: CLAST MARAE MAPAU MADAM
MADLY: CLAST PALEA LARDY BADLY MADLY
MAFIA: CLAST MARAE MAGMA MANIA MAFIA
MAGIC: CLAST NACRE GAUCH MAGIC
MAGMA: CLAST MARAE MAGMA
MAIZE: CLAST MARAE MAMIE MAIZE
MAJOR: CLAST MARAE MAYOR MANOR MAJOR
MAKER: CLAST MARAE MAZER MAKER
MAMBO: CLAST MARAE MANKY MAXIM MAMBO
MAMMA: CLAST MARAE MAGMA MAMMA
MAMMY: CLAST MARAE MANKY MAUBY MAMMY
MANGA: CLAST MARAE MAGMA MANGA
MANGE: CLAST MARAE MAMIE MANGE
MANGO: CLAST MARAE MANKY MANDI MANGO
MANGY: CLAST MARAE MANKY MANGY
MANIA: CLAST MARAE MAGMA MANIA
MANIC: CLAST NACRE GANCH PANIC MANIC
MANLY: CLAST PALEA LARDY GAILY WANLY MANLY
MANOR: CLAST MARAE MAYOR MANOR
MAPLE: CLAST PALEA LAPJE MAPLE
MARCH: CLAST NACRE FARCY MARCH
MARRY: CLAST MARAE MARRY
MARSH: CLAST RASSE MARSH
MASON: CLAST NARES BASON MASON
MASSE: CLAST RASSE MASSE
MATCH: CLAST TACAN PATCH WATCH HATCH RATCH
MATEY: CLAST TATER PATED EATEN MATEY
MAUVE: CLAST MARAE MAMIE MANGE MAYBE MAHOE
MAXIM: CLAST MARAE MANKY MAXIM
MAYBE: CLAST MARAE MAMIE MANGE MAYBE
MAYOR: CLAST MARAE MAYOR
MEALY: CLAST LEARY VEALY MEALY
MEANT: CLAST TRANT HIANT QUANT MEANT
MEATY: CLAST GRATE MEATY
MECCA: CLAST NACRE DECAY MECCA
MEDAL: CLAST PALEA GLEAN FEMAL MEDAL
MEDIA: CLAST MARAE MEDIA
MEDIC: CLAST YINCE MEDIC
MELEE: CLAST OILED MULEY MELEE
MELON: CLAST OILED PELON BELON MELON
MERCY: CLAST YINCE MERCY
MERGE: CLAST RONDE GERBE MERGE
MERIT: CLAST REBIT MERIT
MERRY: CLAST RONDE FERER BERRY PERRY VERRY
METAL: CLAST TALEA FETAL PETAL METAL
METER: CLAST TORTE RETEM METER
METRO: CLAST TORTE RETOX METRO
MICRO: CLAST YINCE MICRO
MIDGE: CLAST RONDE MIDGE
MIDST: CLAST REIST MIDST
MIGHT: CLAST REBIT PINOT MIDST MIGHT
MILKY: CLAST OILED FILMY MILKY
MIMIC: CLAST YINCE MICRO MIMIC
MINCE: CLAST YINCE WINCE MINCE
MINER: CLAST RONDE INNER FINER VINER MINER
MINIM: CLAST RONDE GUNNY MINIM
MINOR: CLAST RONDE MINOR
MINTY: CLAST TORTE MINTY
MINUS: CLAST DORES MINKS MINUS
MIRTH: CLAST TORTE YIRTH GIRTH MIRTH
MISER: CLAST DORES SKIER WISER MISER
MISSY: CLAST SOUSE HISSY MISSY
MOCHA: CLAST NACRE OCCAM MOCHA
MODAL: CLAST PALEA LORAN MODAL
MODEL: CLAST OILED MODEL
MODEM: CLAST RONDE POHED DOGEY MODEM
MOGUL: CLAST OILED WOOLY LOUGH MOGUL
MOIST: CLAST REIST HOIST FOIST MOIST
MOLAR: CLAST PALEA ONLAY MOLAR
MOLDY: CLAST OILED MOLDY
MONEY: CLAST RONDE HONEY MONEY
MONTH: CLAST TORTE BOOTY FOUTH MONTH
MOODY: CLAST RONDE DOWDY MOODY
MOOSE: CLAST SOUSE WORSE NOOSE BOOSE GOOSE
MORAL: CLAST PALEA LORAN MORAL
MORON: CLAST RONDE MORON
MORPH: CLAST RONDE MOORY MOHUR MORPH
MOSSY: CLAST SOUSE MOSSO MOSSY
MOTEL: CLAST TOILE HOTEL BOTEL MOTEL
MOTIF: CLAST TORTE NOOIT MOTIF
MOTOR: CLAST TORTE MOTOR
MOTTO: CLAST TORTE POTTO MOTTO
MOULT: CLAST GILET MOULT
MOUND: CLAST RONDE WOUND MOUND
MOUNT: CLAST REBIT FOUNT MOUNT
MOURN: CLAST RONDE MORON MOURN
MOUSE: CLAST SOUSE ROUSE YOUSE MOUSE
MOUTH: CLAST TORTE BOOTY FOUTH MOUTH
MOVER: CLAST RONDE MOWER MOVER
MOVIE: CLAST RONDE BOGIE MOXIE MOVIE
MOWER: CLAST RONDE MOWER
MUCKY: CLAST YINCE GUCKY DUCKY MUCKY
MUCUS: CLAST SOUCE FUCUS MUCUS
MUDDY: CLAST RONDE DIDDY WUDDY PUDDY BUDDY
MULCH: CLAST LOCIE MULCH
MUMMY: CLAST RONDE PIGMY MUMMY
MUNCH: CLAST YINCE BUNCH HUNCH PUNCH MUNCH
MURAL: CLAST PALEA LORAN FURAL RURAL DURAL
MURKY: CLAST RONDE GRIMY MURKY
MUSHY: CLAST DORES SPUNK HUMUS MUSHY
MUSIC: CLAST SOUCE FUCUS MUSIC
MUSKY: CLAST DORES SPUNK BUSKY MUSKY
MUSTY: CLAST TIRES STONY BUSTY FUSTY GUSTY
MYRRH: CLAST RONDE GRIMY MYRRH
NADIR: CLAST MARAE RANID NADIR
NAIVE: CLAST MARAE DAINE NAIVE
NANNY: CLAST MARAE GANDY JANNY FANNY NANNY
NASAL: CLAST SALLE LAIKS NASAL
NASTY: CLAST TATES HASTY MASTY VASTY NASTY
NATAL: CLAST TALEA RATAL KATAL DATAL NATAL
NAVAL: CLAST PALEA NAHAL NAVAL
NAVEL: CLAST PALEA LAVER JAVEL NAVEL
NEEDY: CLAST RONDE NEDDY NEEDY
NEIGH: CLAST RONDE HEMIN NEIGH
NERDY: CLAST RONDE NERDY
NERVE: CLAST RONDE URINE NERVE
NEVER: CLAST RONDE GREEN NEVER
NEWER: CLAST RONDE GREEN NEVER NEWER
NEWLY: CLAST OILED GERLE NEWLY
NICER: CLAST YINCE NICER
NICHE: CLAST YINCE NICHE
NIECE: CLAST YINCE NIECE
NIGHT: CLAST REBIT PINOT NIGHT
NINJA: CLAST MARAE GONIA DINNA NINJA
NINNY: CLAST RONDE GUNNY PINNY MINNY FINNY
NINTH: CLAST TORTE MINTY NINTH
NOBLE: CLAST OILED BOGLE ROBLE NOBLE
NOBLY: CLAST OILED WOOLY NOBLY
NOISE: CLAST SOUSE WORSE NOOSE NOISE
NOISY: CLAST SOUSE GOOSY NOISY
NOMAD: CLAST MARAE HUMAN NOMAD
NOOSE: CLAST SOUSE WORSE NOOSE
NORTH: CLAST TORTE FORTY NORTH
NOSEY: CLAST DORES HOSEN NOSEY
NOTCH: CLAST TRICE KOTCH BOTCH HOTCH NOTCH
NOVEL: CLAST OILED LOVER NOVEL
NUDGE: CLAST RONDE UNDEE NUDIE NUDGE
NURSE: CLAST SOUSE BURSE PURSE NURSE
NUTTY: CLAST TORTE BUTTY GUTTY JUTTY NUTTY
NYLON: CLAST OILED POLLY NYLON
NYMPH: CLAST RONDE NYMPH
OAKEN: CLAST MARAE DAWEN PAVEN BAKEN OAKEN
OBESE: CLAST SOUSE OBESE
OCCUR: CLAST YINCE MUCHO OCCUR
OCEAN: CLAST NACRE OCEAN
OCTAL: CLAST ICTAL OCTAL
OCTET: CLAST DICOT OCTET
ODDER: CLAST RONDE ORDER ODDER
ODDLY: CLAST OILED ODDLY
OFFAL: CLAST PALEA LORAN OFFAL
OFFER: CLAST RONDE BEVOR OFFER
OFTEN: CLAST TORTE BETON OFTEN
OLDEN: CLAST GLOBE OLDEN
OLDER: CLAST GLOBE OLDEN OLDER
OLIVE: CLAST GLOBE OLLIE OLIVE
OMBRE: CLAST RONDE PROBE OMBRE
OMEGA: CLAST MARAE EDEMA OMEGA
ONION: CLAST RONDE GIPON INION UNION ONION
ONSET: CLAST SUINT ONSET
OPERA: CLAST MARAE URENA OPERA
OPINE: CLAST RONDE PHONE OPINE
OPIUM: CLAST RONDE HIMBO OPIUM
OPTIC: CLAST TRICE INCUT OPTIC
ORBIT: CLAST REBIT ORBIT
ORDER: CLAST RONDE ORDER
ORGAN: CLAST MARAE BROAD ORGAN
OTHER: CLAST TORTE RETOX OTHER
OTTER: CLAST TORTE OTTER
OUGHT: CLAST REBIT FOUNT OUGHT
OUNCE: CLAST YINCE PONCE OUNCE
OUTDO: CLAST TORTE TIMBO OUTDO
OUTER: CLAST TORTE RETOX OFTER OUTER
OUTGO: CLAST TORTE TIMBO OUTDO OUTGO
OVARY: CLAST DEARN HOARY OVARY
OVATE: CLAST GRATE AMATE QUATE ENATE OVATE
OVERT: CLAST REBIT GREET OVERT
OVINE: CLAST RONDE PHONE OVINE
OVOID: CLAST RONDE DUOMO OVOID
OWING: CLAST RONDE GIPON OHING OWING
OWNER: CLAST RONDE GENRO OWNER
OXIDE: CLAST RONDE EXODE OXIDE
OZONE: CLAST RONDE PHONE OZONE
PADDY: CLAST MARAE GANDY WADDY BADDY DADDY
PAGAN: CLAST MARAE JAPAN PAVAN PAGAN
PAINT: CLAST ARIOT TAINT HAINT DAINT PAINT
PALER: CLAST PALEA PALED PALER
PALSY: CLAST LYSSA PALSY
PANEL: CLAST PALEA PANEL
PANIC: CLAST NACRE GANCH PANIC
PANSY: CLAST RASSE PAYSD PANSY
PAPAL: CLAST PALEA PAPAL
PAPER: CLAST MARAE GAPER PAPER
PARER: CLAST MARAE DARER YARER BARER PARER
PARKA: CLAST MARAE PARRA PARKA
PARRY: CLAST MARAE BARDY PARKY PARRY
PARSE: CLAST RASSE MARSE PARSE
PARTY: CLAST TATER YARTA PARTY
PASTA: CLAST TATES HASTY BASTA PASTA
PASTE: CLAST TATES HASTE PASTE
PASTY: CLAST TATES HASTY MASTY VASTY NASTY
PATCH: CLAST TACAN PATCH
PATIO: CLAST TATER MATAI PATIN PATIO
PATSY: CLAST TASSE PATSY
PATTY: CLAST TATER BATTY PATTY
PAUSE: CLAST RASSE HANSE PAISE PAUSE
PAYEE: CLAST MARAE DAINE GAUJE PAYEE
PAYER: CLAST MARAE GAPER PAWER PAVER PAYER
PEACE: CLAST BRACE APACE PEACE
PEACH: CLAST BRACE PEACH
PEARL: CLAST LEARY PEARL
PECAN: CLAST NACRE DECAN PECAN
PEDAL: CLAST PALEA PEDAL
PENAL: CLAST PALEA PEDAL PENAL
PENCE: CLAST YINCE PONCE PENCE
PENNE: CLAST RONDE GENIE PENNE
PENNY: CLAST RONDE PENNY
PERCH: CLAST YINCE PERCE PERCH
PERIL: CLAST OILED ERVIL PERIL
PERKY: CLAST RONDE FERER PERKY
PESKY: CLAST DORES SEINE PESKY
PESTO: CLAST TIRES STOPE PESTO
PETAL: CLAST TALEA FETAL PETAL
PETTY: CLAST TORTE BETTY JETTY NETTY PETTY
PHASE: CLAST SMASH PHASE
PHONE: CLAST RONDE PHONE
PHONY: CLAST RONDE GIPON PHONO PHONY
PHOTO: CLAST TORTE JUNTO PHOTO
PIANO: CLAST DEARN NGAIO PIANO
PICKY: CLAST YINCE WICKY KICKY MICKY PICKY
PIECE: CLAST YINCE PIECE
PIETY: CLAST TORTE DEPTH PIETY
PIGGY: CLAST RONDE PIGMY PIGGY
PILOT: CLAST GILET PILOT
PINCH: CLAST YINCE GINCH FINCH PINCH
PINEY: CLAST RONDE PENNY PINEY
PINKY: CLAST RONDE GUNNY PINKY
PINTO: CLAST TORTE JUNTO PINTO
PIPER: CLAST RONDE FERER VIPER PIPER
PIQUE: CLAST RONDE PUMIE PIQUE
PITCH: CLAST TRICE BITCH PITCH
PITHY: CLAST TORTE PITHY
PIVOT: CLAST REBIT PINOT PIVOT
PIXEL: CLAST OILED LINER GIBEL ZIZEL PIXEL
PIXIE: CLAST RONDE PUMIE PIXIE
PIZZA: CLAST MARAE GONIA PODIA PIZZA
PLACE: CLAST PLACK PLACE
PLAID: CLAST FLANE ALARM BLADY PLAID
PLAIN: CLAST FLANE BLAIN PLAIN
PLAIT: CLAST PLANT PLAIT
PLANE: CLAST FLANE ALANE PLANE
PLANK: CLAST FLANE KLANG PLANK
PLANT: CLAST PLANT
PLATE: CLAST ELATE PLATE
PLAZA: CLAST FLANE ALARM PLAYA PLAZA
PLEAD: CLAST ILEAL GLEAM BLEAR PLEAD
PLEAT: CLAST PLOAT PLEAT
PLIED: CLAST GLOBE FLEER PLIED
PLIER: CLAST GLOBE FLEER PLIER
PLUCK: CLAST OLEIC PLUCK
PLUMB: CLAST GLOBE BLINY PLUMB
PLUME: CLAST GLOBE FLUME PLUME
PLUMP: CLAST GLOBE PLINK PLUMY PLUMP
PLUNK: CLAST GLOBE PLINK PLUNK
PLUSH: CLAST SLUSE BLUSH FLUSH PLUSH
POESY: CLAST SOUSE POESY
POINT: CLAST REBIT PINOT POINT
POISE: CLAST SOUSE WORSE NOOSE HOISE POISE
POKER: CLAST RONDE MOWER POKER
POLAR: CLAST PALEA PULAO POLAR
POLKA: CLAST PALEA POLKA
POLYP: CLAST OILED POLLY POLYP
POOCH: CLAST YINCE POOCH
POPPY: CLAST RONDE GOMBO PONZU POPPY
PORCH: CLAST YINCE POOCH PORCH
POSER: CLAST DORES HOSER NOSER POSER
POSIT: CLAST SUINT RESIT POSIT
POSSE: CLAST SOUSE GOSSE POSSE
POUCH: CLAST YINCE POOCH PORCH POUCH
POUND: CLAST RONDE WOUND MOUND FOUND POUND
POUTY: CLAST TORTE BOOTY PONTY POUTY
POWER: CLAST RONDE MOWER POWER
PRANK: CLAST DEARN KRANG PRANK
PRAWN: CLAST DEARN BRAWN PRAWN
PREEN: CLAST RONDE GREEN PREEN
PRESS: CLAST SOUSE PRESS
PRICE: CLAST YINCE DRICE PRICE
PRICK: CLAST YINCE WRICK PRICK
PRIDE: CLAST RONDE PRIDE
PRIED: CLAST RONDE DRIER WRIED FRIED PRIED
PRIME: CLAST RONDE GERBE PRIZE PRIME
PRIMO: CLAST RONDE GROOM PRIMO
PRINT: CLAST REBIT GRIPT PRINT
PRIOR: CLAST RONDE GROOM PRIOR
PRISM: CLAST SOUSE BRISK GRISY PRISM
PRIVY: CLAST RONDE GRIMY PRIVY
PRIZE: CLAST RONDE GERBE PRIZE
PROBE: CLAST RONDE PROBE
PRONE: CLAST RONDE KRONE GRONE PRONE
PRONG: CLAST RONDE PRION PRONG
PROOF: CLAST RONDE GROOM PROOF
PROSE: CLAST SOUSE OBESE WHOSE PROSE
PROUD: CLAST RONDE DROOK PROUD
PROVE: CLAST RONDE PROBE PROKE PROVE
PROWL: CLAST OILED WOOLY PROWL
PROXY: CLAST RONDE GROOM FROWY PROXY
PRUDE: CLAST RONDE PRIDE PRUDE
PRUNE: CLAST RONDE URINE PRUNE
PSALM: CLAST SPALE PAALS PSALM
PUBIC: CLAST YINCE DOMIC PUBIC
PUDGY: CLAST RONDE DIPPY PUDGY
PUFFY: CLAST RONDE PIGMY PUFFY
PULPY: CLAST OILED GULPH PULPY
PULSE: CLAST LOUSE MULSE DULSE BULSE PULSE
PUNCH: CLAST YINCE BUNCH HUNCH PUNCH
PUPAL: CLAST PALEA PRIAL POKAL PYGAL PUPAL
PUPIL: CLAST OILED GRILL FUZIL PUPIL
PUPPY: CLAST RONDE PIGMY PUFFY PUPPY
PUREE: CLAST RONDE GERBE PUREE
PURER: CLAST RONDE FERER HIRER PURER
PURGE: CLAST RONDE GERBE VIRGE PURGE
PURSE: CLAST SOUSE BURSE PURSE
PUSHY: CLAST DORES SPUNK PUSHY
PUTTY: CLAST TORTE BUTTY GUTTY JUTTY NUTTY
PYGMY: CLAST RONDE PIGMY PYGMY
QUACK: CLAST BRACE KIACK QUACK
QUAIL: CLAST LEARY DUALS QUAIL
QUAKE: CLAST DEARN AGAZE QUAKE
QUALM: CLAST LEARY DUALS QUALM
QUARK: CLAST DEARN HOARY URARI QUARK
QUART: CLAST TRANT PEART QUART
QUASH: CLAST SMASH ABASH GNASH DEASH QUASH
QUASI: CLAST SMASH PEASE ABASK QUASI
QUEEN: CLAST RONDE HEMIN QUEYN QUEEN
QUEER: CLAST RONDE FERER EMBER PHEER QUEER
QUELL: CLAST OILED GERLE KNELL QUELL
QUERY: CLAST RONDE FERER PREMY QUERY
QUEST: CLAST REIST GOEST EWEST QUEST
QUEUE: CLAST RONDE PUMIE FUZEE QUEUE
QUICK: CLAST YINCE WRICK HOICK QUICK
QUIET: CLAST REBIT PIERT QUIET
QUILL: CLAST OILED GRILL QUILL
QUILT: CLAST GILET BUILT QUILT
QUIRK: CLAST RONDE GRIMY QUIRK
QUITE: CLAST TORTE UNITE QUITE
QUOTA: CLAST TATER DIOTA QUOTA
QUOTE: CLAST TORTE EMOTE QUOTE
QUOTH: CLAST TORTE JUNTO QUOTH
RABBI: CLAST MARAE RANID RABBI
RABID: CLAST MARAE RANID RAPID RABID
RACER: CLAST NACRE RACER
RADAR: CLAST MARAE BAZAR NAVAR RADAR
RADII: CLAST MARAE RANID RADII
RADIO: CLAST MARAE RANID RADII RADIX RADIO
RAINY: CLAST MARAE RANID RAINY
RAISE: CLAST RASSE RAISE
RAJAH: CLAST MARAE BAZAR RAJAH
RALLY: CLAST PALEA BALDY RALLY
RALPH: CLAST PALEA JALOP RALPH
RAMEN: CLAST MARAE RAMEN
RANCH: CLAST NACRE RANCH
RANDY: CLAST MARAE RANID RANDY
RANGE: CLAST MARAE RANGE
RAPID: CLAST MARAE RANID RAPID
RARER: CLAST MARAE DARER YARER BARER PARER
RASPY: CLAST NARES SABRA RASPY
RATIO: CLAST TATER RATOO RATIO
RATTY: CLAST TATER RATTY
RAVEN: CLAST MARAE GAPER RAVEY RAVED RAVEN
RAYON: CLAST MARAE RANID RAYON
RAZOR: CLAST MARAE RANID RAZOO RAZOR
REACH: CLAST BRACE REACH
REACT: CLAST REACT
READY: CLAST DEARN READY
REALM: CLAST LEARY REALO REALM
REARM: CLAST DEARN MEARE REARM
REBAR: CLAST MARAE DEBAR KEBAR REBAR
REBEL: CLAST OILED REBEL
REBUS: CLAST DORES BEERS REBUS
REBUT: CLAST REBIT REBUT
RECAP: CLAST NACRE ARCED RECAP
RECUR: CLAST YINCE OCHER RECUR
RECUT: CLAST DICOT FECHT RECUT
REEDY: CLAST RONDE REDDY REEDY
REFER: CLAST RONDE REEFY REFER
REFIT: CLAST REBIT REMIT REFIT
REGAL: CLAST PALEA GLEAN LEGAL REGAL
REHAB: CLAST MARAE DEBAR REHAB
REIGN: CLAST RONDE REPIN REIGN
RELAX: CLAST PALEA BELAR RELAY RELAX
RELAY: CLAST PALEA BELAR RELAY
RELIC: CLAST LOCIE MELIC RELIC
REMIT: CLAST REBIT REMIT
RENAL: CLAST PALEA GLEAN NERAL RENAL
RENEW: CLAST RONDE RENIN RENEW
REPAY: CLAST MARAE DEBAR RENAY REPAY
REPEL: CLAST OILED REBEL REFEL REPEL
REPLY: CLAST OILED GERLE REFLY REPLY
RERUN: CLAST RONDE REPIN REMEN RERUN
RESET: CLAST SUINT ROSET RESET
RESIN: CLAST DORES SPIRE RESIN
RETCH: CLAST TRICE RETCH
RETRO: CLAST TORTE RETOX RETRO
RETRY: CLAST TORTE RETEM RETRY
REUSE: CLAST SOUSE MEUSE REUSE
REVEL: CLAST OILED REBEL REFEL REPEL REVEL
REVUE: CLAST RONDE REVIE REVUE
RHINO: CLAST RONDE RHINO
RHYME: CLAST RONDE REVIE RHYME
RIDER: CLAST RONDE REDID RIDER
RIDGE: CLAST RONDE RUDIE RIDGE
RIFLE: CLAST OILED RIELS RIFLE
RIGHT: CLAST REBIT RIGHT
RIGID: CLAST RONDE RIGID
RIGOR: CLAST RONDE RUMBO RIGOR
RINSE: CLAST SOUSE PRESE RINSE
RIPEN: CLAST RONDE REPIN RIPEN
RIPER: CLAST RONDE REEFY REMAP RIPER
RISEN: CLAST DORES SKIER RISEN
RISER: CLAST DORES SKIER WISER MISER RISER
RISKY: CLAST DORES SMIRK RISKY
RIVAL: CLAST PALEA LORAN RIYAL RIVAL
RIVER: CLAST RONDE REEFY REMAP RIVER
RIVET: CLAST REBIT RIVET
ROACH: CLAST BRACE ROACH
ROAST: CLAST REAST ROAST
ROBIN: CLAST RONDE ROBIN
ROBOT: CLAST REBIT ROBOT
ROCKY: CLAST YINCE GUCKY JOCKY POCKY ROCKY
RODEO: CLAST RONDE ROPED RODEO
ROGER: CLAST RONDE ROPER ROGER
ROGUE: CLAST RONDE ROQUE ROGUE
ROOMY: CLAST RONDE ROOPY ROOFY ROOMY
ROOST: CLAST REIST ROYST ROOST
ROTOR: CLAST TORTE MOTOR ROTOR
ROUGE: CLAST RONDE ROQUE ROUGE
ROUGH: CLAST RONDE ROOPY ROUGH
ROUND: CLAST RONDE ROUND
ROUSE: CLAST SOUSE ROUSE
ROUTE: CLAST TORTE RONTE ROUTE
ROVER: CLAST RONDE ROPER ROGER ROVER
ROWDY: CLAST RONDE ROWDY
ROWER: CLAST RONDE ROPER ROGER ROVER ROKER
ROYAL: CLAST PALEA LORAN ROMAL ROYAL
RUDDY: CLAST RONDE RUDDY
RUDER: CLAST RONDE REDID RUDER
RUGBY: CLAST RONDE RHUMB RUBBY RUGBY
RULER: CLAST OILED MULEY PULER RULER
RUMBA: CLAST MARAE ARMOR RUMBA
RUMOR: CLAST RONDE RUMBO RUMOR
RUPEE: CLAST RONDE REVIE RUPEE
RURAL: CLAST PALEA LORAN FURAL RURAL
RUSTY: CLAST TIRES STORK RUSTY
SADLY: CLAST SALLE SAILS SAOLA SADLY
SAFER: CLAST NARES BASER SAYER SAGER SAKER
SAINT: CLAST RESAT SAUNT SAINT
SALAD: CLAST SALLE SALOP SALIX SALAD
SALLY: CLAST SALLE SALLY
SALON: CLAST SALLE SALOP SALON
SALSA: CLAST LYSSA SALSA
SALTY: CLAST TOLAS SALTY
SALVE: CLAST SALLE SALUE SALVE
SALVO: CLAST SALLE SALOP SALVO
SANDY: CLAST NARES BASON SANGH SANDY
SANER: CLAST NARES SANER
SAPPY: CLAST NARES PASHA SAMPI SAPPY
SASSY: CLAST RASSE MASSY SASSY
SATIN: CLAST TATES SATAI SATIN
SATYR: CLAST TATES SATAI SATYR
SAUCE: CLAST RACES SAICE SAUCE
SAUCY: CLAST RACES SAUCY
SAUNA: CLAST NARES BASON SANGH SAUNA
SAUTE: CLAST TATES HASTE SAUTE
SAVOR: CLAST NARES SABRA SAPOR SAVOR
SAVOY: CLAST NARES PASHA MAYOS SAVOY
SAVVY: CLAST NARES PASHA MAYOS SAVVY
SCALD: CLAST SCALY SCALE SCALP SCALD
SCALE: CLAST SCALY SCALE
SCALP: CLAST SCALY SCALE SCALP
SCALY: CLAST SCALY
SCAMP: CLAST SCARP SCAMP
SCANT: CLAST SCATT SCART SCANT
SCARE: CLAST SCARP SCARE
SCARF: CLAST SCARP SCARE SCARY SCARS SCARF
SCARY: CLAST SCARP SCARE SCARY
SCENE: CLAST SOUCE SCREE SCENE
SCENT: CLAST SCOUT SCENT
SCION: CLAST SOUCE SCROG SCOOP SCION
SCOFF: CLAST SOUCE SCROG SCOWS SCODY SCOFF
SCOLD: CLAST SCULK SCOLD
SCONE: CLAST SOUCE SCONE
SCOOP: CLAST SOUCE SCROG SCOOP
SCOPE: CLAST SOUCE SCONE SCOPE
SCORE: CLAST SOUCE SCONE SCOPE SCORE
SCORN: CLAST SOUCE SCROG SCORN
SCOUR: CLAST SOUCE SCOUG SCOUR
SCOUT: CLAST SCOUT
SCOWL: CLAST SCULK SCOWL
SCRAM: CLAST RACES SCRAY SCRAG SCRAP SCRAB
SCRAP: CLAST RACES SCRAY SCRAG SCRAP
SCREE: CLAST SOUCE SCREE
SCREW: CLAST SOUCE SCYES SCREW
SCRUB: CLAST SOUCE SCUMS SCRUB
SCRUM: CLAST SOUCE SCUMS SCRUM
SCUBA: CLAST RACES SCOPA SCHWA SCUBA
SEDAN: CLAST NARES SNEAP SEWAN SEDAN
SEEDY: CLAST DORES SNIDE SEEDY
SEGUE: CLAST DORES SEINE SEGUE
SEIZE: CLAST DORES SEINE SEIZE
SEMEN: CLAST DORES SEYEN SEWEN SEMEN
SENSE: CLAST SOUSE SENSE
SEPIA: CLAST NARES SEPAD SEPIA
SERIF: CLAST DORES SURGE SERIF
SERUM: CLAST DORES SURGE SERUM
SERVE: CLAST DORES SURGE SERRE SERVE
SETUP: CLAST TIRES STOPE SETUP
SEVEN: CLAST DORES SEYEN SEWEN SEMEN SEVEN
SEVER: CLAST DORES SKIER SPEER SEFER SEWER
SEWER: CLAST DORES SKIER SPEER SEFER SEWER
SHACK: CLAST SCARP SNACK SMACK SHACK
SHADE: CLAST SNARE SHAME SHADE
SHADY: CLAST SNARE SPAWS SMAAK SHADY
SHAFT: CLAST SPART SHAKT SHAFT
SHAKE: CLAST SNARE SHAME SHADE SHAKE
SHAKY: CLAST SNARE SPAWS SMAAK SHAKO SHAKY
SHALE: CLAST SPALE SHALE
SHALL: CLAST SPALE SHALM SHALL
SHALT: CLAST SMALT SHALT
SHAME: CLAST SNARE SHAME
SHANK: CLAST SNARE SPAWN SHANK
SHAPE: CLAST SNARE SHAME SHADE SHAKE SHAPE
SHARD: CLAST SNARE SPARD SHARD
SHARE: CLAST SNARE SHARE
SHARK: CLAST SNARE SPARD SWARM SHARK
SHARP: CLAST SNARE SPARD SHARP
SHAVE: CLAST SNARE SHAME SHADE SHAKE SHAPE
SHAWL: CLAST SPALE SWAIL SHAWL
SHEAR: CLAST NARES SEWAR SMEAR SPEAR SKEAR
SHEEN: CLAST DORES SEYEN SHEEN
SHEEP: CLAST DORES SEYEN SMEEK SHEEP
SHEER: CLAST DORES SKIER SPEER SNEER SHEER
SHEET: CLAST SUINT STOPT SHAKT SHEET
SHEIK: CLAST DORES SEINE SMEIK SHEIK
SHELF: CLAST SOLEI SPEEL SHELF
SHELL: CLAST SOLEI SPEEL SMELL SWELL SHELL
SHIED: CLAST DORES SIPED SKIED SHIED
SHIFT: CLAST SUINT SHIRT SHIFT
SHINE: CLAST DORES SEINE SWINE SPINE SHINE
SHINY: CLAST DORES SPUNK SHINY
SHIRE: CLAST DORES SPIRE SHIRE
SHIRK: CLAST DORES SMIRK SHIRK
SHIRT: CLAST SUINT SHIRT
SHOAL: CLAST SALLE SORAL SKOAL SHOAL
SHOCK: CLAST SOUCE SHOCK
SHONE: CLAST DORES SHONE
SHOOK: CLAST DORES HYSON SHOOK
SHOOT: CLAST SUINT STOPT SHORT SHOOT
SHORE: CLAST DORES SMORE SNORE SPORE SWORE
SHORN: CLAST DORES SHORN
SHORT: CLAST SUINT STOPT SHORT
SHOUT: CLAST SUINT SPOUT SMOUT SHOUT
SHOVE: CLAST DORES SHONE SHOVE
SHOWN: CLAST DORES HYSON SHOWN
SHOWY: CLAST DORES HYSON SHOWY
SHREW: CLAST DORES SIREE SPREW SHREW
SHRUB: CLAST DORES SHRUG SHRUB
SHRUG: CLAST DORES SHRUG
SHUCK: CLAST SOUCE SHUCK
SHUNT: CLAST SUINT STUNT SHUNT
SHUSH: CLAST SOUSE SHUSH
SHYLY: CLAST SOLEI SLUNK SHYLY
SIEGE: CLAST DORES SEINE SIEGE
SIEVE: CLAST DORES SEINE SIEGE SIEVE
SIGHT: CLAST SUINT SPRIT SIGHT
SIGMA: CLAST NARES SIMAS SIGMA
SILKY: CLAST SOLEI SILLY SILKY
SILLY: CLAST SOLEI SILLY
SINCE: CLAST SOUCE SINCE
SINEW: CLAST DORES SEYEN SINEW
SINGE: CLAST DORES SEINE SINGE
SIREN: CLAST DORES SIREE SIREN
SISSY: CLAST SOUSE SWISS SISSY
SIXTH: CLAST TIRES FISTY SIXTH
SIXTY: CLAST TIRES FISTY SIXTY
SKATE: CLAST TEARS SKATE
SKIER: CLAST DORES SKIER
SKIFF: CLAST DORES SPUNK SKIVY SKIFF
SKILL: CLAST SOLEI SHILY SWILL SKILL
SKIMP: CLAST DORES SPUNK SKIMP
SKIRT: CLAST SUINT SHIRT SPIRT SKIRT
SKULK: CLAST SOLEI SLUNK SKULK
SKULL: CLAST SOLEI SLUNK SKULL
SKUNK: CLAST DORES SPUNK SKUNK
SLACK: CLAST SLACK
SLAIN: CLAST SLANG SLAIN
SLANG: CLAST SLANG
SLANT: CLAST SLART SLANT
SLASH: CLAST SLASH
SLATE: CLAST FLATS SLATY SLATE
SLAVE: CLAST SLANG SLADE SLAVE
SLEEK: CLAST PLIES SLEER SLEEK
SLEEP: CLAST PLIES SLEEP
SLEET: CLAST SLIPT SLOOT SLEET
SLEPT: CLAST SLIPT SLEPT
SLICE: CLAST SLICE
SLICK: CLAST SLICE SLICK
SLIDE: CLAST PLIES SLIME SLIDE
SLIME: CLAST PLIES SLIME
SLIMY: CLAST PLIES SLILY SLIMY
SLING: CLAST PLIES SLILY SLINK SLING
SLINK: CLAST PLIES SLILY SLINK
SLOOP: CLAST PLIES SLURP SLOOP
SLOPE: CLAST PLIES SLOPE
SLOSH: CLAST SLUSE SLOSH
SLOTH: CLAST SLUIT SLOTS SLOTH
SLUMP: CLAST PLIES SLURP SLUMP
SLUNG: CLAST PLIES SLORM SLUNK SLUNG
SLUNK: CLAST PLIES SLORM SLUNK
SLURP: CLAST PLIES SLURP
SLUSH: CLAST SLUSE SLUSH
SLYLY: CLAST PLIES SLORM SLUNK SLYLY
SMACK: CLAST SCARP SNACK SMACK
SMALL: CLAST SPALE SHALM SMALL
SMART: CLAST SPART SMART
SMASH: CLAST SMASH
SMEAR: CLAST NARES SEWAR SMEAR
SMELL: CLAST SOLEI SPEEL SMELL
SMELT: CLAST SPELT SWELT SMELT
SMILE: CLAST SOLEI SPILE SWILE SMILE
SMIRK: CLAST DORES SMIRK
SMITE: CLAST TIRES SPITE SUITE SKITE SHITE
SMITH: CLAST TIRES STIMY SMITH
SMOCK: CLAST SOUCE SHOCK SMOCK
SMOKE: CLAST DORES SHONE SMOKE
SMOKY: CLAST DORES HYSON SMOKY
SMOTE: CLAST TIRES STOPE SOOTE SMOTE
SNACK: CLAST SCARP SNACK
SNAIL: CLAST SPALE SWAIL SNAIL
SNAKE: CLAST SNARE SNAKE
SNAKY: CLAST SNARE SNAGS SNAKY
SNARE: CLAST SNARE
SNARL: CLAST SPALE SWAIL SNARL
SNEAK: CLAST NARES SNEAP SNEAK
SNEER: CLAST DORES SKIER SPEER SNEER
SNIDE: CLAST DORES SNIDE
SNIFF: CLAST DORES SPUNK SNIFF
SNIPE: CLAST DORES SEINE SNIPE
SNOOP: CLAST DORES HYSON SNOOK SNOOP
SNORE: CLAST DORES SMORE SNORE
SNORT: CLAST SUINT SNOOT SNORT
SNOUT: CLAST SUINT SNOUT
SNOWY: CLAST DORES HYSON SNOWY
SNUCK: CLAST SOUCE SHUCK SNUCK
SNUFF: CLAST DORES SPUNK SNUFF
SOAPY: CLAST SNARE SPAWS SOAPY
SOBER: CLAST DORES HOSER SOWER SOBER
SOGGY: CLAST DORES SOUPY SOGGY
SOLAR: CLAST SALLE SYLVA SOLAH SOLAR
SOLID: CLAST SOLEI SOLID
SOLVE: CLAST SOLEI SOLVE
SONAR: CLAST NARES SONAR
SONIC: CLAST SOUCE SODIC SONIC
SOOTH: CLAST TIRES STONY SOOTH
SOOTY: CLAST TIRES STONY SOOTY
SORRY: CLAST DORES SORBO SORRY
SOUND: CLAST DORES WOODS SOUND
SOUTH: CLAST TIRES STONY SOWTH SOUTH
SOWER: CLAST DORES HOSER SOWER
SPACE: CLAST SCARP SPACY SPACE
SPADE: CLAST SNARE SHAME SPADE
SPANK: CLAST SNARE SPAWN SPANG SPANK
SPARE: CLAST SNARE SHARE SPARE
SPARK: CLAST SNARE SPARD SPARS SPARK
SPASM: CLAST SMASH SPASM
SPAWN: CLAST SNARE SPAWN
SPEAK: CLAST NARES SEPAD SPEAK
SPEAR: CLAST NARES SEWAR SMEAR SPEAR
SPECK: CLAST SOUCE SPECK
SPEED: CLAST DORES SIPED SPUED SPEED
SPELL: CLAST SOLEI SPEEL SPELL
SPELT: CLAST SPELT
SPEND: CLAST DORES SNIDE SPEND
SPENT: CLAST SUINT STENT SPENT
SPERM: CLAST DORES SPIRE SPERM
SPICE: CLAST SOUCE SINCE SPICE
SPICY: CLAST SOUCE SYNCS SPICY
SPIED: CLAST DORES SIPED SPIED
SPIEL: CLAST SOLEI SPIEL
SPIKE: CLAST DORES SEINE SWIVE SPIKE
SPIKY: CLAST DORES SPUNK SPIKY
SPILL: CLAST SOLEI SHILY SWILL SKILL SPILL
SPILT: CLAST SPELT SPILT
SPINE: CLAST DORES SEINE SWINE SPINE
SPINY: CLAST DORES SPUNK SPINY
SPIRE: CLAST DORES SPIRE
SPITE: CLAST TIRES SPITE
SPLAT: CLAST SALUT SPLAT
SPLIT: CLAST SPELT SPLIT
SPOIL: CLAST SOLEI SPOIL
SPOKE: CLAST DORES SHONE SMOKE SPOKE
SPOOF: CLAST DORES HYSON SPOOK SPOOF
SPOOK: CLAST DORES HYSON SPOOK
SPOOL: CLAST SOLEI SKOOL SNOOL SHOOL SPOOL
SPOON: CLAST DORES HYSON PSION SPOON
SPORE: CLAST DORES SMORE SNORE SPORE
SPORT: CLAST SUINT STOPT SPOOT SPORT
SPOUT: CLAST SUINT SPOUT
SPRAY: CLAST NARES DURAS SPRAG SPRAY
SPREE: CLAST DORES SIREE SPREE
SPRIG: CLAST DORES SHRUG SPRIG
SPUNK: CLAST DORES SPUNK
SPURN: CLAST DORES SMIRK SPURN
SPURT: CLAST SUINT SPOUT SPURT
SQUAD: CLAST NARES SIMAS SQUAD
SQUAT: CLAST RESAT SHOAT SQUAT
SQUIB: CLAST DORES SPUNK SQUIB
STACK: CLAST SCATS STACK
STAFF: CLAST TEARS STANG STAMP STAID STAFF
STAGE: CLAST TEARS SKATE STAGE
STAID: CLAST TEARS STANG STAMP STAID
STAIN: CLAST TEARS STANG STAIN
STAIR: CLAST TEARS STAIR
STAKE: CLAST TEARS SKATE STAKE
STALE: CLAST LEATS STALE
STALK: CLAST LEATS STALL STALK
STALL: CLAST LEATS STALL
STAMP: CLAST TEARS STANG STAMP
STAND: CLAST TEARS STANG STANK STAND
STANK: CLAST TEARS STANG STANK
STARE: CLAST TEARS STARE
STARK: CLAST TEARS STARN STARK
START: CLAST SPART SMART SWART START
STASH: CLAST TRASS STASH
STATE: CLAST TEARS SKATE SPATE STATE
STAVE: CLAST TEARS SKATE STAGE STANE STADE
STEAD: CLAST TATES STRAE STEAK STEAN STEAM
STEAK: CLAST TATES STRAE STEAK
STEAL: CLAST TOLAS STEAL
STEAM: CLAST TATES STRAE STEAK STEAN STEAM
STEED: CLAST TIRES STEED
STEEL: CLAST TELOS STILE STEEL
STEEP: CLAST TIRES STEED STEEM STEEK STEEN
STEER: CLAST TIRES STEER
STEIN: CLAST TIRES SPITE STEIN
STERN: CLAST TIRES STYRE STERN
STICK: CLAST TICES STICH STICK
STIFF: CLAST TIRES STIMY STING STIFF
STILL: CLAST TELOS STILL
STILT: CLAST SPELT STILT
STING: CLAST TIRES STIMY STING
STINK: CLAST TIRES STIMY STING STINK
STINT: CLAST SUINT STINT
STOCK: CLAST TICES STOCK
STOIC: CLAST TICES STICH STOIC
STOKE: CLAST TIRES STOPE STOVE STONE STOKE
STOLE: CLAST TELOS STOLE
STOMP: CLAST TIRES STONY STOWP STOMP
STONE: CLAST TIRES STOPE STOVE STONE
STONY: CLAST TIRES STONY
STOOD: CLAST TIRES STONY STOWP STOOK STOOD
STOOL: CLAST TELOS STOOL
STOOP: CLAST TIRES STONY STOWP STOMP STOUP
STORE: CLAST TIRES STYRE STERE STORE
STORK: CLAST TIRES STORK
STORM: CLAST TIRES STORK STORY STORM
STORY: CLAST TIRES STORK STORY
STOUT: CLAST SUINT SPOUT SMOUT SHOUT STOUT
STOVE: CLAST TIRES STOPE STOVE
STRAP: CLAST TATES STIPA STRAP
STRAW: CLAST TATES STIPA STAGY STRAD STRAW
STRAY: CLAST TATES STIPA STAGY STRAY
STRIP: CLAST TIRES STRIG STRIP
STRUT: CLAST SUINT SPOUT STRUT
STUCK: CLAST TICES STOCK STUCK
STUDY: CLAST TIRES STONY STYMY STUDY
STUFF: CLAST TIRES STONY STUMP STUFF
STUMP: CLAST TIRES STONY STUMP
STUNG: CLAST TIRES STONY STUNK STUNG
STUNK: CLAST TIRES STONY STUNK
STUNT: CLAST SUINT STUNT
STYLE: CLAST TELOS STILE STYLE
SUAVE: CLAST SNARE SHAME SPADE SUAVE
SUGAR: CLAST NARES SOPRA SIMAR SUGAR
SUING: CLAST DORES SPUNK SUNNY SUING
SUITE: CLAST TIRES SPITE SUITE
SULKY: CLAST SOLEI SULKY
SULLY: CLAST SOLEI SULKY SULLY
SUMAC: CLAST RACES SCOPA SUMAC
SUNNY: CLAST DORES SPUNK SUNNY
SUPER: CLAST DORES SKIER SPEER SUPER
SURER: CLAST DORES SIREE SPREW SURER
SURGE: CLAST DORES SURGE
SURLY: CLAST SOLEI SLUNK SURLY
SUSHI: CLAST DORES SPUNK SUBBY SUSHI
SWAMI: CLAST SNARE SPAWS SWAMY SWAMI
SWAMP: CLAST SNARE SPAWS SWAMP
SWARM: CLAST SNARE SPARD SWARM
SWASH: CLAST SMASH SNASH SHASH SWASH
SWATH: CLAST TEARS STANG SWATH
SWEAR: CLAST NARES SEWAR SWEAR
SWEAT: CLAST RESAT SWEAT
SWEEP: CLAST DORES SEYEN SMEEK SHEEP SWEEP
SWEET: CLAST SUINT STOPT SHAKT SWEET
SWELL: CLAST SOLEI SPEEL SMELL SWELL
SWEPT: CLAST SUINT STOPT SWEPT
SWIFT: CLAST SUINT SHIRT SWIFT
SWILL: CLAST SOLEI SHILY SWILL
SWINE: CLAST DORES SEINE SWINE
SWING: CLAST DORES SPUNK SHINY SWING
SWIRL: CLAST SOLEI SHILY SWIRL
SWISH: CLAST SOUSE SWISS SWISH
SWOON: CLAST DORES HYSON PSION SWOON
SWOOP: CLAST DORES HYSON SPOOK SWOOP
SWORD: CLAST DORES SUDOR SWORD
SWORE: CLAST DORES SMORE SNORE SPORE SWORE
SWORN: CLAST DORES SHORN SWORN
SWUNG: CLAST DORES SPUNK SWUNG
SYNOD: CLAST DORES UNSOD SYNOD
SYRUP: CLAST DORES SHRUG SIRUP SYRUP
TABBY: CLAST TATER TANKA TABID TABBY
TABLE: CLAST TALEA TABLE
TABOO: CLAST TATER TANKA TABID TABBY TABOO
TACIT: CLAST TACET TACIT
TACKY: CLAST TACAN TACHO TACKY
TAFFY: CLAST TATER TANKA TABID TAGMA TAFFY
TAINT: CLAST ARIOT TAINT
TAKEN: CLAST TATER TAPEN TAKEN
TAKER: CLAST TATER TAVER TAXER TAWER TABER
TALLY: CLAST TALEA TALKY TALLY
TALON: CLAST TALEA TALKY TALON
TAMER: CLAST TATER TAVER TAXER TAWER TABER
TANGO: CLAST TATER TANKA TANGO
TANGY: CLAST TATER TANKA TANGO TANGI TANGY
TAPER: CLAST TATER TAVER TAXER TAWER TABER
TAPIR: CLAST TATER TABOR TAPIR
TARDY: CLAST TATER TARDY
TAROT: CLAST ARIOT TAROT
TASTE: CLAST TATES TASTE
TASTY: CLAST TATES TASTY
TATTY: CLAST TATER TATTY
TAUNT: CLAST ARIOT GAUNT DAUNT HAUNT TAUNT
TAWNY: CLAST TATER TANKA TAUON TAWNY
TEACH: CLAST THACK TEACH
TEARY: CLAST GRATE TEARY
TEASE: CLAST TRASS TEASE
TEDDY: CLAST TORTE TEEND TEDDY
TEETH: CLAST TORTE TENTY TEETH
TEMPO: CLAST TORTE TEPOY TEMPO
TENET: CLAST REBIT DEMPT TENET
TENOR: CLAST TORTE TENOR
TENSE: CLAST TOUSE TERSE TEMSE TENSE
TENTH: CLAST TORTE TENTY TENTH
TEPEE: CLAST TORTE TENUE TEPEE
TEPID: CLAST TORTE TEEND TEPID
TERRA: CLAST TATER TERGA TERRA
TERSE: CLAST TOUSE TERSE
TESTY: CLAST TIRES TESTY
THANK: CLAST GRATE THANA THANX THANK
THEFT: CLAST REBIT UNMET WHEFT THEFT
THEIR: CLAST TORTE TRIED THEIR
THEME: CLAST TORTE TENUE THEBE THEME
THERE: CLAST TORTE TRIKE THERE
THESE: CLAST TOUSE TERSE THESE
THETA: CLAST TATER THETA
THICK: CLAST TRICE THICK
THIEF: CLAST TORTE TEEND TUPEK THIEF
THIGH: CLAST TORTE TIYIN THIGH
THING: CLAST TORTE TIYIN TWINK THING
THINK: CLAST TORTE TIYIN TWINK THINK
THIRD: CLAST TORTE TRUMP THIRD
THONG: CLAST TORTE TIMON THONG
THORN: CLAST TORTE TROOP THORN
THOSE: CLAST TOUSE THOSE
THREE: CLAST TORTE TERNE THREE
THREW: CLAST TORTE TERRY THREW
THROB: CLAST TORTE THROB
THROW: CLAST TORTE THROB THROW
THRUM: CLAST TORTE THRID THRUM
THUMB: CLAST TORTE TIYIN THUMP THUMB
THUMP: CLAST TORTE TIYIN THUMP
THYME: CLAST TORTE TENUE THYME
TIARA: CLAST GRATE THARM TIARA
TIBIA: CLAST TATER TONKA THUJA TIBIA
TIDAL: CLAST TALEA TOLAR TYPAL TIDAL
TIGER: CLAST TORTE TRIED TIGER
TIGHT: CLAST REBIT PINOT MIDST HIGHT FIGHT
TILDE: CLAST TOILE TILDE
TIMER: CLAST TORTE TRIED TIGER TIMER
TIMID: CLAST TORTE TIYIN TIMID
TIPSY: CLAST TOUSE TIPSY
TITAN: CLAST TATER TITAN
TITHE: CLAST TORTE TITHE
TITLE: CLAST TOILE TITLE
TOAST: CLAST REAST HOAST BOAST TOAST
TODAY: CLAST TATER TONKA TOPAZ TODAY
TODDY: CLAST TORTE TOYON TOUZY TODDY
TOKEN: CLAST TORTE TOKEN
TONAL: CLAST TALEA TOLAR TOTAL TONAL
TONGA: CLAST TATER TONKA TONGA
TONIC: CLAST TRICE TONIC
TOOTH: CLAST TORTE TOTTY TOOTH
TOPAZ: CLAST TATER TONKA TOPAZ
TOPIC: CLAST TRICE TONIC TOXIC TOPIC
TORCH: CLAST TRICE TORCH
TORSO: CLAST TOUSE TORSI TORSO
TORUS: CLAST TIRES TORRS TOROS TORUS
TOTAL: CLAST TALEA TOLAR TOTAL
TOTEM: CLAST TORTE TOTEM
TOUCH: CLAST TRICE TOUCH
TOUGH: CLAST TORTE TOYON TOUGH
TOWEL: CLAST TOILE TOLED TOWEL
TOWER: CLAST TORTE TOYER TOKER TOPER TONER
TOXIC: CLAST TRICE TONIC TOXIC
TOXIN: CLAST TORTE TOYON TOXIN
TRACE: CLAST THACK TRACE
TRACK: CLAST THACK TRACK
TRACT: CLAST REACT TRACT
TRADE: CLAST GRATE TRAVE TRADE
TRAIL: CLAST TRAIL
TRAIN: CLAST GRATE TRANK TRAIN
TRAIT: CLAST TRANT TRAIT
TRAMP: CLAST GRATE TRANK TRAMP
TRASH: CLAST TRASS TRASH
TRAWL: CLAST TRAIL TRAWL
TREAD: CLAST TATER TERGA TREAD
TREAT: CLAST ARIOT GREAT TREAT
TREND: CLAST TORTE TRIED TREND
TRIAD: CLAST TATER TRONA TRIAD
TRIAL: CLAST TALEA TOLAR TRIAL
TRIBE: CLAST TORTE TRIKE TRINE TRIPE TRIDE
TRICE: CLAST TRICE
TRICK: CLAST TRICE TRICK
TRIED: CLAST TORTE TRIED
TRIPE: CLAST TORTE TRIKE TRINE TRIPE
TRITE: CLAST TORTE TRITE
TROLL: CLAST TOILE TROLL
TROOP: CLAST TORTE TROOP
TROPE: CLAST TORTE TROKE TRODE TROPE
TROUT: CLAST REBIT PRUNT TROUT
TROVE: CLAST TORTE TROKE TRODE TROPE TROVE
TRUCE: CLAST TRICE TRUCE
TRUCK: CLAST TRICE TRUCK
TRUER: CLAST TORTE TRIED TRUER
TRULY: CLAST TOILE TRULL TRULY
TRUMP: CLAST TORTE TRUMP
TRUNK: CLAST TORTE TRUMP TRUNK
TRUSS: CLAST TOUSE TRUSS
TRUST: CLAST REIST BURST TRUST
TRUTH: CLAST TORTE TRUTH
TRYST: CLAST REIST BURST FROST TRYST
TUBAL: CLAST TALEA TOLAR TYPAL TIDAL TUBAL
TUBER: CLAST TORTE TRIED TUYER TUNER TUBER
TULIP: CLAST TOILE TULIP
TULLE: CLAST TOILE TUPLE TULLE
TUMOR: CLAST TORTE TROOP TUMOR
TUNIC: CLAST TRICE TONIC TUNIC
TURBO: CLAST TORTE THROB TURBO
TUTOR: CLAST TORTE TUTOR
TWANG: CLAST GRATE THAGI TWANG
TWEAK: CLAST TATER TEGUA TWEAK
TWEED: CLAST TORTE TEEND THEED TWEED
TWEET: CLAST REBIT UNMET TWEET
TWICE: CLAST TRICE TWICE
TWINE: CLAST TORTE TENUE TWINE
TWIRL: CLAST TOILE THIRL TWIRL
TWIST: CLAST REIST HOIST QUIST TWIST
TWIXT: CLAST REBIT PINOT TWIXT
TYING: CLAST TORTE TIYIN TWINY TYING
UDDER: CLAST RONDE DRIER EDGER UDDER
ULCER: CLAST OLEIC ULCER
ULTRA: CLAST ALTER ULTRA
UMBRA: CLAST MARAE ARMOR UMBRA
UNCLE: CLAST LOCIE UNCLE
UNCUT: CLAST DICOT FECHT UNCUT
UNDER: CLAST RONDE NUDER UNDER
UNDID: CLAST RONDE UNDUG UNDID
UNDUE: CLAST RONDE UNDEE UNDUE
UNFED: CLAST RONDE INDEW UNFED
UNFIT: CLAST REBIT INWIT UNFIT
UNIFY: CLAST RONDE NYMPH UNIFY
UNION: CLAST RONDE GIPON INION UNION
UNITE: CLAST TORTE UNITE
UNITY: CLAST TORTE MINTY UNITY
UNLIT: CLAST GILET UNLIT
UNMET: CLAST REBIT UNMET
UNSET: CLAST SUINT UNSET
UNTIE: CLAST TORTE HYTHE UPTIE UNTIE
UNTIL: CLAST TOILE MILTY INTIL UNTIL
UNWED: CLAST RONDE INDEW UNWED
UNZIP: CLAST RONDE NYMPH UNPIN UNZIP
UPPER: CLAST RONDE FERER VIPER UPPER
UPSET: CLAST SUINT UPSET
URBAN: CLAST MARAE BROAD URBAN
URINE: CLAST RONDE URINE
USAGE: CLAST SNARE YSAME USAGE
USHER: CLAST DORES SKIER USHER
USING: CLAST DORES SPUNK USING
USUAL: CLAST SALLE LUMAS USUAL
USURP: CLAST DORES SMIRK USURP
UTILE: CLAST TOILE UTILE
UTTER: CLAST TORTE UTTER
VAGUE: CLAST MARAE DAINE GAUJE VAGUE
VALET: CLAST GALUT VALET
VALID: CLAST PALEA BALDY HALID VALID
VALOR: CLAST PALEA BALDY VALOR
VALUE: CLAST PALEA HALVE VALUE
VALVE: CLAST PALEA HALVE VALVE
VAPID: CLAST MARAE GANDY PAGOD VAPID
VAPOR: CLAST MARAE RANID PAYOR VAPOR
VAULT: CLAST GALUT FAULT HAULT VAULT
VAUNT: CLAST ARIOT GAUNT DAUNT HAUNT TAUNT
VEGAN: CLAST MARAE BEGAD VEGAN
VENOM: CLAST RONDE GENOM VENOM
VENUE: CLAST RONDE GENIE PENNE VENUE
VERGE: CLAST RONDE GERBE MERGE VERGE
VERSE: CLAST SOUSE PRESE HERSE VERSE
VERSO: CLAST SOUSE VERSO
VERVE: CLAST RONDE GERBE KERVE VERVE
VICAR: CLAST NACRE VICAR
VIDEO: CLAST RONDE GEOID VIDEO
VIGIL: CLAST OILED LINGY VIGIL
VIGOR: CLAST RONDE GROOM PIROG VIGOR
VILLA: CLAST PALEA MULLA VILLA
VINYL: CLAST OILED LINGY VINYL
VIOLA: CLAST PALEA IDOLA VIOLA
VIPER: CLAST RONDE FERER VIPER
VIRAL: CLAST PALEA LORAN FURAL GYRAL VIRAL
VIRUS: CLAST DORES KIRNS MIRVS VIRUS
VISIT: CLAST SUINT RESIT POSIT VISIT
VISOR: CLAST DORES SHORN VISOR
VISTA: CLAST TATES STIPA VISTA
VITAL: CLAST TALEA DOTAL VITAL
VIVID: CLAST RONDE DIPPY BIFID VIVID
VIXEN: CLAST RONDE HEMIN VIXEN
VOCAL: CLAST LACED VOCAL
VODKA: CLAST MARAE GONIA POOKA VODKA
VOGUE: CLAST RONDE BOGIE VOGUE
VOICE: CLAST YINCE DRICE JUICE VOICE
VOILA: CLAST PALEA IDOLA VOILA
VOMIT: CLAST REBIT INWIT VOMIT
VOTER: CLAST TORTE VOTER
VOUCH: CLAST YINCE POOCH GOUCH VOUCH
VOWEL: CLAST OILED LOVER VOXEL VOWEL
VYING: CLAST RONDE NYMPH VYING
WACKY: CLAST NACRE BACHA JACKY WACKY
WAFER: CLAST MARAE GAPER WAKER WAFER
WAGER: CLAST MARAE GAPER EAGER YAGER JAGER
WAGON: CLAST MARAE GANDY KAING WAGON
WAIST: CLAST SAIST WAIST
WAIVE: CLAST MARAE DAINE BAIZE WAIVE
WALTZ: CLAST TALEA WALTY WALTZ
WARTY: CLAST TATER YARTA PARTY WARTY
WASTE: CLAST TATES HASTE PASTE WASTE
WATCH: CLAST TACAN PATCH WATCH
WATER: CLAST TATER WATER
WAVER: CLAST MARAE GAPER WAKER WAFER WAVER
WAXEN: CLAST MARAE DAWEN WAKEN WAXEN
WEARY: CLAST DEARN MEARE WEARY
WEAVE: CLAST DEARN PEAVY HEAVE WEAVE
WEDGE: CLAST RONDE MIDGE JUDGE WEDGE
WEEDY: CLAST RONDE DEEDY WEEDY
WEIGH: CLAST RONDE BEGEM WEIGH
WEIRD: CLAST RONDE DRIER WEIRD
WELCH: CLAST LOCIE WELCH
WELSH: CLAST LOUSE WELSH
WENCH: CLAST YINCE BENCH HENCH DENCH KENCH
WHACK: CLAST BRACE KIACK QUACK WHACK
WHALE: CLAST LEARY DWALE WHALE
WHARF: CLAST DEARN HOARY PHARM WHARF
WHEAT: CLAST ARIOT GAUNT EXEAT WHEAT
WHEEL: CLAST OILED REBEL KNEEL WHEEL
WHELP: CLAST OILED GERLE KNELL WHELM WHELP
WHERE: CLAST RONDE GERBE FIERE WHERE
WHICH: CLAST YINCE WRICK WHICH
WHIFF: CLAST RONDE PIGMY BUFFI WHIFF
WHILE: CLAST OILED ERVIL GUILE WHILE
WHINE: CLAST RONDE NEIVE WHINE
WHINY: CLAST RONDE NYMPH WHINY
WHIRL: CLAST OILED GRILL WHIRL
WHISK: CLAST SOUSE BRISK WHISK
WHITE: CLAST TORTE UNITE WHITE
WHOLE: CLAST OILED BOGLE WHOLE
WHOOP: CLAST RONDE HIMBO WHOOF WHOOP
WHOSE: CLAST SOUSE OBESE WHOSE
WIDEN: CLAST RONDE INDEW WIDEN
WIDER: CLAST RONDE DRIER HIDER WIDER
WIDOW: CLAST RONDE DUOMO BIPOD WIDOW
WIDTH: CLAST TORTE MINTY FIFTH WIDTH
WIELD: CLAST OILED WIELD
WIGHT: CLAST REBIT PINOT MIDST HIGHT FIGHT
WILLY: CLAST OILED FILMY GILLY BILLY HILLY
WIMPY: CLAST RONDE PIGMY JIMPY WIMPY
WINCE: CLAST YINCE WINCE
WINCH: CLAST YINCE GINCH FINCH PINCH WINCH
WINDY: CLAST RONDE BUNDY KINDY WINDY
WISER: CLAST DORES SKIER WISER
WISPY: CLAST DORES SPUNK WISPY
WITCH: CLAST TRICE BITCH PITCH HITCH FITCH
WITTY: CLAST TORTE BUTTY KITTY NITTY DITTY
WOKEN: CLAST RONDE HOVEN WOMEN WOXEN WOKEN
WOMAN: CLAST MARAE HUMAN WOMAN
WOMEN: CLAST RONDE HOVEN WOMEN
WOODY: CLAST RONDE DOWDY WOODY
WOOER: CLAST RONDE MOWER WOOER
WOOLY: CLAST OILED WOOLY
WOOZY: CLAST RONDE GOMBO WOOPY WOOZY
WORDY: CLAST RONDE WORDY
WORLD: CLAST OILED WOULD WORLD
WORRY: CLAST RONDE MOORY WORRY
WORSE: CLAST SOUSE WORSE
WORST: CLAST REIST BURST WORST
WORTH: CLAST TORTE FORTY NORTH WORTH
WOULD: CLAST OILED WOULD
WOUND: CLAST RONDE WOUND
WOVEN: CLAST RONDE HOVEN WOVEN
WRACK: CLAST BRACE DRACO FRACK WRACK
WRATH: CLAST GRATE PRATY FRATI WRATH
WREAK: CLAST MARAE DEBAR WREAK
WRECK: CLAST YINCE PERCE WRECK
WREST: CLAST REIST TREST WREST
WRING: CLAST RONDE BRUIN IRING WRING
WRIST: CLAST REIST GRIST TRIST WRIST
WRITE: CLAST TORTE WRITE
WRONG: CLAST RONDE PRION WRONG
WROTE: CLAST TORTE WROTE
WRUNG: CLAST RONDE BRUIN WRUNG
WRYLY: CLAST OILED RUMLY WRYLY
YACHT: CLAST TACET YACHT
YEARN: CLAST DEARN YEARN
YEAST: CLAST REAST FEAST BEAST HEAST YEAST
YIELD: CLAST OILED WIELD BIELD YIELD
YOUNG: CLAST RONDE MOONY YOUNG
YOUTH: CLAST TORTE BOOTY YOUTH
ZEBRA: CLAST MARAE URENA HEJRA ZEBRA
ZESTY: CLAST TIRES STOPE FESTY YESTY ZESTY
ZONAL: CLAST PALEA LORAN MONAL ZONAL
Success: 2248
Fail: 67
Avg guess: 4.079
