ABACK: TALCS BRAKE ABACK
ABASE: TALCS SPIRE AMUSE ABASE
ABATE: TALCS ARENA GRUBS ABATE
ABBEY: TALCS DRONE KHAYA ABBEY
ABBOT: TALCS ARENA DUOMO ABBOT
ABHOR: TALCS DRONE MORAY AGGRO ABHOR
ABIDE: TALCS DRONE ABRIM ABIDE
ABLED: TALCS ROPEY BLITE ABLED
ABODE: TALCS DRONE ABODE
ABORT: TALCS ARENA LIMPA ABORT
ABOUT: TALCS ARENA DUOMO ABOUT
ABOVE: TALCS DRONE KIMBO ABOVE
ABUSE: TALCS SPIRE AMUSE ABUSE
ABYSS: TALCS DEARN KOMBU ABYSS
ACORN: TALCS CRINE ACORN
ACRID: TALCS CRINE SCRAP ACRID
ACTOR: TALCS ROTTE ACTOR
ACUTE: TALCS ROTTE ACUTE
ADAGE: TALCS DRONE ABRIM ADAGE
ADAPT: TALCS ARENA WIMPY ADAPT
ADEPT: TALCS ARENA AWETO ADEPT
ADMIN: TALCS DRONE UNDAM ADMIN
ADMIT: TALCS ARENA DUOMO ADMIT
ADOBE: TALCS DRONE ABODE ADOBE
ADOPT: TALCS ARENA DUOMO ADOPT
ADORE: TALCS DRONE ADORE
ADORN: TALCS DRONE ADORN
ADULT: TALCS PETTO LYART ADULT
AFFIX: TALCS DRONE GUIMP ZIMBI AFFIX
AFIRE: TALCS DRONE GUIMP AFIRE
AFOOT: TALCS ARENA DUOMO AFOOT
AFOUL: TALCS ANEAR ODIUM AFOUL
AFTER: TALCS ARENA APTER AFTER
AGAIN: TALCS DRONE UNMAN AGAIN
AGAPE: TALCS DRONE AGAZE AGAVE AGAPE
AGATE: TALCS ARENA GRUBS AGATE
AGENT: TALCS ARENA OGHAM AGENT
AGILE: TALCS ANEAR MOILE AGILE
AGING: TALCS DRONE BIGHA KAPOW AXING AGING
AGLOW: TALCS ROPEY ALGIN AGLOW
AGONY: TALCS DRONE AMONG AGONY
AGORA: TALCS DRONE AGORA
AGREE: TALCS DRONE GUIMP AYGRE AGREE
AHEAD: TALCS DRONE HIDED JEHAD AHEAD
AIDER: TALCS DRONE TEDDY AIDER
AISLE: TALCS SHALE AISLE
ALARM: TALCS ANEAR ALARM
ALBUM: TALCS ANEAR ODIUM ALBUM
ALERT: TALCS PETTO ALERT
ALGAE: TALCS ANEAR ALGAE
ALIBI: TALCS ANEAR ODIUM ALIBI
ALIEN: TALCS ANEAR ALONE ALIEN
ALIGN: TALCS ANEAR ALIGN
ALIKE: TALCS ANEAR MOILE ALIKE
ALIVE: TALCS ANEAR MOILE ALIKE ALIVE
ALLAY: TALCS ROPEY INLAY ALLAY
ALLEY: TALCS ROPEY ALLEY
ALLOT: TALCS PAGOD ALLOT
ALLOW: TALCS ROPEY ALGIN ALLOD ALLOW
ALLOY: TALCS ROPEY ALLOY
ALOFT: TALCS PETTO FLOGS ALOFT
ALONE: TALCS ANEAR ALONE
ALONG: TALCS ANEAR ALIGN ALONG
ALOOF: TALCS ANEAR ODIUM ALOOF
ALOUD: TALCS ANEAR ODIUM ALOUD
ALPHA: TALCS ANEAR IGAPO ALPHA
ALTAR: TALCS PETTO DITAL ALTAR
ALTER: TALCS PETTO ALTER
AMASS: TALCS DEARN SOPHY SKUGS AMASS
AMAZE: TALCS DRONE AGAZE AMAZE
AMBER: TALCS DRONE REBAR AMBER
AMBLE: TALCS ANEAR MOILE AMBLE
AMEND: TALCS DRONE AMEND
AMISS: TALCS DEARN KOMBU AMIAS AMISS
AMITY: TALCS ARENA DUOMO AMBIT AMITY
AMONG: TALCS DRONE AMONG
AMPLE: TALCS ANEAR MOILE AMBLE AMPLE
AMPLY: TALCS ANEAR ODIUM AMPLY
AMUSE: TALCS SPIRE AMUSE
ANGEL: TALCS ANEAR KIDGE ANGEL
ANGER: TALCS DRONE MINAR ANGER
ANGLE: TALCS ANEAR KIDGE ANGLE
ANGRY: TALCS DRONE UNARM INFRA ANGRY
ANGST: TALCS STARE QUOIT ANGST
ANIME: TALCS DRONE NIVAL ANIME
ANKLE: TALCS ANEAR KIDGE ANKLE
ANNEX: TALCS DRONE GENUA ANNEX
ANNOY: TALCS DRONE WIGAN BONZA ANNOY
ANNUL: TALCS ANEAR ANNUL
ANODE: TALCS DRONE ANODE
ANTIC: TALCS ROTTE ANTIC
ANVIL: TALCS ANEAR ANNUL ANVIL
AORTA: TALCS ARENA ATRIA AORTA
APART: TALCS ARENA APART
APHID: TALCS DRONE APAID APHID
APING: TALCS DRONE BIGHA KAPOW APING
APNEA: TALCS DRONE GENUA APNEA
APPLE: TALCS ANEAR MOILE APPLE
APPLY: TALCS ANEAR ODIUM ALKYL APPLY
APRON: TALCS DRONE NORMA APRON
APTLY: TALCS PETTO APTLY
ARBOR: TALCS DRONE BLITZ ARBOR
ARDOR: TALCS DRONE ARDOR
ARENA: TALCS DRONE CHUFF ARENA
ARGUE: TALCS DRONE GUAVA ARGUE
ARISE: TALCS SPIRE ARISE
ARMOR: TALCS DRONE BLITZ ARMOR
AROMA: TALCS DRONE SABHA AROMA
AROSE: TALCS SPIRE ERASE AROSE
ARRAY: TALCS DRONE AMIGA ARRAH ARRAY
ARROW: TALCS DRONE BLITZ ARMOR ARROW
ARSON: TALCS SPIRE ROOSA ARSON
ARTSY: TALCS STARE ARTSY
ASCOT: TALCS TORTE ASCOT
ASHEN: TALCS SPIRE ASKED ASHEN
ASIDE: TALCS SPIRE ANISE ASIDE
ASKEW: TALCS SPIRE ASKED ASKEW
ASSAY: TALCS SPIRE MUSHY ASSAY
ASSET: TALCS STARE VESTA ASSET
ATOLL: TALCS PETTO FLOGS ATOLL
ATONE: TALCS ARENA ATONE
ATTIC: TALCS ROTTE ATTIC
AUDIO: TALCS DRONE AIDED AUDIO
AUDIT: TALCS ARENA DUOMO AUDIT
AUGUR: TALCS DRONE MURRI FUBAR AUGUR
AUNTY: TALCS ARENA AUNTY
AVAIL: TALCS ANEAR IGAPO AVAIL
AVERT: TALCS ARENA AVERT
AVIAN: TALCS DRONE UNMAN SWIVE AVIAN
AVOID: TALCS DRONE AVOID
AWAIT: TALCS ARENA WIMPY AWAIT
AWAKE: TALCS DRONE AGAZE AWAKE
AWARD: TALCS DRONE ULAMA AWARD
AWARE: TALCS DRONE GUIMP REHAB AWARE
AWASH: TALCS SPIRE MUSHY ABASH AWASH
AWFUL: TALCS ANEAR ODIUM AWFUL
AWOKE: TALCS DRONE KIMBO AWOKE
AXIAL: TALCS ANEAR PYGAL AXIAL
AXIOM: TALCS DRONE GIMPY AXIOM
AXION: TALCS DRONE WIGAN UNFIX AXION
AZURE: TALCS DRONE GUIMP AZURE
BACON: TALCS CORED MACHO BACON
BADGE: TALCS GYRED EMBOW BADGE
BADLY: TALCS GYRED MADLY BADLY
BAGEL: TALCS GYRED BAGEL
BAGGY: TALCS GYRED BUNJE BAGGY
BAKER: TALCS GYRED ROWME PAVEN BHAJI BAKER
BALER: TALCS HYPED BALER
BALMY: TALCS HYPED ROBLE BALKY BALMY
BANAL: TALCS GYRED NIKAB BANAL
BANJO: TALCS GYRED MANIA BANJO
BARGE: TALCS GYRED PAMPA BARGE
BARON: TALCS GYRED MIKVA BARON
BASAL: TALCS LESBO BASAL
BASIC: TALCS OURIE BASIC
BASIL: TALCS LESBO BASAL BASIL
BASIN: TALCS SYREN OXIMS BASIN
BASIS: TALCS REINK DAMPY OASIS BASIS
BASTE: TALCS SEITY WHEEP BASTE
BATCH: TALCS CROWN HIMBO BATCH
BATHE: TALCS RHINE BATHE
BATON: TALCS RHINE WOMBY BATON
BATTY: TALCS RHINE PUTTO BATTA BATTY
BAWDY: TALCS GYRED BIDDY BAWDY
BAYOU: TALCS GYRED PUNKY BAYOU
BEACH: TALCS BRAKE BEACH
BEADY: TALCS DRONE HIDED BEADY
BEARD: TALCS DRONE TEDDY HEARD BEARD
BEAST: TALCS STARE FUBSY BEAST
BEECH: TALCS IRONE CHECK BEECH
BEEFY: TALCS RONDE WIMPY FUZEE BEEFY
BEFIT: TALCS ROUEN FITTE BEFIT
BEGAN: TALCS DRONE GENUA BEGAN
BEGAT: TALCS ARENA PEATY BEGAT
BEGET: TALCS ROUEN DEBIT BEGET
BEGIN: TALCS RONDE HEMIN PEKIN BEGIN
BEGUN: TALCS RONDE HEMIN EEVEN BEGUN
BEING: TALCS RONDE HEMIN BEING
BELCH: TALCS HUMID FUBSY BELCH
BELIE: TALCS DOGIE DEBBY BELIE
BELLE: TALCS DOGIE BIKES BELLE
BELLY: TALCS DOGIE PUNKY FUBSY BELLY
BELOW: TALCS DOGIE RUMBO BELON BELOW
BENCH: TALCS IRONE DWEEB BENCH
BERET: TALCS ROUEN EMBER BERET
BERRY: TALCS RONDE FERER BUMPH BERRY
BERTH: TALCS ROUEN PEIZE DERTH BERTH
BESET: TALCS SIEUR PONTY BESET
BETEL: TALCS FOUET LITER BETEL
BEVEL: TALCS GOIER DEBEL BEZEL BEVEL
BEZEL: TALCS GOIER DEBEL BEZEL
BIBLE: TALCS GOIER DEXIE BIBLE
BICEP: TALCS MOIRE DICEY BICEP
BIDDY: TALCS RONDE DWAUM GRUBS BIDDY
BIGOT: TALCS ROUEN BIPOD BIGOT
BILGE: TALCS DOGIE BILGE
BILLY: TALCS DOGIE MUHLY FUBSY BILLY
BINGE: TALCS RONDE WEIGH GRUBS BINGE
BINGO: TALCS RONDE PINGO BINGO
BIOME: TALCS RONDE CHIMP BIOME
BIRCH: TALCS IRONE BIRCH
BIRTH: TALCS ROUEN FIGHT DEBBY BIRTH
BISON: TALCS SIREN BISON
BITTY: TALCS ROUEN FIGHT DWEEB BITTY
BLACK: TALCS CHAPE SABHA BLACK
BLADE: TALCS ANEAR MEDLE BLADE
BLAME: TALCS ANEAR MEDLE BLAME
BLAND: TALCS ANEAR BLINK BLAND
BLANK: TALCS ANEAR BLINK BLANK
BLARE: TALCS ANEAR REPEG FLARE BLARE
BLAST: TALCS SLEPT BLAST
BLAZE: TALCS ANEAR MEDLE GLAZE BLAZE
BLEAK: TALCS ANEAR DUOMI WHEAL BLEAK
BLEAT: TALCS PETTO ALERT BLEAT
BLEED: TALCS GOIER DEBEL BLEED
BLEEP: TALCS GOIER DEBEL BLEEP
BLEND: TALCS GOIER NEUME KNELL BLEND
BLESS: TALCS GOIER SEELY PLEBS BLESS
BLIMP: TALCS GOIER BUNDY BLIMP
BLIND: TALCS GOIER BUNDY BLIND
BLINK: TALCS GOIER BUNDY BLINK
BLISS: TALCS GOIER SPAMS BLISS
BLITZ: TALCS FOUET BLITZ
BLOAT: TALCS PETTO FLOGS BLOAT
BLOCK: TALCS KUBIE BLOCK
BLOKE: TALCS GOIER BLOWN BLOKE
BLOND: TALCS GOIER KONDO BLOND
BLOOD: TALCS GOIER KONDO BLOOD
BLOOM: TALCS GOIER KONDO BLOOP BLOOM
BLOWN: TALCS GOIER KONDO BLOWN
BLUER: TALCS GOIER FEUED BLUER
BLUFF: TALCS GOIER BUMPY BLUNK BLUFF
BLUNT: TALCS FOUET BLUNT
BLURB: TALCS GOIER DUMBO BLURB
BLURT: TALCS FOUET BLUNT BLURT
BLUSH: TALCS SPIEL FLUSH BLUSH
BOARD: TALCS DRONE HOARD BOARD
BOAST: TALCS STARE GABBA BOAST
BOBBY: TALCS RONDE BUMPY GLOZE BOBBY
BONEY: TALCS RONDE LYMPH BONEY
BONGO: TALCS RONDE BOOGY BONGO
BONUS: TALCS DONER GIMPY KHAZI BONUS
BOOBY: TALCS RONDE BUMPY GLOZE FLANK BOOBY
BOOST: TALCS SIEUR GOSHT BOOST
BOOTH: TALCS ROUEN MYTHI FOWTH BOOTH
BOOTY: TALCS ROUEN MYTHI BAZOO BOOTY
BOOZE: TALCS RONDE GIMPY ZOWEE BOOZE
BOOZY: TALCS RONDE BUMPY GLOZE BOOZY
BORAX: TALCS DRONE MORAY BORAK BORAX
BORNE: TALCS RONDE BORNE
BOSOM: TALCS SIREN BUMPH BOSOM
BOSSY: TALCS SIREN BUMPH BOSKY BOSSY
BOTCH: TALCS HOIED PRONG BOTCH
BOUGH: TALCS RONDE BUMPY BOUGH
BOULE: TALCS GOIER DUMPY BANJO BOULE
BOUND: TALCS RONDE WHUMP BOUND
BOWEL: TALCS GOIER WAVED BOWEL
BOXER: TALCS RONDE WHUMP KIRBY BOXER
BRACE: TALCS BRAKE BRACE
BRAID: TALCS DRONE FRAUD BRAID
BRAIN: TALCS DRONE BRAAI BRAIN
BRAKE: TALCS DRONE GUAVA ZIMBS BRAKE
BRAND: TALCS DRONE GRAND BRAND
BRASH: TALCS SPIRE ROOSA BRASH
BRASS: TALCS DEARN BUMPY GAWKY BRASS
BRAVE: TALCS DRONE GUAVA BRAVE
BRAVO: TALCS DRONE BLITZ BRAVO
BRAWL: TALCS ANEAR BRAID BRAWL
BRAWN: TALCS DRONE BRAAI BRAWN
BREAD: TALCS DRONE BLEAK BREAD
BREAK: TALCS DRONE FUBAR BREAK
BREED: TALCS RONDE DRIER GRUBS BREED
BRIAR: TALCS DRONE AMIGA FRIAR BRIAR
BRIBE: TALCS RONDE BEIGE BRIBE
BRICK: TALCS IRONE WASPY BRICK
BRIDE: TALCS RONDE GENIP BRIDE
BRIEF: TALCS RONDE FERER GRUBS BRIEF
BRINE: TALCS RONDE DUING BRINE
BRING: TALCS RONDE IBRIK BRINY BRING
BRINK: TALCS RONDE IBRIK BRINK
BRINY: TALCS RONDE IBRIK BRINY
BRISK: TALCS SIREN FUBSY BRISK
BROAD: TALCS DRONE AROID BROAD
BROIL: TALCS GOIER BROIL
BROKE: TALCS RONDE PROBE BROME BROKE
BROOD: TALCS RONDE DROOK BROOD
BROOK: TALCS RONDE GROOM PROOF BROOK
BROOM: TALCS RONDE GROOM VROOM BROOM
BROTH: TALCS ROUEN WROOT FROTH BROTH
BROWN: TALCS RONDE GIPON FRORN BROWN
BRUNT: TALCS ROUEN GRUBS BRUNT
BRUSH: TALCS SIREN FUBSY BRUSK BRUSH
BRUTE: TALCS ROUEN ERUPT BRUTE
BUDDY: TALCS RONDE DWAUM FUBSY BUDDY
BUDGE: TALCS RONDE BEDIM BUDGE
BUGGY: TALCS RONDE PIGMY VUGHY FUGGY BUGGY
BUGLE: TALCS GOIER BUGLE
BUILD: TALCS GOIER BUNDY BUILD
BUILT: TALCS FOUET GRUBS BUILT
BULGE: TALCS DOGIE GELEE BULGE
BULKY: TALCS DOGIE HIPLY BULKY
BULLY: TALCS DOGIE HIPLY BULLY
BUNCH: TALCS IRONE HOMED BUNCH
BUNNY: TALCS RONDE PIING NEBEL BUNNY
BURLY: TALCS GOIER DUMBO BURLY
BURNT: TALCS ROUEN BURNT
BURST: TALCS SIEUR BRUSH BURST
BUSED: TALCS SIREN DUMPY FUSED BUSED
BUSHY: TALCS SIREN BUMPH BUSHY
BUTCH: TALCS HOIED KOMBU BUTCH
BUTTE: TALCS ROUEN FITTS BUTTE
BUXOM: TALCS RONDE BUMPH BUXOM
BUYER: TALCS RONDE FERER BUMPH BUYER
BYLAW: TALCS ROPEY BYLAW
CABAL: TALCS CRUVE CABAL
CABBY: TALCS CORED YAMUN CABBY
CABIN: TALCS CORED YAMUN CABIN
CABLE: TALCS CRUVE CAPLE CABLE
CACAO: TALCS CORED HANAP CACAO
CACHE: TALCS CORED CACHE
CACTI: TALCS CERTY CACTI
CADDY: TALCS CORED CANDY CADDY
CADET: TALCS CERTY CADET
CAGEY: TALCS CORED KINKY CAGEY
CAIRN: TALCS CORED CAURI CAIRN
CAMEL: TALCS CRUVE CAMEL
CAMEO: TALCS CORED CAMEO
CANAL: TALCS CRUVE CABAL CANAL
CANDY: TALCS CORED CANDY
CANNY: TALCS CORED YAMUN CANNY
CANOE: TALCS CORED CANOE
CANON: TALCS CORED HANAP CANON
CAPER: TALCS CORED PRONG CAPER
CAPUT: TALCS CERTY CAPOT CAPUT
CARAT: TALCS CERTY CARAT
CARGO: TALCS CORED ABOON CARGO
CAROL: TALCS CRUVE CAROL
CARRY: TALCS CORED INBYE CARVY CARRY
CARVE: TALCS CORED CARVE
CASTE: TALCS CANST CASTE
CATCH: TALCS CROWN CATCH
CATER: TALCS CERTY CATER
CATTY: TALCS CERTY CATTY
CAULK: TALCS CRUVE CAULD CAULK
CAUSE: TALCS OURIE CAUSE
CAVIL: TALCS CRUVE CAVIL
CEASE: TALCS SPARE CEASE
CEDAR: TALCS CRINE CEDAR
CELLO: TALCS CEROC CELLO
CHAFE: TALCS CRINE EMOVE CHAFE
CHAFF: TALCS CRINE FOAMY CHAFF
CHAIN: TALCS CRINE CHAIN
CHAIR: TALCS CRINE UNRIG CHAIR
CHALK: TALCS CROME CLANK CHALK
CHAMP: TALCS CRINE FOAMY CHAMP
CHANT: TALCS ROTTE FLANK CHANT
CHAOS: TALCS CRAME PYOID CHAOS
CHARD: TALCS CRINE KHAYA DRIER CHARD
CHARM: TALCS CRINE KHAYA DRIER CHARM
CHART: TALCS ROTTE CRAFT CHART
CHASE: TALCS SPARE CEASE CHASE
CHASM: TALCS SPARE CHASM
CHEAP: TALCS CRINE CHEAP
CHEAT: TALCS ROTTE CHEAT
CHECK: TALCS IRONE CHECK
CHEEK: TALCS MOIRE HEXED CHEEP CHEEK
CHEER: TALCS MOIRE PREED CHEER
CHESS: TALCS ROUEN KEMPY TOWSE CHESS
CHEST: TALCS CROUT CHEST
CHICK: TALCS IRONE CHICK
CHIDE: TALCS MOIRE GRIND CHIDE
CHIEF: TALCS MOIRE CHIEF
CHILD: TALCS ULYIE CHIRL CHILI CHILD
CHILI: TALCS ULYIE CHIRL CHILI
CHILL: TALCS ULYIE CHIRL CHILL
CHIME: TALCS MOIRE CHIME
CHINA: TALCS CRINE CHINA
CHIRP: TALCS MOIRE UPTER CHIRP
CHOCK: TALCS IRONE COMPO CHOCK
CHOIR: TALCS MOIRE UNRIG CHOIR
CHOKE: TALCS MOIRE CHODE CHOKE
CHORD: TALCS MOIRE CHORD
CHORE: TALCS MOIRE OCHRE CHORE
CHOSE: TALCS COURE CHOSE
CHUCK: TALCS IRONE YUCCH CHUCK
CHUMP: TALCS MOIRE CHUMP
CHUNK: TALCS MOIRE CHYND CHUNK
CHURN: TALCS MOIRE CHURR CHURN
CHUTE: TALCS ROUEN CHUTE
CIDER: TALCS MOIRE DIRER CIDER
CIGAR: TALCS CRINE UNRIG CIGAR
CINCH: TALCS IRONE CAMPY CINCH
CIRCA: TALCS BRAKE CIRCA
CIVIC: TALCS MOIRE CUPID CYNIC CIVIC
CIVIL: TALCS ULYIE LOGIC CIVIL
CLACK: TALCS CHAPE CLACK
CLAIM: TALCS CROME CLAIM
CLAMP: TALCS CROME CLAMP
CLANG: TALCS CROME CLANK CLANG
CLANK: TALCS CROME CLANK
CLASH: TALCS PHYLE CLASH
CLASP: TALCS PHYLE CLASP
CLASS: TALCS DOYEN WHUMP CLASS
CLEAN: TALCS CROME CLEAN
CLEAR: TALCS CROME CLEAR
CLEAT: TALCS CRIPE CLEAT
CLEFT: TALCS PITOT CLEFT
CLERK: TALCS ULYIE CLERK
CLICK: TALCS KUBIE FLICK CLICK
CLIFF: TALCS ULYIE FLANK CLIFF
CLIMB: TALCS ULYIE FLANK CLIMB
CLING: TALCS ULYIE FLANK CLING
CLINK: TALCS ULYIE FLANK CLINK
CLOAK: TALCS CROME CHOLA CLOAK
CLOCK: TALCS KUBIE FLOCK CLOCK
CLONE: TALCS ULYIE NEVES CLONE
CLOSE: TALCS KNOLL CLOSE
CLOTH: TALCS PITOT CLOTH
CLOUD: TALCS ULYIE PAGOD CLOUD
CLOUT: TALCS PITOT CLOUT
CLOVE: TALCS ULYIE NEVES CLOVE
CLOWN: TALCS ULYIE ABOON CLOWN
CLUCK: TALCS KUBIE CLUCK
CLUED: TALCS ULYIE CLUED
CLUMP: TALCS ULYIE PAGOD CLUMP
CLUNG: TALCS ULYIE PAGOD CLUNG
COACH: TALCS BRAKE POACH COACH
COAST: TALCS TORTE COAST
COBRA: TALCS CRINE KHAYA COBRA
COCOA: TALCS CRINE FOAMY COCOA
COLON: TALCS CEROC COLON
COLOR: TALCS CEROC COLOR
COMET: TALCS ROUEN COVET COMET
COMFY: TALCS MOIRE COOMB COMFY
COMIC: TALCS MOIRE CYNIC COMIC
COMMA: TALCS CRINE FOAMY COMMA
CONCH: TALCS IRONE CORBY CONCH
CONDO: TALCS MOIRE PONGO CONVO CONDO
CONIC: TALCS MOIRE CYNIC CONIC
COPSE: TALCS COURE COSIE COPSE
CORAL: TALCS CROME CORAL
CORER: TALCS MOIRE VARDY CORER
CORNY: TALCS MOIRE BUCKO CORNY
COUCH: TALCS IRONE CLUMP COUCH
COUGH: TALCS MOIRE PONGO COUGH
COULD: TALCS ULYIE COULD
COUNT: TALCS ROUEN COUNT
COUPE: TALCS MOIRE BHUNA COUPE
COURT: TALCS ROUEN COURT
COVEN: TALCS MOIRE PYNED CHIVE COVEN
COVER: TALCS MOIRE VARDY COVER
COVET: TALCS ROUEN COVET
COVEY: TALCS MOIRE PYNED GLOZE COVEY
COWER: TALCS MOIRE VARDY ATOPY COWER
COYLY: TALCS ULYIE COYLY
CRACK: TALCS BRAKE COWED CRACK
CRAFT: TALCS ROTTE CRAFT
CRAMP: TALCS CRINE PONTY CRAMP
CRANE: TALCS CRINE CRANE
CRANK: TALCS CRINE CRANK
CRASH: TALCS SPARE CRASH
CRASS: TALCS CRAME WINGY SPEOS CRASS
CRATE: TALCS ROTTE CRATE
CRAVE: TALCS CRINE SPORK MEZZE CRAVE
CRAWL: TALCS CROME CRAAL CRAWL
CRAZE: TALCS CRINE SPORK MEZZE CRAZE
CRAZY: TALCS CRINE PONTY CRAZY
CREAK: TALCS CRINE CREAK
CREAM: TALCS CRINE CREAK CREAM
CREDO: TALCS MOIRE DYKON CREDO
CREED: TALCS MOIRE PREED CREED
CREEK: TALCS MOIRE PREED CREEK
CREEP: TALCS MOIRE PREED CREEP
CREME: TALCS MOIRE CREME
CREPE: TALCS MOIRE ERVEN CREPE
CREPT: TALCS ROUEN CHERT CREPT
CRESS: TALCS ROUEN DEISM CRESS
CREST: TALCS CROUT CREST
CRICK: TALCS IRONE WASPY BRICK CRICK
CRIED: TALCS MOIRE CRIER CRIED
CRIER: TALCS MOIRE CRIER
CRIME: TALCS MOIRE CRIME
CRIMP: TALCS MOIRE CRIMP
CRISP: TALCS COURE CRISP
CROAK: TALCS CRINE PONTY CROAK
CROCK: TALCS IRONE CHUFF CROCK
CRONE: TALCS MOIRE CRONE
CRONY: TALCS MOIRE CROON CRONK CRONY
CROOK: TALCS MOIRE CROON CROOK
CROSS: TALCS ROUEN WISPS CROSS
CROUP: TALCS MOIRE CROON CROUP
CROWD: TALCS MOIRE CROON CROUP CROWD
CROWN: TALCS MOIRE CROON CROWN
CRUDE: TALCS MOIRE ERVEN CRUDE
CRUEL: TALCS ULYIE CRUEL
CRUMB: TALCS MOIRE CRUMP CRUMB
CRUMP: TALCS MOIRE CRUMP
CRUSH: TALCS COURE CRUSY CRUSH
CRUST: TALCS CROUT CRUST
CRYPT: TALCS ROUEN CHIRT CRYPT
CUBIC: TALCS MOIRE CUPID CUBIC
CUMIN: TALCS MOIRE CUMIN
CURIO: TALCS MOIRE UNRIG CURIO
CURLY: TALCS ULYIE CURLY
CURRY: TALCS MOIRE CHURR CURRY
CURSE: TALCS COURE CURSE
CURVE: TALCS MOIRE ERVEN CURVE
CURVY: TALCS MOIRE GRIND CURVY
CUTIE: TALCS ROUEN CUTIE
CYBER: TALCS MOIRE PREED CURER CYBER
CYCLE: TALCS ULYIE LYCEE CYCLE
CYNIC: TALCS MOIRE CUPID CYNIC
DADDY: TALCS GYRED BIDDY DOWPS DADDY
DAILY: TALCS GYRED MADLY DAILY
DAIRY: TALCS GYRED DAIRY
DAISY: TALCS SYREN PASHM DAISY
DALLY: TALCS HYPED BALDY DALLY
DANCE: TALCS HENRY PAGOD DANCE
DANDY: TALCS GYRED BIDDY DANDY
DATUM: TALCS RHINE PUTTO DATUM
DAUNT: TALCS RHINE JUDGE DAUNT
DEALT: TALCS PETTO DEALT
DEATH: TALCS ARENA PEATY HOMED DEATH
DEBAR: TALCS DRONE WIRRA DEBAR
DEBIT: TALCS ROUEN FITTE BLEED DEBIT
DEBUG: TALCS RONDE BEIGY DEBUG
DEBUT: TALCS ROUEN FITTS DEBUT
DECAL: TALCS CROME FECAL DECAL
DECAY: TALCS CRINE BEEFY DECAY
DECOR: TALCS MOIRE DYKON DECOR
DECOY: TALCS MOIRE GECKO DECOY
DECRY: TALCS MOIRE DECRY
DEFER: TALCS RONDE DRIER DUPER DEFER
DEIGN: TALCS RONDE EIKED DEIGN
DEITY: TALCS ROUEN FITTE MEITH DEITY
DELAY: TALCS ROPEY BELAY DELAY
DELTA: TALCS PAGOD DELTA
DELVE: TALCS DOGIE DELVE
DEMON: TALCS RONDE DEVON DEMON
DEMUR: TALCS RONDE DRIER DEMUR
DENIM: TALCS RONDE WIMPY DENIM
DENSE: TALCS SIREN MENSE DENSE
DEPOT: TALCS ROUEN DEMPT DEPOT
DEPTH: TALCS ROUEN FITTE EMPTY DEPTH
DERBY: TALCS RONDE DRIER DERBY
DETER: TALCS ROUEN EMBER PETER DETER
DETOX: TALCS ROUEN DEMPT DETOX
DEUCE: TALCS IRONE DEUCE
DEVIL: TALCS GOIER DEXIE DEVIL
DIARY: TALCS DRONE DIRAM DIARY
DICEY: TALCS MOIRE DICEY
DIGIT: TALCS ROUEN FIGHT DIGIT
DILLY: TALCS DOGIE DILLY
DIMLY: TALCS GOIER DUMPY DIMLY
DINER: TALCS RONDE URNED DINER
DINGO: TALCS RONDE DUNNO DINGO
DINGY: TALCS RONDE DUNGY DINGY
DIODE: TALCS RONDE EPODE DIODE
DIRGE: TALCS RONDE KRUBI DIRGE
DIRTY: TALCS ROUEN FIGHT DIRTY
DISCO: TALCS PHONE CISCO DISCO
DITCH: TALCS HOIED DITCH
DITTO: TALCS ROUEN BIPOD DITTO
DITTY: TALCS ROUEN FIGHT DWEEB DITZY DITTY
DIVER: TALCS RONDE DRIER HAKAM DIVER
DIZZY: TALCS RONDE PRIMY DIZZY
DODGE: TALCS RONDE BEWIG PAMPA DODGE
DODGY: TALCS RONDE BUDDY DODGY
DOGMA: TALCS DRONE DOGMA
DOING: TALCS RONDE WHUMP DOING
DOLLY: TALCS DOGIE DOLOR DOLLY
DONOR: TALCS RONDE DONOR
DONUT: TALCS ROUEN NOTUM DONUT
DOPEY: TALCS RONDE WHOMP POKED DOPEY
DOUBT: TALCS ROUEN UMPTY DOUBT
DOUGH: TALCS RONDE BUDDY DOUGH
DOWDY: TALCS RONDE DHOWS DOWDY
DOWEL: TALCS GOIER WAVED DOWEL
DOWNY: TALCS RONDE WHUMP DOWNY
DOWRY: TALCS RONDE DOBRO DOWRY
DOZEN: TALCS RONDE ZAYIN DOZEN
DRAFT: TALCS ARENA WIFTY PAGOD DRAFT
DRAIN: TALCS DRONE DRAWN DRAIN
DRAKE: TALCS DRONE PAKKA DRAKE
DRAMA: TALCS DRONE DRAMA
DRANK: TALCS DRONE DRANK
DRAPE: TALCS DRONE PAKKA DRAPE
DRAWL: TALCS ANEAR BRAID DRAWL
DRAWN: TALCS DRONE DRAWN
DREAD: TALCS DRONE MINED DREAD
DREAM: TALCS DRONE MINED DREAM
DRESS: TALCS DONER GREYS DRESS
DRIED: TALCS RONDE DRIER DRIED
DRIER: TALCS RONDE DRIER
DRIFT: TALCS ROUEN FIGHT DRIFT
DRILL: TALCS GOIER BAWDY DRILL
DRINK: TALCS RONDE GRIND DRINK
DRIVE: TALCS RONDE KRUBI DRIVE
DROIT: TALCS ROUEN WROOT DROPT DROIT
DROLL: TALCS GOIER UPBOW FLORY DROLL
DRONE: TALCS RONDE DRONE
DROOL: TALCS GOIER UPBOW DROOL
DROOP: TALCS RONDE DROOK GRUBS DROOP
DROSS: TALCS DONER SPEOS DROSS
DROVE: TALCS RONDE HAKAM DROVE
DROWN: TALCS RONDE BROND DROWN
DRUID: TALCS RONDE MURRY DRUID
DRUNK: TALCS RONDE GRIND DRUNK
DRYER: TALCS RONDE DRIER DREER DRYER
DRYLY: TALCS GOIER DUMBO DRYLY
DUCHY: TALCS MOIRE CHYND DUCHY
DULLY: TALCS DOGIE DULLY
DUMMY: TALCS RONDE PRIMY DUMMY
DUMPY: TALCS RONDE PRIMY DUMPY
DUNCE: TALCS IRONE BUMPH DUNCE
DUSKY: TALCS SIREN BUMPH GAWKY DUSKY
DUSTY: TALCS SIEUR GISMO DEBBY DUSTY
DUTCH: TALCS HOIED DUTCH
DUVET: TALCS ROUEN MUTED DUVET
DWARF: TALCS DRONE DIRAM DWARF
DWELL: TALCS GOIER NEUME WHELK DWELL
DWELT: TALCS FOUET BLENT DWELT
DYING: TALCS RONDE BUDDY DYING
EAGER: TALCS GYRED REWET EAGER
EAGLE: TALCS GYRED PAGLE EAGLE
EARLY: TALCS GYRED EARLY
EARTH: TALCS RHINE HATER EARTH
EASEL: TALCS LESBO EASLE EASEL
EATEN: TALCS RHINE PONTY EATEN
EATER: TALCS RHINE PAGOD EMEUS EATER
EBONY: TALCS RONDE ENJOY EBONY
ECLAT: TALCS ECLAT
EDICT: TALCS HOIED EDICT
EDIFY: TALCS RONDE BEIGY EDIFY
EERIE: TALCS RONDE BEIGE EERIE
EGRET: TALCS ROUEN EMBER EGRET
EIGHT: TALCS ROUEN FITTE EIGHT
EJECT: TALCS HOIED ERECT EJECT
EKING: TALCS RONDE HEMIN KYDST EKING
ELATE: TALCS PETTO SABHA ELATE
ELBOW: TALCS GOIER BLOWN ELBOW
ELDER: TALCS GOIER FEUED ELDER
ELECT: TALCS ELECT
ELEGY: TALCS GOIER BUGLE ELEGY
ELFIN: TALCS GOIER DEXIE ELFIN
ELIDE: TALCS GOIER BAWDY ELIDE
ELITE: TALCS FOUET LETHE ELITE
ELOPE: TALCS GOIER BLOWN PLOYE ELOPE
ELUDE: TALCS GOIER NEUME ELUDE
EMAIL: TALCS ANEAR MEDLE EMAIL
EMBED: TALCS RONDE BEIGY EBBED EMBED
EMBER: TALCS RONDE FERER BUMPH EMBER
EMCEE: TALCS MOIRE CHYME EMCEE
EMPTY: TALCS ROUEN FITTE EMPTY
ENACT: TALCS NOTER ENACT
ENDOW: TALCS RONDE DEVON ENDOW
ENEMA: TALCS DRONE GENUA ENEMA
ENEMY: TALCS RONDE HEMIN ENEMY
ENJOY: TALCS RONDE ENJOY
ENNUI: TALCS RONDE PENNY ENNUI
ENSUE: TALCS SIREN MENSE ENSUE
ENTER: TALCS ROUEN ENTER
ENTRY: TALCS ROUEN DYERS ENTRY
ENVOY: TALCS RONDE ENJOY ENVOY
EPOCH: TALCS IRONE EPOCH
EPOXY: TALCS RONDE BEMIX EPOXY
EQUAL: TALCS ANEAR DEFOG EQUAL
EQUIP: TALCS RONDE WIMPY EQUIP
ERASE: TALCS SPIRE ERASE
ERECT: TALCS HOIED ERECT
ERODE: TALCS RONDE ERODE
ERROR: TALCS RONDE BREER ERROR
ERUPT: TALCS ROUEN ERUPT
ESSAY: TALCS SPIRE ASKED ESSAY
ESTER: TALCS SIEUR ESTER
ETHER: TALCS ROUEN EMBER ETHER
ETHIC: TALCS ROUEN HEFTS ETHIC
ETHOS: TALCS ROUEN EYOTS ETHOS
ETUDE: TALCS ROUEN ETUDE
EVADE: TALCS DRONE ABRIM EVADE
EVENT: TALCS ROUEN PIETY EVENT
EVERY: TALCS RONDE FERER EVERY
EVICT: TALCS HOIED EVICT
EVOKE: TALCS RONDE CHIMP OXEYE EVOKE
EXACT: TALCS NOTER EPACT EXACT
EXALT: TALCS PETTO ALERT EXALT
EXCEL: TALCS ULYIE CHELP EXCEL
EXERT: TALCS ROUEN PEIZE EVERT EXERT
EXILE: TALCS GOIER BAWDY EXILE
EXIST: TALCS SIEUR FEIGN EXIST
EXPEL: TALCS GOIER DEBEL KNEEL EXPEL
EXTOL: TALCS FOUET METOL EXTOL
EXTRA: TALCS ARENA EXTRA
EXULT: TALCS FOUET EXULT
EYING: TALCS RONDE HEMIN KYDST EYING
FABLE: TALCS GYRED WHOMP FABLE
FACET: TALCS CERTY FACET
FAINT: TALCS RHINE PAGOD FAINT
FAIRY: TALCS GYRED ROSHI FAIRY
FAITH: TALCS RHINE FUBSY FAITH
FALSE: TALCS SPEOS CHIVE FALSE
FANCY: TALCS HENRY NIXED FANCY
FANNY: TALCS GYRED PUNKY NYAFF FANNY
FARCE: TALCS HENRY FARCE
FATAL: TALCS LYTED KRONE FATAL
FATTY: TALCS RHINE PUTTO BATTA FATTY
FAULT: TALCS LYTED FIGHT FAULT
FAUNA: TALCS GYRED MANIA NAKFA FAUNA
FAVOR: TALCS GYRED ROBIN FAVOR
FEAST: TALCS STARE FUBSY FEAST
FECAL: TALCS CROME FECAL
FEIGN: TALCS RONDE HEMIN FEIGN
FELLA: TALCS ROPEY BELGA FELLA
FELON: TALCS DOGIE RUMBO FELON
FEMME: TALCS RONDE GUIMP FEMME
FEMUR: TALCS RONDE FERER FEMUR
FENCE: TALCS IRONE BUMPH FENCE
FERAL: TALCS ANEAR FERAL
FERRY: TALCS RONDE FERER FERRY
FETAL: TALCS PETTO FETAL
FETCH: TALCS HOIED KERVE FETCH
FETID: TALCS ROUEN FITTE FETID
FETUS: TALCS ROUEN DUETS FETUS
FEVER: TALCS RONDE FERER VEILY FEVER
FEWER: TALCS RONDE FERER VEILY FEWER
FIBER: TALCS RONDE FERER VIBEX FIBER
FIBRE: TALCS RONDE BEIGE FIBRE
FICUS: TALCS ROUEN SKYFS FICUS
FIELD: TALCS GOIER DEXIE FUBSY FIELD
FIEND: TALCS RONDE EIKED PIEND FIEND
FIERY: TALCS RONDE FERER FIERY
FIFTH: TALCS ROUEN FIGHT FIFTH
FIFTY: TALCS ROUEN FIGHT FIFTY
FIGHT: TALCS ROUEN FIGHT
FILER: TALCS DOGIE VIPER MILER FILER
FILET: TALCS MONEY GILET FILET
FILLY: TALCS DOGIE MUHLY FUBSY FILLY
FILMY: TALCS DOGIE MUHLY FILMY
FILTH: TALCS MONEY FILTH
FINAL: TALCS ANEAR LUNGI FUBSY FINAL
FINCH: TALCS IRONE CAMPY GAWKY FINCH
FINER: TALCS RONDE NIMBS VINER FINER
FIRST: TALCS SIEUR FIRST
FISHY: TALCS SIREN MOSKS DISHY FISHY
FIXER: TALCS RONDE FERER VIBEX FIXER
FIZZY: TALCS RONDE PIGMY BIZZY FIZZY
FJORD: TALCS RONDE DROOK FJORD
FLACK: TALCS CHAPE SABHA FLACK
FLAIL: TALCS ANEAR DUOMI KIBLA FLAIL
FLAIR: TALCS ANEAR FLAIR
FLAKE: TALCS ANEAR MEDLE GLAZE FLAKE
FLAKY: TALCS ANEAR DUOMI FLAKY
FLAME: TALCS ANEAR MEDLE BLAME FLAME
FLANK: TALCS ANEAR BLINK FLANK
FLARE: TALCS ANEAR REPEG FLARE
FLASH: TALCS SHALE FUBSY FLASH
FLASK: TALCS SHALE FLASK
FLECK: TALCS KUBIE CLECK FLECK
FLEET: TALCS FOUET FLEET
FLESH: TALCS SPIEL ENSUE FLESH
FLICK: TALCS KUBIE FLICK
FLIER: TALCS GOIER FLIER
FLING: TALCS GOIER FUBSY FLING
FLINT: TALCS FOUET PONTY FLINT
FLIRT: TALCS FOUET PONTY FLIRT
FLOAT: TALCS PETTO FLOGS FLOAT
FLOCK: TALCS KUBIE FLOCK
FLOOD: TALCS GOIER KONDO BLOOD FLOOD
FLOOR: TALCS GOIER FLOOR
FLORA: TALCS ANEAR BRAID FLORA
FLOSS: TALCS GOIER SWOPS FLOSS
FLOUR: TALCS GOIER FLOOR FLOUR
FLOUT: TALCS FOUET FLOUT
FLOWN: TALCS GOIER KONDO BLOWN FLOWN
FLUFF: TALCS GOIER BUMPY FLUFF
FLUID: TALCS GOIER DUMPY FLUID
FLUKE: TALCS GOIER NEUME FLUKE
FLUME: TALCS GOIER NEUME FUBSY FLUME
FLUNG: TALCS GOIER FLUNG
FLUNK: TALCS GOIER BUMPY FLUFF FLUNK
FLUSH: TALCS SPIEL FLUSH
FLUTE: TALCS FOUET FLUTE
FLYER: TALCS GOIER FEUED FLYER
FOAMY: TALCS DRONE GIMPY FOAMY
FOCAL: TALCS CROME LEAFS FOCAL
FOCUS: TALCS ROUEN CHUFF FOCUS
FOGGY: TALCS RONDE BUMPY KIDGE FOGGY
FOIST: TALCS SIEUR OJIME CHUFF FOIST
FOLIO: TALCS DOGIE FOLIO
FOLLY: TALCS DOGIE WHELP LEAFS FOLLY
FORAY: TALCS DRONE MORAY FORAY
FORCE: TALCS IRONE FORCE
FORGE: TALCS RONDE GRIEF FORGE
FORGO: TALCS RONDE GURRY BORGO FORGO
FORTE: TALCS ROUEN FORTE
FORTH: TALCS ROUEN BOOFY FORTH
FORTY: TALCS ROUEN BOOFY FORTY
FORUM: TALCS RONDE GURRY FORUM
FOUND: TALCS RONDE WHUMP BOUND FOUND
FOYER: TALCS RONDE WHUMP KIRBY FOYER
FRAIL: TALCS ANEAR BRAID GRAIL FRAIL
FRAME: TALCS DRONE GUAVA ZIMBS FRAME
FRANK: TALCS DRONE GOPIK FRANK
FRAUD: TALCS DRONE FRAUD
FREAK: TALCS DRONE FUBAR FREAK
FREED: TALCS RONDE DRIER GRUBS PREED FREED
FREER: TALCS RONDE FERER FREER
FRESH: TALCS SIREN EPODE FRESH
FRIAR: TALCS DRONE AMIGA FRIAR
FRIED: TALCS RONDE DRIER WASPY FRIED
FRILL: TALCS GOIER BAWDY FLANK FRILL
FRISK: TALCS SIREN FUBSY FRISK
FRITZ: TALCS ROUEN FIGHT FRITZ
FROCK: TALCS IRONE CHUFF FROCK
FROND: TALCS RONDE BROND FROND
FRONT: TALCS ROUEN INTRO FRONT
FROST: TALCS SIEUR WHOOP FROST
FROTH: TALCS ROUEN WROOT FROTH
FROWN: TALCS RONDE GIPON FRORN FROWN
FROZE: TALCS RONDE PROBE SWERF FROZE
FRUIT: TALCS ROUEN FRUIT
FUDGE: TALCS RONDE BEDIM POLJE FUDGE
FUGUE: TALCS RONDE GUIMP FUGUE
FULLY: TALCS DOGIE HIPLY BULLY FULLY
FUNGI: TALCS RONDE PIING FUNGI
FUNKY: TALCS RONDE PIING HAJJI FUNKY
FUNNY: TALCS RONDE PIING NEBEL FUNNY
FUROR: TALCS RONDE GROOM FUROR
FURRY: TALCS RONDE GUIMP HAFIZ FURRY
FUSSY: TALCS SIREN BUMPH GAWKY FUSSY
FUZZY: TALCS RONDE PIGMY HAFIZ FUZZY
GAFFE: TALCS GYRED JUMBY GAFFE
GAILY: TALCS GYRED GAYLY GAILY
GAMER: TALCS GYRED PYGMY GAMER
GAMMA: TALCS GYRED AMMON GAMMA
GAMUT: TALCS RHINE PUTTO MAZUT GAMUT
GASSY: TALCS SYREN PASHM BASSY GASSY
GAUDY: TALCS GYRED GAUDY
GAUGE: TALCS GYRED JUMBY GAUGE
GAUNT: TALCS RHINE JUDGE GAUNT
GAUZE: TALCS GYRED JUMBY GAUGE GAUZE
GAVEL: TALCS GYRED GAVEL
GAWKY: TALCS GYRED WHUMP GAWKY
GAYER: TALCS GYRED GAYER
GAYLY: TALCS GYRED GAYLY
GAZER: TALCS GYRED PYGMY GAZER
GECKO: TALCS MOIRE GECKO
GEEKY: TALCS RONDE WIMPY FUZEE GEEKY
GEESE: TALCS SIREN GOOPY GEESE
GENIE: TALCS RONDE WEIGH GENIE
GENRE: TALCS RONDE GENRE
GHOST: TALCS SIEUR GOSHT GHOST
GHOUL: TALCS GOIER BUXOM GHOUL
GIANT: TALCS ARENA HIANT GIANT
GIDDY: TALCS RONDE DWAUM GRUBS GIDDY
GIPSY: TALCS SIREN MOSKS GIPSY
GIRLY: TALCS GOIER GIRLY
GIRTH: TALCS ROUEN FIGHT GIRTH
GIVEN: TALCS RONDE HEMIN GIVEN
GIVER: TALCS RONDE FERER BUMPH GAWKY GIVER
GLADE: TALCS ANEAR MEDLE BLADE GLADE
GLAND: TALCS ANEAR BLINK LLANO GLAND
GLARE: TALCS ANEAR REPEG GLARE
GLASS: TALCS FLAME PANGA GLASS
GLAZE: TALCS ANEAR MEDLE GLAZE
GLEAM: TALCS ANEAR DUOMI GLEAM
GLEAN: TALCS ANEAR GLEAN
GLIDE: TALCS GOIER DUMKY GLIDE
GLINT: TALCS FOUET LIGHT GLINT
GLOAT: TALCS PETTO FLOGS GLOAT
GLOBE: TALCS GOIER BOVID GLOBE
GLOOM: TALCS GOIER BUXOM GLOOM
GLORY: TALCS GOIER GROWL GLORY
GLOSS: TALCS GOIER SPAMS GLOSS
GLOVE: TALCS GOIER BOVID GLOVE
GLYPH: TALCS GOIER GHYLL GLYPH
GNASH: TALCS SPIRE MUSHY ABASH GNASH
GNOME: TALCS RONDE WHOMP GNOME
GODLY: TALCS GOIER GOOLD GODLY
GOING: TALCS RONDE GIMPY GOING
GOLEM: TALCS DOGIE GOLEM
GOLLY: TALCS DOGIE LOLOG GOLLY
GONAD: TALCS DRONE HAMZA GONAD
GONER: TALCS RONDE ZIMBS HONER GONER
GOODY: TALCS RONDE DHOWS BEFOG GOODY
GOOEY: TALCS RONDE GYMPS GOOEY
GOOFY: TALCS RONDE BUMPY KIDGE GOOFY
GOOSE: TALCS SIREN GOOPY GOOSE
GORGE: TALCS RONDE GRIEF GORGE
GOUGE: TALCS RONDE GIMPY GOUGE
GOURD: TALCS RONDE DOBRO GOURD
GRACE: TALCS BRAKE GRACE
GRADE: TALCS DRONE GRADE
GRAFT: TALCS ARENA WIFTY PAGOD GRAFT
GRAIL: TALCS ANEAR BRAID GRAIL
GRAIN: TALCS DRONE BRAAI GRAIN
GRAND: TALCS DRONE GRAND
GRANT: TALCS ARENA PAGOD GRANT
GRAPE: TALCS DRONE GUAVA PAMPA GRAPE
GRAPH: TALCS DRONE AMIGA GRAPY GRAPH
GRASP: TALCS SPIRE GRASP
GRASS: TALCS DEARN BUMPY GUISE GRASS
GRATE: TALCS ARENA FUGIO GRATE
GRAVE: TALCS DRONE GUAVA GRAVE
GRAVY: TALCS DRONE AMIGA GRAPY GRAVY
GRAZE: TALCS DRONE GUAVA PAMPA GRAZE
GREAT: TALCS ARENA GREAT
GREED: TALCS RONDE DRIER GRUBS GREED
GREEN: TALCS RONDE GIVEN GREEN
GREET: TALCS ROUEN EMBER FREET GREET
GRIEF: TALCS RONDE FERER GRUBS GRIEF
GRILL: TALCS GOIER GRILL
GRIME: TALCS RONDE BEIGE KEMPS GRIME
GRIMY: TALCS RONDE GUIMP GRIMY
GRIND: TALCS RONDE GRIND
GRIPE: TALCS RONDE BEIGE KEMPS GRIPE
GROAN: TALCS DRONE GROAN
GROIN: TALCS RONDE GIPON GROIN
GROOM: TALCS RONDE GROOM
GROPE: TALCS RONDE PROBE GROPE
GROSS: TALCS DONER GRIPS WHISK GROSS
GROUP: TALCS RONDE GROOM GROUF GROUP
GROUT: TALCS ROUEN GROUT
GROVE: TALCS RONDE PROBE SWERF GROVE
GROWL: TALCS GOIER GROWL
GROWN: TALCS RONDE GIPON GROWN
GRUEL: TALCS GOIER GRUEL
GRUFF: TALCS RONDE GUIMP GRUFF
GRUNT: TALCS ROUEN GRUBS GRUNT
GUARD: TALCS DRONE ULAMA GUARD
GUAVA: TALCS DRONE GUIMP GUAVA
GUESS: TALCS DONER KEMPY SHEWS GUESS
GUEST: TALCS SIEUR QUEST GUEST
GUIDE: TALCS RONDE EXUDE GUIDE
GUILD: TALCS GOIER GLIFF GUILD
GUILE: TALCS GOIER DUMKY GUILE
GUILT: TALCS FOUET GRUBS GUILT
GUISE: TALCS SIREN OUPHE GUISE
GULCH: TALCS HUMID CULCH GULCH
GULLY: TALCS DOGIE GULPH GULFY GULLY
GUMBO: TALCS RONDE BUMPH GUMBO
GUMMY: TALCS RONDE PIGMY GUMMY
GUPPY: TALCS RONDE PIGMY GYPPY GUPPY
GUSTO: TALCS SIEUR GISMO GUSTO
GUSTY: TALCS SIEUR GISMO GUSTY
GYPSY: TALCS SIREN BUMPH POPSY GYPSY
HABIT: TALCS RHINE HABIT
HAIRY: TALCS GYRED ROSHI HAIRY
HALVE: TALCS HYPED HALVE
HANDY: TALCS GYRED BIDDY PLUSH HANDY
HAPPY: TALCS GYRED PUNKY MYTHY HAPPY
HARDY: TALCS GYRED BUMPH HARDY
HAREM: TALCS GYRED ROPER WAREZ HAREM
HARPY: TALCS GYRED BAKRA MARVY HARPY
HARRY: TALCS GYRED BAKRA PAMPA HARRY
HARSH: TALCS SYREN MARSH HARSH
HASTE: TALCS SEITY WHEEP HASTE
HASTY: TALCS SEITY NYMPH HASTY
HATCH: TALCS CROWN HIMBO HATCH
HATER: TALCS RHINE HATER
HAUNT: TALCS RHINE HAUNT
HAUTE: TALCS RHINE BATHE HAUTE
HAVEN: TALCS GYRED KNOWN UMPHS HAVEN
HAVOC: TALCS CORED MACHO HAVOC
HAZEL: TALCS GYRED BAVIN HAZEL
HEADY: TALCS DRONE HIDED HEADY
HEARD: TALCS DRONE TEDDY HEARD
HEART: TALCS ARENA PEART FEART HEART
HEATH: TALCS ARENA PEATY HOMED HEATH
HEAVE: TALCS DRONE AGAZE HEAME HEAVE
HEAVY: TALCS DRONE KHAYA HEAPY HEAVY
HEDGE: TALCS RONDE BEDIM WHEAL HEDGE
HEFTY: TALCS ROUEN FITTE HEFTY
HEIST: TALCS SIEUR FEIGN HEIST
HELIX: TALCS DOGIE KELIM HELIX
HELLO: TALCS DOGIE RUMBO JELLO HELLO
HENCE: TALCS IRONE BUMPH HENCE
HERON: TALCS RONDE PEEOY HERON
HILLY: TALCS DOGIE MUHLY HILLY
HINGE: TALCS RONDE WEIGH HINGE
HIPPO: TALCS RONDE BUMPH HIPPO
HIPPY: TALCS RONDE PIGMY YAHOO HIPPY
HITCH: TALCS HOIED HITCH
HOARD: TALCS DRONE HOARD
HOBBY: TALCS RONDE BUMPY YAHOO HOBBY
HOIST: TALCS SIEUR OJIME CHUFF HOIST
HOLLY: TALCS DOGIE WHELP HOLLO HOLLY
HOMER: TALCS RONDE WHUMP HOMER
HONEY: TALCS RONDE LYMPH HONEY
HONOR: TALCS RONDE HONOR
HORDE: TALCS RONDE BORDE HORDE
HORNY: TALCS RONDE SPUMY HORNY
HORSE: TALCS SIREN WHOMP HORSE
HOTEL: TALCS FOUET SABHA HOTEL
HOTLY: TALCS FOUET LOTTO HOTLY
HOUND: TALCS RONDE WHUMP HOUND
HOUSE: TALCS SIREN GOOPY DUMBO HOUSE
HOVEL: TALCS GOIER WAVED HOVEL
HOVER: TALCS RONDE WHUMP HOVER
HOWDY: TALCS RONDE DHOWS HOWDY
HUMAN: TALCS DRONE UNMAN HUMAN
HUMID: TALCS RONDE PRIMY HUMID
HUMOR: TALCS RONDE GROOM HUMOR
HUMPH: TALCS RONDE PIGMY BUMPH HUMPH
HUMUS: TALCS DONER SUMPH HUMUS
HUNCH: TALCS IRONE HOMED HUNCH
HUNKY: TALCS RONDE PIING HAJJI HUNKY
HURRY: TALCS RONDE GUIMP HAFIZ HURRY
HUSKY: TALCS SIREN BUMPH HUSKY
HUSSY: TALCS SIREN BUMPH HUSKY HUSHY HUSSY
HUTCH: TALCS HOIED HUTCH
HYDRO: TALCS RONDE DROOK HYDRO
HYENA: TALCS DRONE HEAME HYENA
HYMEN: TALCS RONDE HEMIN HYMEN
HYPER: TALCS RONDE FERER BUMPH HYPER
ICILY: TALCS ULYIE ICILY
ICING: TALCS MOIRE HUNKY ICING
IDEAL: TALCS ANEAR DUOMI IDEAL
IDIOM: TALCS RONDE HUMID IDIOM
IDIOT: TALCS ROUEN BIPOD IDIOT
IDLER: TALCS DOGIE FIBER IDLER
IDYLL: TALCS GOIER DUMPY IDYLL
IGLOO: TALCS DOGIE IGLOO
ILIAC: TALCS CROME ILIAC
IMAGE: TALCS DRONE AGAZE PEAGE IMAGE
IMBUE: TALCS RONDE GUIMP IMBUE
IMPEL: TALCS GOIER KINDY IMPEL
IMPLY: TALCS GOIER DUMPY IMPLY
INANE: TALCS DRONE UMIAK INANE
INBOX: TALCS RONDE GUIMP INBOX
INCUR: TALCS MOIRE RICIN INCUR
INDEX: TALCS RONDE EIKED INDEW INDEX
INEPT: TALCS ROUEN PIETY INEPT
INERT: TALCS ROUEN DYERS INERT
INFER: TALCS RONDE GIVEN INFER
INGOT: TALCS ROUEN BIONT INGOT
INLAY: TALCS ROPEY INLAY
INLET: TALCS MONEY INLET
INNER: TALCS RONDE NIMBS INNER
INPUT: TALCS ROUEN PUNTY INPUT
INTER: TALCS ROUEN ENTER INTER
INTRO: TALCS ROUEN INTRO
IONIC: TALCS MOIRE CYNIC IONIC
IRATE: TALCS ARENA FUGIO IRATE
IRONY: TALCS RONDE GIPON IRONY
ISLET: TALCS SPLIT ISLET
ISSUE: TALCS SIREN OUPHE ISSUE
ITCHY: TALCS ROUEN DICTY ITCHY
IVORY: TALCS RONDE GROOM IVORY
JAUNT: TALCS RHINE JUDGE JAUNT
JAZZY: TALCS GYRED PUNKY JAMBU JAZZY
JELLY: TALCS DOGIE PUNKY FUBSY WELLY JELLY
JERKY: TALCS RONDE FERER KHAPH JERKY
JETTY: TALCS ROUEN FITTE POLJE JETTY
JEWEL: TALCS GOIER DEBEL LIVEN JEWEL
JIFFY: TALCS RONDE PIGMY BIZZY JIFFY
JOINT: TALCS ROUEN JANNY JOINT
JOIST: TALCS SIEUR OJIME JOIST
JOKER: TALCS RONDE WHUMP KIRBY JOKER
JOLLY: TALCS DOGIE WHELP LEAFS MOLLY JOLLY
JOUST: TALCS SIEUR GISMO JOUST
JUDGE: TALCS RONDE BEDIM POLJE JUDGE
JUICE: TALCS IRONE JUICE
JUICY: TALCS IRONE CHICK JUICY
JUMBO: TALCS RONDE BUMPH GUMBO JUMBO
JUMPY: TALCS RONDE PIGMY SABHA JUMPY
JUNTA: TALCS ARENA PINTA JUNTA
JUNTO: TALCS ROUEN UMPTY JUNTO
JUROR: TALCS RONDE GROOM FUROR JUROR
KAPPA: TALCS GYRED MANIA PAKKA KAPPA
KARMA: TALCS GYRED MIKVA KARMA
KAYAK: TALCS GYRED PUNKY KAYAK
KEBAB: TALCS DRONE KHAYA KEBAB
KHAKI: TALCS DRONE GUIMP ZIMBI KHAKI
KINKY: TALCS RONDE PIING KHATS KINKY
KIOSK: TALCS SIREN MOSKS KIOSK
KITTY: TALCS ROUEN FIGHT DWEEB KITTY
KNACK: TALCS BRAKE WHINY KNACK
KNAVE: TALCS DRONE NIVAL KNAVE
KNEAD: TALCS DRONE AWNED KNEAD
KNEED: TALCS RONDE EIKED KNEED
KNEEL: TALCS GOIER DEBEL KNEEL
KNELT: TALCS FOUET BLENT KNELT
KNIFE: TALCS RONDE WEENY KNIVE KNIFE
KNOCK: TALCS IRONE KNOCK
KNOLL: TALCS GOIER KONDO KNOLL
KNOWN: TALCS RONDE GUIMP KNOWN
KOALA: TALCS ANEAR PULLY JHALA KOALA
KRILL: TALCS GOIER BAWDY FLANK KRILL
LABEL: TALCS GYRED BAVIN LABEL
LABOR: TALCS GYRED LUBRA LABOR
LADEN: TALCS GYRED LADEN
LADLE: TALCS GYRED LADLE
LAGER: TALCS GYRED LAGER
LANCE: TALCS IRONE LANCE
LANKY: TALCS GYRED LINUM LANKY
LAPEL: TALCS GYRED BAVIN HAZEL LAPEL
LAPSE: TALCS LESBO LAPSE
LARGE: TALCS GYRED LARGE
LARVA: TALCS GYRED JARUL LARVA
LASSO: TALCS LESBO LASSO
LATCH: TALCS LATCH
LATER: TALCS LYTED GRINS LATER
LATHE: TALCS LYTED TROTH LATHE
LATTE: TALCS LYTED TROTH LATTE
LAUGH: TALCS GYRED LAUGH
LAYER: TALCS GYRED LAYER
LEACH: TALCS CHAPE LEACH
LEAFY: TALCS ANEAR MEDLE FLUKY LEAFY
LEAKY: TALCS ANEAR MEDLE FLUKY LEAKY
LEANT: TALCS PETTO DEALT LEANT
LEAPT: TALCS PETTO LEAPT
LEARN: TALCS ANEAR LEARN
LEASE: TALCS SHALE LYASE LEASE
LEASH: TALCS SHALE LEASH
LEAST: TALCS SLEPT LEAST
LEAVE: TALCS ANEAR MEDLE LEAVE
LEDGE: TALCS GOIER BUGLE LEDGE
LEECH: TALCS KUBIE LEECH
LEERY: TALCS GOIER REFLY LEERY
LEFTY: TALCS FOUET LEFTY
LEGAL: TALCS ANEAR DEFOG LEGAL
LEGGY: TALCS GOIER BUGLE LEGGY
LEMON: TALCS GOIER BLOWN LEMON
LEMUR: TALCS GOIER LEMUR
LEPER: TALCS GOIER FEUED LEVER LEPER
LEVEL: TALCS GOIER DEBEL LIVEN LEVEL
LEVER: TALCS GOIER FEUED LEVER
LIBEL: TALCS GOIER KINDY BLITZ LIBEL
LIEGE: TALCS GOIER LIEGE
LIGHT: TALCS FOUET LIGHT
LIKEN: TALCS GOIER KINDY LIKEN
LILAC: TALCS COULD LILAC
LIMBO: TALCS GOIER VIOLD LIMBO
LIMIT: TALCS FOUET LIGHT LIMIT
LINEN: TALCS GOIER KINDY LINEN
LINER: TALCS GOIER FLANK LINER
LINGO: TALCS GOIER LINGO
LIPID: TALCS GOIER DUMPY LIPID
LITHE: TALCS FOUET LETHE LYTHE LITHE
LIVER: TALCS GOIER FLANK LIVER
LIVID: TALCS GOIER DUMPY LIVID
LLAMA: TALCS ANEAR PULLY LLAMA
LOAMY: TALCS ANEAR DUOMI LOAMY
LOATH: TALCS PETTO LOATH
LOBBY: TALCS GOIER WOOLD PONTY LOBBY
LOCAL: TALCS CROME LEAFS LOCAL
LOCUS: TALCS GUILE LOCUS
LODGE: TALCS GOIER FONLY LODGE
LOFTY: TALCS FOUET LOFTY
LOGIC: TALCS ULYIE LOGIC
LOGIN: TALCS GOIER LOGOI LOGIN
LOOPY: TALCS GOIER WOOLD BUNKO LOOPY
LOOSE: TALCS SPIEL ENSUE LOOSE
LORRY: TALCS GOIER WORLD LORRY
LOSER: TALCS SPIEL REWON LOSER
LOUSE: TALCS SPIEL ENSUE LOUSE
LOUSY: TALCS SPIEL FLUSH LOUSY
LOVER: TALCS GOIER WOVEN LOVER
LOWER: TALCS GOIER WOVEN LOWER
LOWLY: TALCS GOIER WOOLD LOWLY
LOYAL: TALCS ANEAR GUIMP OFFAL LOYAL
LUCID: TALCS ULYIE LUDIC LUCID
LUCKY: TALCS ULYIE CURLY LUCKY
LUMEN: TALCS GOIER DEBEL FLUEY LUMEN
LUMPY: TALCS GOIER BUMPY LUMPY
LUNAR: TALCS ANEAR ULNAR LUNAR
LUNCH: TALCS KUBIE LURCH LUNCH
LUNGE: TALCS GOIER BUGLE LUNGE
LUPUS: TALCS GOIER BUSKS LUPUS
LURCH: TALCS KUBIE LURCH
LURID: TALCS GOIER MIRLY LURID
LUSTY: TALCS STILE GLOST LUSTY
LYING: TALCS GOIER FUBSY LYING
LYMPH: TALCS GOIER BUMPY LYMPH
LYNCH: TALCS KUBIE LYNCH
LYRIC: TALCS ULYIE LYRIC
MACAW: TALCS CORED GIMPY MACAW
MACHO: TALCS CORED MACHO
MACRO: TALCS CORED RACON MACRO
MADAM: TALCS GYRED DIVNA MADAM
MADLY: TALCS GYRED MADLY
MAFIA: TALCS GYRED MANIA MAFIA
MAGIC: TALCS CORED GIMPY MAGIC
MAGMA: TALCS GYRED NAKFA MAGMA
MAIZE: TALCS GYRED OVINE BAIZE MAIZE
MAJOR: TALCS GYRED ROBIN FAVOR MAJOR
MAKER: TALCS GYRED ROWME MAKER
MAMBO: TALCS GYRED MANIA MAMBO
MAMMA: TALCS GYRED MANIA BUTOH MAMMA
MAMMY: TALCS GYRED PUNKY JAMBU HAMMY MAMMY
MANGA: TALCS GYRED NAKFA PANGA MANGA
MANGE: TALCS GYRED VAGUE MANGE
MANGO: TALCS GYRED NAKFA HANGI MANGO
MANGY: TALCS GYRED BUNJE MANGY
MANIA: TALCS GYRED MANIA
MANIC: TALCS CORED GIMPY MANIC
MANLY: TALCS GYRED LINUM MANLY
MANOR: TALCS GYRED ROBIN MANOR
MAPLE: TALCS GYRED WHOMP MAPLE
MARCH: TALCS HENRY PARCH MARCH
MARRY: TALCS GYRED BAKRA PAMPA MARRY
MARSH: TALCS SYREN MARSH
MASON: TALCS SYREN OXIMS MASON
MASSE: TALCS SYREN SMUSH MASSE
MATCH: TALCS CROWN HIMBO MATCH
MATEY: TALCS RHINE DIMBO MATEY
MAUVE: TALCS GYRED OVINE MAUVE
MAXIM: TALCS GYRED MANIA MAXIM
MAYBE: TALCS GYRED FAYNE MAYBE
MAYOR: TALCS GYRED ROSHI MAYOR
MEALY: TALCS ANEAR MEDLE MEALY
MEANT: TALCS ARENA MEANT
MEATY: TALCS ARENA PEATY MEATY
MECCA: TALCS BRAKE MECCA
MEDAL: TALCS ANEAR DEFOG PEDAL MEDAL
MEDIA: TALCS DRONE HIDED MEDIA
MEDIC: TALCS MOIRE MEDIC
MELEE: TALCS DOGIE BIKES MELEE
MELON: TALCS DOGIE RUMBO MELON
MERCY: TALCS IRONE MERCY
MERGE: TALCS RONDE BEIGE VERGE MERGE
MERIT: TALCS ROUEN PEIZE MERIT
MERRY: TALCS RONDE FERER BUMPH MERRY
METAL: TALCS PETTO FETAL METAL
METER: TALCS ROUEN EMBER METER
METRO: TALCS ROUEN ERGOT METRO
MICRO: TALCS MOIRE MICRO
MIDGE: TALCS RONDE BEDIM MIDGE
MIDST: TALCS SIEUR MYOID MIDST
MIGHT: TALCS ROUEN FIGHT HAKAM MIGHT
MILKY: TALCS DOGIE MUHLY MILKY
MIMIC: TALCS MOIRE UNKID MIMIC
MINCE: TALCS IRONE WORMY MINCE
MINER: TALCS RONDE NIMBS MINER
MINIM: TALCS RONDE PIING MINIM
MINOR: TALCS RONDE MINOR
MINTY: TALCS ROUEN INNIT MINTY
MINUS: TALCS DONER GUIMP MINUS
MIRTH: TALCS ROUEN FIGHT DEBBY MIRTH
MISER: TALCS SIREN REWON MISER
MISSY: TALCS SIREN MOSKS MISSY
MOCHA: TALCS CRINE MOCHA
MODAL: TALCS ANEAR GUIMP MODAL
MODEL: TALCS GOIER WAVED ENJOY MODEL
MODEM: TALCS RONDE WHOMP MOVED MODEM
MOGUL: TALCS GOIER LOGGY MOGUL
MOIST: TALCS SIEUR OJIME MOIST
MOLAR: TALCS ROPEY BUXOM MOLAR
MOLDY: TALCS DOGIE MOLDY
MONEY: TALCS RONDE LYMPH MONEY
MONTH: TALCS ROUEN JANNY MONTH
MOODY: TALCS RONDE DHOWS BEFOG MOODY
MOOSE: TALCS SIREN GOOPY WARBS MOOSE
MORAL: TALCS ANEAR RUMPO MORAL
MORON: TALCS RONDE SPUMY MORON
MORPH: TALCS RONDE GURRY MORPH
MOSSY: TALCS SIREN BUMPH MOSSO MOSSY
MOTEL: TALCS FOUET SABHA MOTEL
MOTIF: TALCS ROUEN MYTHI MOTIF
MOTOR: TALCS ROUEN BOOFY MOTOR
MOTTO: TALCS ROUEN MYTHI MOTTO
MOULT: TALCS FOUET PAMPA MOULT
MOUND: TALCS RONDE WHUMP MOUND
MOUNT: TALCS ROUEN MOUNT
MOURN: TALCS RONDE SPUMY MOURN
MOUSE: TALCS SIREN GOOPY DUMBO MOUSE
MOUTH: TALCS ROUEN UMPTY MOUTH
MOVER: TALCS RONDE WHUMP VOMER MOVER
MOVIE: TALCS RONDE GIMPY BUXOM MOVIE
MOWER: TALCS RONDE WHUMP MOWER
MUCKY: TALCS MOIRE MUCKY
MUCUS: TALCS ROUEN SKYFS MUCUS
MUDDY: TALCS RONDE DWAUM MUDDY
MULCH: TALCS HUMID MULCH
MUMMY: TALCS RONDE PIGMY YUMMY MUMMY
MUNCH: TALCS IRONE HOMED MUNCH
MURAL: TALCS ANEAR RUMPO MURAL
MURKY: TALCS RONDE GUIMP MURKY
MUSHY: TALCS SIREN BUMPH MUSHY
MUSIC: TALCS COURE SUCKY MUSIC
MUSKY: TALCS SIREN BUMPH MUSSY MUSKY
MUSTY: TALCS SIEUR GISMO MUSTH MUSTY
MYRRH: TALCS RONDE GUIMP MYRRH
NADIR: TALCS GYRED ROSHI NADIR
NAIVE: TALCS GYRED OVINE NAIVE
NANNY: TALCS GYRED PUNKY NYAFF NANNY
NASAL: TALCS LESBO VASAL NASAL
NASTY: TALCS SEITY NYMPH NASTY
NATAL: TALCS LYTED KRONE NATAL
NAVAL: TALCS GYRED NIKAB NAVAL
NAVEL: TALCS GYRED BAVIN NAVEL
NEEDY: TALCS RONDE NEEDY
NEIGH: TALCS RONDE HEMIN NEIGH
NERDY: TALCS RONDE NERDY
NERVE: TALCS RONDE DUING NERVE
NEVER: TALCS RONDE GIVEN NEVER
NEWER: TALCS RONDE GIVEN NEWER
NEWLY: TALCS GOIER NEUME NEWLY
NICER: TALCS MOIRE DIRER NICER
NICHE: TALCS MOIRE NICHE
NIECE: TALCS IRONE WORMY NIECE
NIGHT: TALCS ROUEN INNIT NIGHT
NINJA: TALCS DRONE UNMAN NINJA
NINNY: TALCS RONDE PIING NYMPH NINNY
NINTH: TALCS ROUEN INNIT NINTH
NOBLE: TALCS GOIER DUMPY LOWNE NOBLE
NOBLY: TALCS GOIER WOOLD PONTY NOBLY
NOISE: TALCS SIREN NOISE
NOISY: TALCS SIREN KNISH NOISY
NOMAD: TALCS DRONE HAMZA NOMAD
NOOSE: TALCS SIREN MENSE NOOSE
NORTH: TALCS ROUEN NORTH
NOSEY: TALCS SIREN EXUDE NOSEY
NOTCH: TALCS HOIED PRONG NOTCH
NOVEL: TALCS GOIER WAVED HOVEL NOVEL
NUDGE: TALCS RONDE UNDEE NUDGE
NURSE: TALCS SIREN NURSE
NUTTY: TALCS ROUEN PUNTY NUTTY
NYLON: TALCS DOGIE PYLON NYLON
NYMPH: TALCS RONDE HUMPY NYMPH
OAKEN: TALCS GYRED KNOWN OAKEN
OBESE: TALCS SIREN GOOPY OBESE
OCCUR: TALCS MOIRE CROON OCCUR
OCEAN: TALCS CRINE ACNED OCEAN
OCTAL: TALCS CRIPE OCTAL
OCTET: TALCS ROUEN OCTET
ODDER: TALCS RONDE ORDER ODDER
ODDLY: TALCS GOIER KONDO DHOLL ODDLY
OFFAL: TALCS ANEAR GUIMP OFFAL
OFFER: TALCS RONDE BREER OFFER
OFTEN: TALCS ROUEN OFTEN
OLDEN: TALCS GOIER OLDEN
OLDER: TALCS GOIER OLDER
OLIVE: TALCS GOIER OLIVE
OMBRE: TALCS RONDE PROBE OMBRE
OMEGA: TALCS DRONE HOVEA OMEGA
ONION: TALCS RONDE GUIMP ONION
ONSET: TALCS SIEUR PONTY ONSET
OPERA: TALCS DRONE OPERA
OPINE: TALCS RONDE WHOMP OPINE
OPIUM: TALCS RONDE BUMPH OPIUM
OPTIC: TALCS ROUEN DICOT OPTIC
ORBIT: TALCS ROUEN WROOT ORBIT
ORDER: TALCS RONDE ORDER
ORGAN: TALCS DRONE ARGON ORGAN
OTHER: TALCS ROUEN FETTA OTHER
OTTER: TALCS ROUEN FETTA OTTER
OUGHT: TALCS ROUEN OUTGO OUGHT
OUNCE: TALCS IRONE BOEPS OUNCE
OUTDO: TALCS ROUEN OUTGO OUTDO
OUTER: TALCS ROUEN OUTER
OUTGO: TALCS ROUEN OUTGO
OVARY: TALCS DRONE MORAY OVARY
OVATE: TALCS ARENA PEATY QUATE OVATE
OVERT: TALCS ROUEN ERGOT OVERT
OVINE: TALCS RONDE WHOMP OVINE
OVOID: TALCS RONDE HUMID PYOID OVOID
OWING: TALCS RONDE GUIMP OHING OWING
OWNER: TALCS RONDE OWNER
OXIDE: TALCS RONDE EPODE OXIDE
OZONE: TALCS RONDE WHOMP OZONE
PADDY: TALCS GYRED BIDDY DOWPS PADDY
PAGAN: TALCS GYRED NAKFA PAGAN
PAINT: TALCS RHINE PAGOD PAINT
PALER: TALCS HYPED PALER
PALSY: TALCS SPEOS PALSA PALSY
PANEL: TALCS GYRED BAVIN PANEL
PANIC: TALCS CORED GIMPY PANIC
PANSY: TALCS SYREN PANSY
PAPAL: TALCS GYRED NIKAB LAHAL PAPAL
PAPER: TALCS GYRED ROWME PAVEN PAPER
PARER: TALCS GYRED ROPER PARER
PARKA: TALCS GYRED MIKVA PARKA
PARRY: TALCS GYRED BAKRA PAMPA PARRY
PARSE: TALCS SYREN PAMPA PARSE
PARTY: TALCS RHINE PONTY PARTY
PASTA: TALCS SEITY RHOMB PASTA
PASTE: TALCS SEITY WHEEP PASTE
PASTY: TALCS SEITY NYMPH PASTY
PATCH: TALCS CROWN HIMBO PATCH
PATIO: TALCS RHINE KATTI PATIO
PATSY: TALCS SEITY PATSY
PATTY: TALCS RHINE PUTTO PATTY
PAUSE: TALCS SYREN SMUSH PAUSE
PAYEE: TALCS GYRED MAWKY PAYEE
PAYER: TALCS GYRED FUBSY PAYER
PEACE: TALCS BRAKE PEACE
PEACH: TALCS BRAKE PEACH
PEARL: TALCS ANEAR REPEG PEARL
PECAN: TALCS CRINE ACNED PECAN
PEDAL: TALCS ANEAR DEFOG PEDAL
PENAL: TALCS ANEAR GENIP PENAL
PENCE: TALCS IRONE BUMPH PENCE
PENNE: TALCS RONDE WEIGH PENNE
PENNY: TALCS RONDE PENNY
PERCH: TALCS IRONE MERCY PERCH
PERIL: TALCS GOIER PERVE PERIL
PERKY: TALCS RONDE FERER KHAPH PERKY
PESKY: TALCS SIREN GOOPY PESKY
PESTO: TALCS SIEUR PONTY PESTO
PETAL: TALCS PETTO PETAL
PETTY: TALCS ROUEN FITTE POLJE PETTY
PHASE: TALCS SPIRE PHASE
PHONE: TALCS RONDE WHOMP PHONE
PHONY: TALCS RONDE GUIMP PHONO PHONY
PHOTO: TALCS ROUEN BIPOD PHOTO
PIANO: TALCS DRONE GUANO PIANO
PICKY: TALCS MOIRE CUPID PICKY
PIECE: TALCS IRONE JUICE PIECE
PIETY: TALCS ROUEN FITTE PIETY
PIGGY: TALCS RONDE PIGMY PIGGY
PILOT: TALCS MONEY PILOT
PINCH: TALCS IRONE CAMPY PINCH
PINEY: TALCS RONDE PENNY PINEY
PINKY: TALCS RONDE PIING PINKY
PINTO: TALCS ROUEN BIONT PINTO
PIPER: TALCS RONDE FERER BUMPH PAPAW PIPER
PIQUE: TALCS RONDE GUIMP PIQUE
PITCH: TALCS HOIED EMBOW PAGOD PITCH
PITHY: TALCS ROUEN FIGHT PITHY
PIVOT: TALCS ROUEN BIPOD PIVOT
PIXEL: TALCS GOIER KINDY BLITZ PIXEL
PIXIE: TALCS RONDE GUIMP PYXIE PIXIE
PIZZA: TALCS DRONE GUIMP KIPPA PIZZA
PLACE: TALCS CHAPE PLACE
PLAID: TALCS ANEAR DUOMI PLAID
PLAIN: TALCS ANEAR BLINK PLAIN
PLAIT: TALCS PETTO PLANT PLAIT
PLANE: TALCS ANEAR PLANE
PLANK: TALCS ANEAR BLINK FLANK PLANK
PLANT: TALCS PETTO PLANT
PLATE: TALCS PETTO PLATE
PLAZA: TALCS ANEAR PULLY PLAZA
PLEAD: TALCS ANEAR DUOMI PLEAD
PLEAT: TALCS PETTO PLEAT
PLIED: TALCS GOIER FLIED PLIED
PLIER: TALCS GOIER FLIER PLIER
PLUCK: TALCS KUBIE CLUCK PLUCK
PLUMB: TALCS GOIER BUMPY PLUMB
PLUME: TALCS GOIER NEUME FUBSY PLUME
PLUMP: TALCS GOIER BUMPY FLUMP PLUMP
PLUNK: TALCS GOIER BUMPY PLUNK
PLUSH: TALCS SPIEL PLUSH
POESY: TALCS SIREN GOOPY POESY
POINT: TALCS ROUEN JANNY POINT
POISE: TALCS SIREN OUPHE POISE
POKER: TALCS RONDE WHUMP POKER
POLAR: TALCS ROPEY POLAR
POLKA: TALCS ROPEY POLKA
POLYP: TALCS DOGIE WHELP POLYP
POOCH: TALCS IRONE COMPO POOCH
POPPY: TALCS RONDE BUMPY PRONG POPPY
PORCH: TALCS IRONE PORCH
POSER: TALCS SIREN EPHOR POSER
POSIT: TALCS SIEUR OJIME POSIT
POSSE: TALCS SIREN GOOPY POSSE
POUCH: TALCS IRONE CLUMP POUCH
POUND: TALCS RONDE WHUMP POUND
POUTY: TALCS ROUEN UMPTY POUTY
POWER: TALCS RONDE WHUMP POWER
PRANK: TALCS DRONE GOPIK PRANK
PRAWN: TALCS DRONE BRAAI PRAWN
PREEN: TALCS RONDE GIVEN PREEN
PRESS: TALCS DONER MURRI GRAPY PRESS
PRICE: TALCS IRONE PAGOD PRICE
PRICK: TALCS IRONE WASPY PRICK
PRIDE: TALCS RONDE GENIP PRIDE
PRIED: TALCS RONDE DRIER WASPY PRIED
PRIME: TALCS RONDE BEIGE PRIME
PRIMO: TALCS RONDE GROOM PRIMO
PRINT: TALCS ROUEN PRINT
PRIOR: TALCS RONDE GROOM PRIOR
PRISM: TALCS SIREN FUBSY PRISM
PRIVY: TALCS RONDE GUIMP PRIVY
PRIZE: TALCS RONDE BEIGE PRIME PRIZE
PROBE: TALCS RONDE PROBE
PRONE: TALCS RONDE KIDGE PRONE
PRONG: TALCS RONDE GIPON PRONG
PROOF: TALCS RONDE GROOM PROOF
PROSE: TALCS SIREN EPODE PROSE
PROUD: TALCS RONDE DROOK PROUD
PROVE: TALCS RONDE PROBE ROKER PROVE
PROWL: TALCS GOIER UPBOW PROWL
PROXY: TALCS RONDE GROOM FRORY PROXY
PRUDE: TALCS RONDE GENIP PRUDE
PRUNE: TALCS RONDE DUING PRUNE
PSALM: TALCS SHALE PSALM
PUBIC: TALCS MOIRE CUPID PUBIC
PUDGY: TALCS RONDE PRIMY PUDGY
PUFFY: TALCS RONDE PIGMY PUPPY PUFFY
PULPY: TALCS DOGIE HIPLY PULPY
PULSE: TALCS OUPED PULSE
PUNCH: TALCS IRONE HOMED BUNCH PUNCH
PUPAL: TALCS ANEAR GUIMP PUPAL
PUPIL: TALCS GOIER DUMPY LUPIN PUPIL
PUPPY: TALCS RONDE PIGMY PUPPY
PUREE: TALCS RONDE BEIGE WORRY PUREE
PURER: TALCS RONDE FERER WIRER PURER
PURGE: TALCS RONDE BEIGE PURGE
PURSE: TALCS SIREN WHOMP PERSE PURSE
PUSHY: TALCS SIREN BUMPH PUSHY
PUTTY: TALCS ROUEN JUTTY GRUBS VUTTY PUTTY
PYGMY: TALCS RONDE PIGMY PYGMY
QUACK: TALCS BRAKE WHINY QUACK
QUAIL: TALCS ANEAR DUOMI QUAIL
QUAKE: TALCS DRONE AGAZE HEAME QUAKE
QUALM: TALCS ANEAR DUOMI QUALM
QUARK: TALCS DRONE MURRI QUARK
QUART: TALCS ARENA KORAT QUART
QUASH: TALCS SPIRE MUSHY QUASH
QUASI: TALCS SPIRE ASSAI QUASI
QUEEN: TALCS RONDE HEMIN UNPEN QUEEN
QUEER: TALCS RONDE FERER BUMPH QUEER
QUELL: TALCS GOIER NEUME QUELL
QUERY: TALCS RONDE FERER EXURB QUERY
QUEST: TALCS SIEUR QUEST
QUEUE: TALCS RONDE GUIMP FUZEE QUEUE
QUICK: TALCS IRONE CHICK QUICK
QUIET: TALCS ROUEN MUTED QUIET
QUILL: TALCS GOIER BUNDY QUILL
QUILT: TALCS FOUET GRUBS QUILT
QUIRK: TALCS RONDE GUIMP QUIRK
QUITE: TALCS ROUEN FITTS QUITE
QUOTA: TALCS ARENA TITUP QUOTA
QUOTE: TALCS ROUEN QUOTE
QUOTH: TALCS ROUEN OUTGO QUOTH
RABBI: TALCS GYRED ROBIN RABBI
RABID: TALCS GYRED BENIS RABID
RACER: TALCS CORED RUMPY RACER
RADAR: TALCS GYRED ROSHI RADAR
RADII: TALCS GYRED ROSHI RADII
RADIO: TALCS GYRED ROSHI RADIO
RAINY: TALCS GYRED ROSHI RAINY
RAISE: TALCS SYREN RASSE RAISE
RAJAH: TALCS GYRED ROBIN RAJAH
RALLY: TALCS HYPED ROBLE RALLY
RALPH: TALCS HYPED RALPH
RAMEN: TALCS GYRED ROWME RAMEN
RANCH: TALCS HENRY RANCH
RANDY: TALCS GYRED DAIRY RANDY
RANGE: TALCS GYRED EAGRE RANGE
RAPID: TALCS GYRED BENIS RAPID
RARER: TALCS GYRED ROPER RARER
RASPY: TALCS SYREN RASPY
RATIO: TALCS RHINE RATIO
RATTY: TALCS RHINE RATOO RATTY
RAVEN: TALCS GYRED ROWME ZINKY RAVEN
RAYON: TALCS GYRED ROSHI RAYON
RAZOR: TALCS GYRED ROBIN RAUPO RAZOR
REACH: TALCS BRAKE REACH
REACT: TALCS NOTER REACT
READY: TALCS DRONE TEDDY READY
REALM: TALCS ANEAR REPEG REALO REALM
REARM: TALCS DRONE REBAR REARM
REBAR: TALCS DRONE REBAR
REBEL: TALCS GOIER REPEL FUBSY REBEL
REBUS: TALCS DONER MURRI RESUS REBUS
REBUT: TALCS ROUEN REBUT
RECAP: TALCS CRINE ACRED RECAP
RECUR: TALCS MOIRE PREED RECUR
RECUT: TALCS ROUEN RECUT
REEDY: TALCS RONDE REDDY REEDY
REFER: TALCS RONDE MIFFY REFER
REFIT: TALCS ROUEN MOTIF REFIT
REGAL: TALCS ANEAR FERAL REGAL
REHAB: TALCS DRONE REBAR REHAB
REIGN: TALCS RONDE REPIN REIGN
RELAX: TALCS ROPEY RELAX
RELAY: TALCS ROPEY RELAY
RELIC: TALCS CEROC RELIC
REMIT: TALCS ROUEN MOTIF REMIT
RENAL: TALCS ANEAR RENAL
RENEW: TALCS RONDE GAWKY RENEW
REPAY: TALCS DRONE REBAR REMAP REPAY
REPEL: TALCS GOIER REPEL
REPLY: TALCS GOIER REFLY REDLY REPLY
RERUN: TALCS RONDE REPIN REMEN RERUN
RESET: TALCS SIEUR PORTS RESET
RESIN: TALCS SIREN RESIN
RETCH: TALCS HOIED KERVE RETCH
RETRO: TALCS ROUEN RETRO
RETRY: TALCS ROUEN MOTIF RETRY
REUSE: TALCS SIREN EPODE GRESE REUSE
REVEL: TALCS GOIER REPEL FUBSY REVEL
REVUE: TALCS RONDE MIEVE REVUE
RHINO: TALCS RONDE RHINO
RHYME: TALCS RONDE MIEVE RHYME
RIDER: TALCS RONDE BIDDY RIDER
RIDGE: TALCS RONDE RIDGE
RIFLE: TALCS GOIER PERVE RIFLE
RIGHT: TALCS ROUEN RITZY RIGHT
RIGID: TALCS RONDE RIDGY RIGID
RIGOR: TALCS RONDE RUMBO RIGOR
RINSE: TALCS SIREN RINSE
RIPEN: TALCS RONDE REPIN RIPEN
RIPER: TALCS RONDE MIFFY RIVER RIPER
RISEN: TALCS SIREN RISEN
RISER: TALCS SIREN REWON RISER
RISKY: TALCS SIREN RISHI RISKY
RIVAL: TALCS ANEAR RUMPO RIVAL
RIVER: TALCS RONDE MIFFY RIVER
RIVET: TALCS ROUEN WIMPS RIVET
ROACH: TALCS BRAKE ROACH
ROAST: TALCS STARE BRAST ROAST
ROBIN: TALCS RONDE ROBIN
ROBOT: TALCS ROUEN BHOOT ROBOT
ROCKY: TALCS MOIRE BUCKO ROCKY
RODEO: TALCS RONDE BEDEW RODED RODEO
ROGER: TALCS RONDE GAWKY ROGER
ROGUE: TALCS RONDE WINGS ROGUE
ROOMY: TALCS RONDE FLUMP ROOMY
ROOST: TALCS SIEUR WHOOP ROOST
ROTOR: TALCS ROUEN BHOOT ROTOR
ROUGE: TALCS RONDE WINGS ROUGE
ROUGH: TALCS RONDE FLUMP ROUGH
ROUND: TALCS RONDE ROUND
ROUSE: TALCS SIREN EPODE ROUSE
ROUTE: TALCS ROUEN ROUTE
ROVER: TALCS RONDE GAWKY ROPER ROVER
ROWDY: TALCS RONDE ROWDY
ROWER: TALCS RONDE GAWKY ROWER
ROYAL: TALCS ANEAR RUMPO RORAL ROYAL
RUDDY: TALCS RONDE RUDDY
RUDER: TALCS RONDE BIDDY REDUX RUDER
RUGBY: TALCS RONDE RUGBY
RULER: TALCS DOGIE PUNKY RULER
RUMBA: TALCS DRONE MURRI JUMAR RUMBA
RUMOR: TALCS RONDE RUMBO RUMOR
RUPEE: TALCS RONDE MIEVE REBBE RUPEE
RURAL: TALCS ANEAR RUMPO RUGAL RURAL
RUSTY: TALCS SIEUR BRUSH RUSTY
SADLY: TALCS LESBO SADLY
SAFER: TALCS SYREN GAWKY FUBSY SAFER
SAINT: TALCS SEITY SAIST SAINT
SALAD: TALCS SPEOS PYOID SALAD
SALLY: TALCS SPEOS PYOID SALLY
SALON: TALCS SPEOS SALON
SALSA: TALCS SPEOS SALSA
SALTY: TALCS ROUTE SALTY
SALVE: TALCS SPEOS VEILY SALVE
SALVO: TALCS SPEOS SALVO
SANDY: TALCS SYREN SANDY
SANER: TALCS SYREN SANER
SAPPY: TALCS SYREN GISMO SAPPY
SASSY: TALCS SYREN GISMO SASSY
SATIN: TALCS SEITY SATIN
SATYR: TALCS SEITY SATYR
SAUCE: TALCS CHIVE SAUCE
SAUCY: TALCS CHIVE SAUCY
SAUNA: TALCS SYREN GENOA SAUNA
SAUTE: TALCS SEITY SAUTE
SAVOR: TALCS SYREN SAVOR
SAVOY: TALCS SYREN GISMO SAVOY
SAVVY: TALCS SYREN GISMO SAPPY SAVVY
SCALD: TALCS PHYLE WEDEL SCALD
SCALE: TALCS PHYLE SCALE
SCALP: TALCS PHYLE SCALP
SCALY: TALCS PHYLE SCALY
SCAMP: TALCS SPARE TUINA SCAMP
SCANT: TALCS TORTE SCANT
SCARE: TALCS SPARE SCARE
SCARF: TALCS SPARE SCARY SCARF
SCARY: TALCS SPARE SCARY
SCENE: TALCS COURE SYCEE SCENE
SCENT: TALCS CROUT SICHT SCENT
SCION: TALCS COURE SCOOP SCION
SCOFF: TALCS COURE SCOOP SCOFF
SCOLD: TALCS KNOLL SCOLD
SCONE: TALCS COURE SCOPE SCONE
SCOOP: TALCS COURE SCOOP
SCOPE: TALCS COURE SCOPE
SCORE: TALCS COURE SCORE
SCORN: TALCS COURE SCORN
SCOUR: TALCS COURE SCOUR
SCOUT: TALCS CROUT SCOUT
SCOWL: TALCS KNOLL SCOWL
SCRAM: TALCS SPARE WINGY SCRAB SCRAM
SCRAP: TALCS SPARE SCRAP
SCREE: TALCS COURE SCREE
SCREW: TALCS COURE SCREW
SCRUB: TALCS COURE SCRUB
SCRUM: TALCS COURE SCRUB SCRUM
SCUBA: TALCS SPARE SCHAV SCUBA
SEDAN: TALCS SPIRE DEMAN SEDAN
SEEDY: TALCS SIREN PODGY SEEDY
SEGUE: TALCS SIREN PODGY SEGUE
SEIZE: TALCS SIREN KEMPS SEIZE
SEMEN: TALCS SIREN VEHME SEMEN
SENSE: TALCS SIREN DONNE SENSE
SEPIA: TALCS SPIRE SEPIA
SERIF: TALCS SIREN SERIF
SERUM: TALCS SIREN VOUGE SERUM
SERVE: TALCS SIREN VOUGE SERVE
SETUP: TALCS SIEUR SETUP
SEVEN: TALCS SIREN VEHME SEVEN
SEVER: TALCS SIREN WHEEP VEXED SEVER
SEWER: TALCS SIREN WHEEP SEWER
SHACK: TALCS MEANY SHACK
SHADE: TALCS SPIRE VEHME SHAKE SHADE
SHADY: TALCS SPIRE HUNKY SHADY
SHAFT: TALCS STARE WHISK SHAFT
SHAKE: TALCS SPIRE VEHME SHAKE
SHAKY: TALCS SPIRE HUNKY SHAKY
SHALE: TALCS SHALE
SHALL: TALCS SHALE YSAME SHALL
SHALT: TALCS SLEPT SHALT
SHAME: TALCS SPIRE VEHME SHAME
SHANK: TALCS SPIRE HUNKY SHANK
SHAPE: TALCS SPIRE SHAPE
SHARD: TALCS SPIRE HUDNA SHARD
SHARE: TALCS SPIRE REWON SHARE
SHARK: TALCS SPIRE HUDNA SHARK
SHARP: TALCS SPIRE SOPRA SHARP
SHAVE: TALCS SPIRE VEHME SHAVE
SHAWL: TALCS SHALE SHAUL SHAWL
SHEAR: TALCS SPIRE WHELK SHEAR
SHEEN: TALCS SIREN VEHME SHEEN
SHEEP: TALCS SIREN WEEDY SKEEF SHEEP
SHEER: TALCS SIREN WHEEP SHEER
SHEET: TALCS SIEUR PWNED STEEK SHEET
SHEIK: TALCS SIREN KEMPS SHEIK
SHELF: TALCS SPIEL FOYLE SHELF
SHELL: TALCS SPIEL SHOWN SHELL
SHIED: TALCS SIREN SYPHS SHIED
SHIFT: TALCS SIEUR WHIFT SHIFT
SHINE: TALCS SIREN PHENE SHINE
SHINY: TALCS SIREN PLUNK SWING SHINY
SHIRE: TALCS SIREN WHEAL SHIRE
SHIRK: TALCS SIREN HUMOR SHIRK
SHIRT: TALCS SIEUR SPINK SHIRT
SHOAL: TALCS SHALE SHOAL
SHOCK: TALCS PHONE SHOCK
SHONE: TALCS SIREN DONNE SHONE
SHOOK: TALCS SIREN WOOPY SMOKO SHOOK
SHOOT: TALCS SIEUR WHOOP SHOOT
SHORE: TALCS SIREN WHOMP SHORE
SHORN: TALCS SIREN SWORN SHORN
SHORT: TALCS SIEUR PHONY SHORT
SHOUT: TALCS SIEUR NEMPT STOUT SHOUT
SHOVE: TALCS SIREN PODGY SHOVE
SHOWN: TALCS SIREN WOOSH SHOWN
SHOWY: TALCS SIREN WOOPY SHOWY
SHREW: TALCS SIREN EPODE SURER SHREW
SHRUB: TALCS SIREN PODGY SHRUB
SHRUG: TALCS SIREN PODGY SHRUG
SHUCK: TALCS PHONE SHUCK
SHUNT: TALCS SIEUR NYMPH SHUNT
SHUSH: TALCS SIREN WOOPY SHUSH
SHYLY: TALCS SPIEL HORNY SHYLY
SIEGE: TALCS SIREN SIEGE
SIEVE: TALCS SIREN SIEGE SIEVE
SIGHT: TALCS SIEUR SIGHT
SIGMA: TALCS SPIRE SIGMA
SILKY: TALCS OUPED SILLY SILKY
SILLY: TALCS OUPED SILLY
SINCE: TALCS PHONE SINCE
SINEW: TALCS SIREN SINED SINEW
SINGE: TALCS SIREN SINGE
SIREN: TALCS SIREN
SISSY: TALCS SIREN SISSY
SIXTH: TALCS SIEUR SIGHT SIXTH
SIXTY: TALCS SIEUR SIGHT SIXTY
SKATE: TALCS STARE SPATE SKATE
SKIER: TALCS SIREN PLUSH SKIER
SKIFF: TALCS SIREN KHOUM SPIKY SKIFF
SKILL: TALCS SPIEL WARKS SKILL
SKIMP: TALCS SIREN KHOUM SKIMP
SKIRT: TALCS SIEUR SPINK SKIRT
SKULK: TALCS SPIEL HORNY SLUFF SKULK
SKULL: TALCS SPIEL KRONE SKULL
SKUNK: TALCS SIREN POWNY SKUNK
SLACK: TALCS SLACK
SLAIN: TALCS SHALE PLINK SLAIN
SLANG: TALCS SHALE PLINK SLANG
SLANT: TALCS SLEPT SLART SLANT
SLASH: TALCS SHALE SLASH
SLATE: TALCS SLEPT SLATE
SLAVE: TALCS SHALE UNKID SLAVE
SLEEK: TALCS SPIEL SLEER SLEEK
SLEEP: TALCS SPIEL SLEEP
SLEET: TALCS STILE SLEET
SLEPT: TALCS STILE SLEET SLEPT
SLICE: TALCS SLICE
SLICK: TALCS SLICE SLICK
SLIDE: TALCS SPIEL DWALM SLIDE
SLIME: TALCS SPIEL DWALM SLIME
SLIMY: TALCS SPIEL GHYLL SLIMY
SLING: TALCS SPIEL GHYLL SLING
SLINK: TALCS SPIEL GHYLL SLINK
SLOOP: TALCS SPIEL SLURP SLOOP
SLOPE: TALCS SPIEL SLOPE
SLOSH: TALCS SPIEL HORNY SLOSH
SLOTH: TALCS STILE SLOTH
SLUMP: TALCS SPIEL SLURP SLUMP
SLUNG: TALCS SPIEL HORNY SLUNK SLUNG
SLUNK: TALCS SPIEL HORNY SLUNK
SLURP: TALCS SPIEL SLURP
SLUSH: TALCS SPIEL HORNY SLUSH
SLYLY: TALCS SPIEL HORNY SLYLY
SMACK: TALCS MEANY SMACK
SMALL: TALCS SHALE TYPAL SMALL
SMART: TALCS STARE KAPOW SMART
SMASH: TALCS SPIRE HUNKY SHAWM SMASH
SMEAR: TALCS SPIRE WHELK SMEAR
SMELL: TALCS SPIEL SHOWN SMELL
SMELT: TALCS STILE PAMPA SMELT
SMILE: TALCS SPIEL DWALM SMILE
SMIRK: TALCS SIREN HUMOR SMIRK
SMITE: TALCS SIEUR DEPTH SKITE SMITE
SMITH: TALCS SIEUR WHIFT SMITH
SMOCK: TALCS PHONE SMOCK
SMOKE: TALCS SIREN PODGY SHOVE SMOKE
SMOKY: TALCS SIREN WOOPY SKODY SMOKY
SMOTE: TALCS SIEUR MONTE SMOTE
SNACK: TALCS MEANY SNACK
SNAIL: TALCS SHALE PLINK SNAIL
SNAKE: TALCS SPIRE VEHME SNAKE
SNAKY: TALCS SPIRE HUNKY SNAKY
SNARE: TALCS SPIRE REWON SNARE
SNARL: TALCS SHALE PLINK SNARL
SNEAK: TALCS SPIRE DEMAN SNEAK
SNEER: TALCS SIREN SNEER
SNIDE: TALCS SIREN PHENE SNIDE
SNIFF: TALCS SIREN PLUNK SNIFF
SNIPE: TALCS SIREN PHENE SNIPE
SNOOP: TALCS SIREN POWNY SNOOP
SNORE: TALCS SIREN SENOR SNORE
SNORT: TALCS SIEUR PHONY SNORT
SNOUT: TALCS SIEUR NEMPT SNOUT
SNOWY: TALCS SIREN POWNY SNOWY
SNUCK: TALCS PHONE SNUCK
SNUFF: TALCS SIREN POWNY SNUSH SNUFF
SOAPY: TALCS SPIRE SOAPY
SOBER: TALCS SIREN WHEEP BOKEH SOBER
SOGGY: TALCS SIREN WOOPY SOGGY
SOLAR: TALCS NOVAE SOLAR
SOLID: TALCS OUPED SOLID
SOLVE: TALCS OUPED SOLVE
SONAR: TALCS SPIRE FURAN SONAR
SONIC: TALCS COURE SODIC SONIC
SOOTH: TALCS SIEUR WHOOP SOOTH
SOOTY: TALCS SIEUR WHOOP SOOTY
SORRY: TALCS SIREN PODGY SORRY
SOUND: TALCS SIREN POWNY SOUND
SOUTH: TALCS SIEUR NYMPH SOUTH
SOWER: TALCS SIREN WHEEP SOWER
SPACE: TALCS MEANY SPACE
SPADE: TALCS SPIRE GRIND SPADE
SPANK: TALCS SPIRE ZYGON SPANK
SPARE: TALCS SPIRE SPARE
SPARK: TALCS SPIRE SPARK
SPASM: TALCS SPIRE ZYGON SPASM
SPAWN: TALCS SPIRE ZYGON SPAWN
SPEAK: TALCS SPIRE SPEAK
SPEAR: TALCS SPIRE SPAER SPEAR
SPECK: TALCS PHONE SPECK
SPEED: TALCS SIREN WEEDY SPEED
SPELL: TALCS SPIEL SPELL
SPELT: TALCS STILE PAMPA SPELT
SPEND: TALCS SIREN DONNE SPEND
SPENT: TALCS SIEUR PWNED SPENT
SPERM: TALCS SIREN WHOMP SPERM
SPICE: TALCS PHONE SPICE
SPICY: TALCS PHONE SPICY
SPIED: TALCS SIREN SYPHS SPIED
SPIEL: TALCS SPIEL
SPIKE: TALCS SIREN KEMPS SPIKE
SPIKY: TALCS SIREN KHOUM SPIKY
SPILL: TALCS SPIEL SPILL
SPILT: TALCS STILE SPILT
SPINE: TALCS SIREN PHENE SPINE
SPINY: TALCS SIREN PLUNK SPINY
SPIRE: TALCS SIREN WHEAL SPIRE
SPITE: TALCS SIEUR DEPTH SPITE
SPLAT: TALCS SPLAT
SPLIT: TALCS SPLIT
SPOIL: TALCS SPIEL SPOIL
SPOKE: TALCS SIREN PODGY SPOKE
SPOOF: TALCS SIREN WOOPY FLANK SPOOF
SPOOK: TALCS SIREN WOOPY FLANK SPOOK
SPOOL: TALCS SPIEL SPOOL
SPOON: TALCS SIREN WOOSH SPOON
SPORE: TALCS SIREN WHOMP SPORE
SPORT: TALCS SIEUR PHONY SPORT
SPOUT: TALCS SIEUR NEMPT SPOUT
SPRAY: TALCS SPIRE DEBBY SPRAY
SPREE: TALCS SIREN EPODE SPREE
SPRIG: TALCS SIREN SPRIG
SPUNK: TALCS SIREN POWNY SPUNK
SPURN: TALCS SIREN SWORN SPURN
SPURT: TALCS SIEUR STURT SPURT
SQUAD: TALCS SPIRE HUNKY DEBBY SQUAD
SQUAT: TALCS STARE QUOTH SQUAT
SQUIB: TALCS SIREN KHOUM DEBBY SQUIB
STACK: TALCS STACK
STAFF: TALCS STARE THING STAMP STAFF
STAGE: TALCS STARE GRIND STAGE
STAID: TALCS STARE THING STAID
STAIN: TALCS STARE THING STAIN
STAIR: TALCS STARE STAIR
STAKE: TALCS STARE GRIND KERVE STAKE
STALE: TALCS SLEPT STALE
STALK: TALCS SLEPT STALL STALK
STALL: TALCS SLEPT STALL
STAMP: TALCS STARE THING STAMP
STAND: TALCS STARE THING STANK STAND
STANK: TALCS STARE THING STANK
STARE: TALCS STARE
STARK: TALCS STARE KNOUT STARK
START: TALCS STARE KNOUT START
STASH: TALCS STARE THING STAPH STASH
STATE: TALCS STARE GRIND KERVE STATE
STAVE: TALCS STARE GRIND KERVE STAVE
STEAD: TALCS STARE DUMKY STEAD
STEAK: TALCS STARE DUMKY STEAK
STEAL: TALCS SLEPT STEAL
STEAM: TALCS STARE DUMKY STEAM
STEED: TALCS SIEUR PWNED STEED
STEEL: TALCS STILE STEEL
STEEP: TALCS SIEUR PWNED STEEP
STEER: TALCS SIEUR STEER
STEIN: TALCS SIEUR STEIN
STERN: TALCS SIEUR STERE STERN
STICK: TALCS UNKID STICK
STIFF: TALCS SIEUR WHIFT STIFF
STILL: TALCS STILE REBUT STILL
STILT: TALCS STILE REBUT STILT
STING: TALCS SIEUR WHIFT GYMPS STING
STINK: TALCS SIEUR WHIFT GYMPS STINK
STINT: TALCS SIEUR WHIFT STINT
STOCK: TALCS UNKID STOCK
STOIC: TALCS CROUT STOIC
STOKE: TALCS SIEUR MONTE PAKKA STOKE
STOLE: TALCS STILE PONTY STOLE
STOMP: TALCS SIEUR WHOOP STOMP
STONE: TALCS SIEUR MONTE STONE
STONY: TALCS SIEUR WHOOP DYKON STONY
STOOD: TALCS SIEUR WHOOP DUMKY STOOD
STOOL: TALCS STILE STOOL
STOOP: TALCS SIEUR WHOOP STOOP
STORE: TALCS SIEUR PONTY STORE
STORK: TALCS SIEUR PHONY STORK
STORM: TALCS SIEUR PHONY STORK STORM
STORY: TALCS SIEUR PHONY STORY
STOUT: TALCS SIEUR NEMPT STOUT
STOVE: TALCS SIEUR MONTE PAKKA STOVE
STRAP: TALCS STARE GAWKY STRAD STRAP
STRAW: TALCS STARE GAWKY STRAW
STRAY: TALCS STARE GAWKY STRAY
STRIP: TALCS SIEUR SPINK STRIP
STRUT: TALCS SIEUR STRUM STRUT
STUCK: TALCS UNKID STUCK
STUDY: TALCS SIEUR NYMPH STUDY
STUFF: TALCS SIEUR NYMPH STUFF
STUMP: TALCS SIEUR NYMPH STUMP
STUNG: TALCS SIEUR NYMPH KYDST STUNG
STUNK: TALCS SIEUR NYMPH KYDST STUNK
STUNT: TALCS SIEUR NYMPH KYDST STUNT
STYLE: TALCS STILE PONTY STYLE
SUAVE: TALCS SPIRE VEHME SUAVE
SUGAR: TALCS SPIRE FURAN SUGAR
SUING: TALCS SIREN PLUNK SUING
SUITE: TALCS SIEUR SUITE
SULKY: TALCS OUPED SULKY
SULLY: TALCS OUPED SULKY SULLY
SUMAC: TALCS SPARE SCHAV SUMAC
SUNNY: TALCS SIREN POWNY SUNNY
SUPER: TALCS SIREN WHEEP SUPER
SURER: TALCS SIREN EPODE SURER
SURGE: TALCS SIREN VOUGE SURGE
SURLY: TALCS SPIEL HORNY SURLY
SUSHI: TALCS SIREN KHOUM SUSHI
SWAMI: TALCS SPIRE SIGMA SWAMI
SWAMP: TALCS SPIRE SOAPY SWAMP
SWARM: TALCS SPIRE HUDNA SWARM
SWASH: TALCS SPIRE HUNKY SHAWM SWASH
SWATH: TALCS STARE WHISK SWATH
SWEAR: TALCS SPIRE WHELK SWEAR
SWEAT: TALCS STARE SWEAT
SWEEP: TALCS SIREN WEEDY SWEEP
SWEET: TALCS SIEUR PWNED SWEET
SWELL: TALCS SPIEL SHOWN SWELL
SWEPT: TALCS SIEUR PWNED SWEPT
SWIFT: TALCS SIEUR WHIFT SWIFT
SWILL: TALCS SPIEL WARKS SWILL
SWINE: TALCS SIREN PHENE SWINE
SWING: TALCS SIREN PLUNK SWING
SWIRL: TALCS SPIEL WARKS SWIRL
SWISH: TALCS SIREN KHOUM SWISH
SWOON: TALCS SIREN WOOSH SWOON
SWOOP: TALCS SIREN WOOPY SWOOP
SWORD: TALCS SIREN MOKOS SWORD
SWORE: TALCS SIREN WHOMP SWORE
SWORN: TALCS SIREN SWORN
SWUNG: TALCS SIREN POWNY SWUNG
SYNOD: TALCS SIREN POWNY SYNOD
SYRUP: TALCS SIREN PODGY SYRUP
TABBY: TALCS BINER TABBY
TABLE: TALCS TABLA TABLE
TABOO: TALCS BINER TABBY TABOO
TACIT: TALCS IRONE TACIT
TACKY: TALCS IRONE TACKY
TAFFY: TALCS BINER UMPTY FLANK TAFFY
TAINT: TALCS BINER TAMIN TAINT
TAKEN: TALCS BINER TAKEN
TAKER: TALCS BINER KAPOW TAKER
TALLY: TALCS APEAK TALON TALLY
TALON: TALCS APEAK TALON
TAMER: TALCS BINER KAPOW VITEX TAMER
TANGO: TALCS BINER GOOKY TANGO
TANGY: TALCS BINER GOOKY TANGY
TAPER: TALCS BINER KAPOW TAPER
TAPIR: TALCS BINER TAPIR
TARDY: TALCS BINER DOTTY TARDY
TAROT: TALCS BINER DOTTY TAROT
TASTE: TALCS RISES TASTE
TASTY: TALCS RISES TASTY
TATTY: TALCS BINER UMPTY TATTY
TAUNT: TALCS BINER TAUNT
TAWNY: TALCS BINER TAUNT TAWNY
TEACH: TALCS REIKI TEACH
TEARY: TALCS IRONE TERRA TEARY
TEASE: TALCS TOISE TEASE
TEDDY: TALCS IRONE HEEDY TEDDY
TEETH: TALCS IRONE HEEDY TEETH
TEMPO: TALCS IRONE PODGY TEMPO
TENET: TALCS IRONE TYNED TENET
TENOR: TALCS IRONE TONER TENOR
TENSE: TALCS ROUSE TENSE
TENTH: TALCS IRONE TYNED TENTH
TEPEE: TALCS IRONE EMEUS TEPEE
TEPID: TALCS IRONE DEISM TEPID
TERRA: TALCS IRONE TERRA
TERSE: TALCS ROUSE TERSE
TESTY: TALCS ROUSE TSKED TESTY
THANK: TALCS IRONE GAWKY THANK
THEFT: TALCS IRONE HEEDY THEFT
THEIR: TALCS IRONE MITER THEIR
THEME: TALCS IRONE EMEUS THEME
THERE: TALCS IRONE THERE
THESE: TALCS ROUSE TENSE THESE
THETA: TALCS IRONE THETA
THICK: TALCS URINE THICK
THIEF: TALCS IRONE DEISM THIEF
THIGH: TALCS IRONE PUDGY THIGH
THING: TALCS IRONE GAWKY THING
THINK: TALCS IRONE GAWKY THINK
THIRD: TALCS IRONE TWIRP THIRD
THONG: TALCS IRONE THONG
THORN: TALCS IRONE THORN
THOSE: TALCS ROUSE THOSE
THREE: TALCS IRONE THERE THREE
THREW: TALCS IRONE TWYER THREW
THROB: TALCS IRONE BUTOH THROB
THROW: TALCS IRONE BUTOH THROW
THRUM: TALCS IRONE TURFY THRUM
THUMB: TALCS IRONE UMPTY THUMB
THUMP: TALCS IRONE UMPTY THUMP
THYME: TALCS IRONE EMEUS THYME
TIARA: TALCS IRONE TIARA
TIBIA: TALCS IRONE THAIM TIBIA
TIDAL: TALCS BROIL TIDAL
TIGER: TALCS IRONE MITER TIGER
TIGHT: TALCS IRONE PUDGY TIGHT
TILDE: TALCS DICEY TILDE
TIMER: TALCS IRONE MITER TIMER
TIMID: TALCS IRONE PUDGY TIMID
TIPSY: TALCS ROUSE TIPSY
TITAN: TALCS IRONE TITAN
TITHE: TALCS IRONE TWITE TITHE
TITLE: TALCS ORIEL TITLE
TOAST: TALCS TOISE TOAST
TODAY: TALCS IRONE TOADY TODAY
TODDY: TALCS IRONE UMPTY COZED TODDY
TOKEN: TALCS IRONE TONEY TOKEN
TONAL: TALCS BROIL TONAL
TONGA: TALCS IRONE TONGA
TONIC: TALCS HORNY TONIC
TOOTH: TALCS IRONE TOOTH
TOPAZ: TALCS IRONE TOADY TOPAZ
TOPIC: TALCS HORNY TOPIC
TORCH: TALCS URINE TORCH
TORSO: TALCS ROUSE LIRKS TORSO
TORUS: TALCS IRONE TOURS TORUS
TOTAL: TALCS BROIL TONAL TOTAL
TOTEM: TALCS IRONE PODGY TOTEM
TOUCH: TALCS URINE TOUCH
TOUGH: TALCS IRONE UMPTY TOUGH
TOWEL: TALCS ORIEL TOWEL
TOWER: TALCS IRONE PAWKY TOWER
TOXIC: TALCS HORNY TOPIC TOXIC
TOXIN: TALCS IRONE TIMON TOXIN
TRACE: TALCS REIKI TRACE
TRACK: TALCS REIKI TRACK
TRACT: TALCS REIKI TRACT
TRADE: TALCS IRONE PAGOD TRADE
TRAIL: TALCS BROIL TRAIL
TRAIN: TALCS IRONE TRAIN
TRAIT: TALCS IRONE TRAIK TRAIT
TRAMP: TALCS IRONE TRAPT TRAMP
TRASH: TALCS TOISE TRASH
TRAWL: TALCS BROIL TRAWL
TREAD: TALCS IRONE FETTA TREAD
TREAT: TALCS IRONE FETTA TREAT
TREND: TALCS IRONE TREND
TRIAD: TALCS IRONE TRAIK TRIAD
TRIAL: TALCS BROIL TRIAL
TRIBE: TALCS IRONE BIPED TRIBE
TRICE: TALCS URINE TRICE
TRICK: TALCS URINE TRICK
TRIED: TALCS IRONE TRIED
TRIPE: TALCS IRONE BIPED TRIPE
TRITE: TALCS IRONE BIPED TRITE
TROLL: TALCS ORIEL TROLL
TROOP: TALCS IRONE UMPHS TROOP
TROPE: TALCS IRONE POKED TROPE
TROUT: TALCS IRONE UMPHS TROUT
TROVE: TALCS IRONE POKED TROVE
TRUCE: TALCS URINE TRUCE
TRUCK: TALCS URINE TRUCK
TRUER: TALCS IRONE TRUER
TRULY: TALCS ORIEL TRULY
TRUMP: TALCS IRONE TRUMP
TRUNK: TALCS IRONE TRUNK
TRUSS: TALCS IRONE TRUSS
TRUST: TALCS ROUSE TRUST
TRUTH: TALCS IRONE TRUMP TRUTH
TRYST: TALCS ROUSE TRYST
TUBAL: TALCS BROIL TUBAL
TUBER: TALCS IRONE TWYER TUBER
TULIP: TALCS DICEY TULIP
TULLE: TALCS DICEY TULLE
TUMOR: TALCS IRONE BUTOH TUMOR
TUNIC: TALCS HORNY TUNIC
TURBO: TALCS IRONE BUTOH TURBO
TUTOR: TALCS IRONE BUTOH TUTOR
TWANG: TALCS IRONE GAWKY TWANG
TWEAK: TALCS IRONE THETA TWEAK
TWEED: TALCS IRONE HEEDY TWEED
TWEET: TALCS IRONE HEEDY TWEET
TWICE: TALCS URINE TWICE
TWINE: TALCS IRONE THINE TWINE
TWIRL: TALCS ORIEL THIRL TWIRL
TWIST: TALCS ROUSE TIPSY TWIST
TWIXT: TALCS IRONE PUDGY TWIXT
TYING: TALCS IRONE GAWKY TYING
UDDER: TALCS RONDE DRIER UDDER
ULCER: TALCS ULYIE ULCER
ULTRA: TALCS PETTO DITAL ULTRA
UMBRA: TALCS DRONE MURRI UMBRA
UNCLE: TALCS ULYIE UNCLE
UNCUT: TALCS ROUEN INCUT UNCUT
UNDER: TALCS RONDE UNRED UNDER
UNDID: TALCS RONDE BUDDY UNDID
UNDUE: TALCS RONDE UNDEE UNDUE
UNFED: TALCS RONDE EIKED FUBSY UNFED
UNFIT: TALCS ROUEN PUNTY UNFIT
UNIFY: TALCS RONDE HUMPY UNIFY
UNION: TALCS RONDE GUIMP UNION
UNITE: TALCS ROUEN UNITE
UNITY: TALCS ROUEN PUNTY UNITY
UNLIT: TALCS MONEY UNLIT
UNMET: TALCS ROUEN GAWKY UNMET
UNSET: TALCS SIEUR UNSET
UNTIE: TALCS ROUEN UNITE UNTIE
UNTIL: TALCS FOUET UNTIL
UNWED: TALCS RONDE EIKED FUBSY UNWED
UNZIP: TALCS RONDE HUMPY UNZIP
UPPER: TALCS RONDE FERER BUMPH UPPER
UPSET: TALCS SIEUR UNSET UPSET
URBAN: TALCS DRONE BRAAI URBAN
URINE: TALCS RONDE DUING URINE
USAGE: TALCS SPIRE AMUSE USAGE
USHER: TALCS SIREN EPHOR USHER
USING: TALCS SIREN KNISH USING
USUAL: TALCS SHALE LYSSA USUAL
USURP: TALCS SIREN FUBSY USURP
UTILE: TALCS FOUET BUTLE UTILE
UTTER: TALCS ROUEN UPTER UTTER
VAGUE: TALCS GYRED VAGUE
VALET: TALCS VIEWY VALET
VALID: TALCS HYPED VALID
VALOR: TALCS HYPED ABRAM VALOR
VALUE: TALCS HYPED VALUE
VALVE: TALCS HYPED VALUE VALVE
VAPID: TALCS GYRED PAVID VAPID
VAPOR: TALCS GYRED ROBIN FAVOR VAPOR
VAULT: TALCS LYTED FIGHT VAULT
VAUNT: TALCS RHINE JUDGE VAUNT
VEGAN: TALCS DRONE GENUA BEGAN VEGAN
VENOM: TALCS RONDE GENOM VENOM
VENUE: TALCS RONDE WEIGH PENNE VENUE
VERGE: TALCS RONDE BEIGE VERGE
VERSE: TALCS SIREN WHOMP VERSE
VERSO: TALCS SIREN WHOMP GORSE VERSO
VERVE: TALCS RONDE BEIGE KELPY VERVE
VICAR: TALCS CRINE SCRAP VICAR
VIDEO: TALCS RONDE BEFOG ODEUM VIDEO
VIGIL: TALCS GOIER LINGY VIGIL
VIGOR: TALCS RONDE GROOM VIGOR
VILLA: TALCS ROPEY MUNGA ZILLA VILLA
VINYL: TALCS GOIER DUMPY VINYL
VIOLA: TALCS ANEAR DUOMI VIOLA
VIPER: TALCS RONDE FERER BUMPH PAPAW VIPER
VIRAL: TALCS ANEAR RUMPO GYRAL VIRAL
VIRUS: TALCS DONER GUIMP VIRUS
VISIT: TALCS SIEUR MYOID VISIT
VISOR: TALCS SIREN RISHI VISOR
VISTA: TALCS STARE QUOIT VISTA
VITAL: TALCS PETTO DITAL VITAL
VIVID: TALCS RONDE PRIMY VIVID
VIXEN: TALCS RONDE HEMIN GIVEN VIXEN
VOCAL: TALCS CROME LEAFS VOCAL
VODKA: TALCS DRONE AIDED HODJA VODKA
VOGUE: TALCS RONDE GIMPY BOGUE VOGUE
VOICE: TALCS IRONE VOICE
VOILA: TALCS ANEAR DUOMI LOGIA VOILA
VOMIT: TALCS ROUEN MYTHI VOMIT
VOTER: TALCS ROUEN DOTER VOTER
VOUCH: TALCS IRONE CLUMP GOUCH VOUCH
VOWEL: TALCS GOIER WAVED VOWEL
VYING: TALCS RONDE HUMPY VYING
WACKY: TALCS CORED GIMPY JACKY WACKY
WAFER: TALCS GYRED ROWME FLANK WAFER
WAGER: TALCS GYRED REWET WAGER
WAGON: TALCS GYRED NAKFA HANGI WAGON
WAIST: TALCS SEITY WAIST
WAIVE: TALCS GYRED OVINE WAIVE
WALTZ: TALCS VIEWY WALTZ
WARTY: TALCS RHINE PONTY WARTY
WASTE: TALCS SEITY WHEEP WASTE
WATCH: TALCS CROWN WATCH
WATER: TALCS RHINE PAGOD EMEUS WATER
WAVER: TALCS GYRED ROWME FLANK WAVER
WAXEN: TALCS GYRED KNOWN WAXEN
WEARY: TALCS DRONE REBAR MIRKY WEARY
WEAVE: TALCS DRONE AGAZE HEAME WEAVE
WEDGE: TALCS RONDE BEDIM WHEAL WEDGE
WEEDY: TALCS RONDE WHITS WEEDY
WEIGH: TALCS RONDE WIMPY WEIGH
WEIRD: TALCS RONDE DRIER WEIRD
WELCH: TALCS HUMID FUBSY WELCH
WELSH: TALCS OUPED WELSH
WENCH: TALCS IRONE DWEEB WENCH
WHACK: TALCS BRAKE WHINY WHACK
WHALE: TALCS ANEAR MEDLE WHALE
WHARF: TALCS DRONE MURRI AGGRY WHARF
WHEAT: TALCS ARENA WHEAT
WHEEL: TALCS GOIER DEBEL KNEEL WHEEL
WHELP: TALCS GOIER NEUME WHELK WHELP
WHERE: TALCS RONDE BEIGE WORRY WHERE
WHICH: TALCS IRONE CHICK WHICH
WHIFF: TALCS RONDE PIGMY BUFFI WHIFF
WHILE: TALCS GOIER BAWDY WHILE
WHINE: TALCS RONDE WEENY WHINE
WHINY: TALCS RONDE HUMPY WHINY
WHIRL: TALCS GOIER BAWDY WHIRL
WHISK: TALCS SIREN WORMY WHISK
WHITE: TALCS ROUEN FITTE WHITE
WHOLE: TALCS GOIER BLOWN WHOLE
WHOOP: TALCS RONDE BUMPH WHOOP
WHOSE: TALCS SIREN GOOPY WHOSE
WIDEN: TALCS RONDE EIKED DIZEN WIDEN
WIDER: TALCS RONDE DRIER WHEEP WIDER
WIDOW: TALCS RONDE HUMID WIDOW
WIDTH: TALCS ROUEN FIGHT WIDTH
WIELD: TALCS GOIER DEXIE FUBSY WIELD
WIGHT: TALCS ROUEN FIGHT HAKAM DWEEB WIGHT
WILLY: TALCS DOGIE MUHLY FUBSY WILLY
WIMPY: TALCS RONDE PIGMY JIMPY WIMPY
WINCE: TALCS IRONE WORMY WINCE
WINCH: TALCS IRONE CAMPY GAWKY WINCH
WINDY: TALCS RONDE FUBSY WINDY
WISER: TALCS SIREN REWON WISER
WISPY: TALCS SIREN MOSKS DISHY WISPY
WITCH: TALCS HOIED EMBOW WITCH
WITTY: TALCS ROUEN FIGHT DWEEB WITTY
WOKEN: TALCS RONDE HAKAM WOKEN
WOMAN: TALCS DRONE WIGAN WOMAN
WOMEN: TALCS RONDE HAKAM NOMEN WOMEN
WOODY: TALCS RONDE DHOWS WOODY
WOOER: TALCS RONDE WHUMP WOOER
WOOLY: TALCS GOIER WOOLD WOOLY
WOOZY: TALCS RONDE BUMPY KIDGE WOOFY WOOZY
WORDY: TALCS RONDE FORDO WORDY
WORLD: TALCS GOIER WORLD
WORRY: TALCS RONDE GURRY WORRY
WORSE: TALCS SIREN WHOMP WORSE
WORST: TALCS SIEUR WHOOP WORST
WORTH: TALCS ROUEN BOOFY WORTH
WOULD: TALCS GOIER WOOLD WOULD
WOUND: TALCS RONDE WHUMP WOUND
WOVEN: TALCS RONDE HAKAM WOVEN
WRACK: TALCS BRAKE COWED WRACK
WRATH: TALCS ARENA WIFTY WRATH
WREAK: TALCS DRONE FUBAR WREAK
WRECK: TALCS IRONE DRECK WRECK
WREST: TALCS SIEUR WEDEL WREST
WRING: TALCS RONDE IBRIK WRING
WRIST: TALCS SIEUR GRIFT WRIST
WRITE: TALCS ROUEN PEIZE WRITE
WRONG: TALCS RONDE GIPON WRONG
WROTE: TALCS ROUEN ERGOT WROTE
WRUNG: TALCS RONDE IBRIK WRUNG
WRYLY: TALCS GOIER DUMBO WRYLY
YACHT: TALCS CERTY YACHT
YEARN: TALCS DRONE MINAR YEARN
YEAST: TALCS STARE FUBSY YEAST
YIELD: TALCS GOIER DEXIE FUBSY YIELD
YOUNG: TALCS RONDE GIMPY YOUNG
YOUTH: TALCS ROUEN UMPTY YOUTH
ZEBRA: TALCS DRONE REBAR ZEBRA
ZESTY: TALCS SIEUR PONTY FUZEE ZESTY
ZONAL: TALCS ANEAR LUNGI ZONAL
Success: 2315
Fail: 0
Avg guess: 3.956
